YYYY,MM,DD,Total,North,South,Date,Difference
1874,5,1,-1,-1,-1,1874-5-1,0
1874,5,2,-1,-1,-1,1874-5-2,0
1874,5,3,-1,-1,-1,1874-5-3,0
1874,5,4,-1,-1,-1,1874-5-4,0
1874,5,5,-1,-1,-1,1874-5-5,0
1874,5,6,-1,-1,-1,1874-5-6,0
1874,5,7,-1,-1,-1,1874-5-7,0
1874,5,8,-1,-1,-1,1874-5-8,0
1874,5,9,1298,446,852,1874-5-9,-406
1874,5,10,1150,343,807,1874-5-10,-464
1874,5,11,767,240,527,1874-5-11,-287
1874,5,12,389,0,389,1874-5-12,-389
1874,5,13,350,0,350,1874-5-13,-350
1874,5,14,312,0,312,1874-5-14,-312
1874,5,15,273,0,273,1874-5-15,-273
1874,5,16,314,0,314,1874-5-16,-314
1874,5,17,217,0,217,1874-5-17,-217
1874,5,18,119,0,119,1874-5-18,-119
1874,5,19,28,0,28,1874-5-19,-28
1874,5,20,329,0,329,1874-5-20,-329
1874,5,21,222,0,222,1874-5-21,-222
1874,5,22,281,0,281,1874-5-22,-281
1874,5,23,210,0,210,1874-5-23,-210
1874,5,24,155,0,155,1874-5-24,-155
1874,5,25,100,0,100,1874-5-25,-100
1874,5,26,428,384,44,1874-5-26,340
1874,5,27,353,353,0,1874-5-27,353
1874,5,28,322,322,0,1874-5-28,322
1874,5,29,290,290,0,1874-5-29,290
1874,5,30,259,259,0,1874-5-30,259
1874,5,31,231,231,0,1874-5-31,231
1874,6,1,313,202,111,1874-6-1,91
1874,6,2,392,226,166,1874-6-2,60
1874,6,3,375,221,154,1874-6-3,67
1874,6,4,358,216,142,1874-6-4,74
1874,6,5,340,213,127,1874-6-5,86
1874,6,6,-1,-1,-1,1874-6-6,0
1874,6,7,-1,-1,-1,1874-6-7,0
1874,6,8,-1,-1,-1,1874-6-8,0
1874,6,9,-1,-1,-1,1874-6-9,0
1874,6,10,-1,-1,-1,1874-6-10,0
1874,6,11,50,0,50,1874-6-11,-50
1874,6,12,30,0,30,1874-6-12,-30
1874,6,13,134,26,108,1874-6-13,-82
1874,6,14,69,0,69,1874-6-14,-69
1874,6,15,184,126,58,1874-6-15,68
1874,6,16,284,199,85,1874-6-16,114
1874,6,17,412,272,140,1874-6-17,132
1874,6,18,540,345,195,1874-6-18,150
1874,6,19,668,418,250,1874-6-19,168
1874,6,20,461,461,0,1874-6-20,461
1874,6,21,504,504,0,1874-6-21,504
1874,6,22,548,548,0,1874-6-22,548
1874,6,23,589,589,0,1874-6-23,589
1874,6,24,543,543,0,1874-6-24,543
1874,6,25,541,541,0,1874-6-25,541
1874,6,26,243,243,0,1874-6-26,243
1874,6,27,390,373,17,1874-6-27,356
1874,6,28,564,346,218,1874-6-28,128
1874,6,29,738,319,419,1874-6-29,-100
1874,6,30,1110,355,755,1874-6-30,-400
1874,7,1,975,271,704,1874-7-1,-433
1874,7,2,972,200,772,1874-7-2,-572
1874,7,3,739,265,474,1874-7-3,-209
1874,7,4,1724,717,1007,1874-7-4,-290
1874,7,5,1897,898,999,1874-7-5,-101
1874,7,6,2225,1164,1061,1874-7-6,103
1874,7,7,2087,1251,836,1874-7-7,415
1874,7,8,2163,1320,843,1874-7-8,477
1874,7,9,1933,1293,640,1874-7-9,653
1874,7,10,1424,887,537,1874-7-10,350
1874,7,11,1207,665,542,1874-7-11,123
1874,7,12,988,442,546,1874-7-12,-104
1874,7,13,769,218,551,1874-7-13,-333
1874,7,14,370,134,236,1874-7-14,-102
1874,7,15,780,335,445,1874-7-15,-110
1874,7,16,990,453,537,1874-7-16,-84
1874,7,17,750,750,0,1874-7-17,750
1874,7,18,731,731,0,1874-7-18,731
1874,7,19,696,696,0,1874-7-19,696
1874,7,20,829,829,0,1874-7-20,829
1874,7,21,768,768,0,1874-7-21,768
1874,7,22,937,937,0,1874-7-22,937
1874,7,23,1336,1336,0,1874-7-23,1336
1874,7,24,1278,1278,0,1874-7-24,1278
1874,7,25,370,370,0,1874-7-25,370
1874,7,26,294,294,0,1874-7-26,294
1874,7,27,290,290,0,1874-7-27,290
1874,7,28,285,285,0,1874-7-28,285
1874,7,29,280,280,0,1874-7-29,280
1874,7,30,910,910,0,1874-7-30,910
1874,7,31,1042,1042,0,1874-7-31,1042
1874,8,1,1014,1014,0,1874-8-1,1014
1874,8,2,987,987,0,1874-8-2,987
1874,8,3,1224,959,265,1874-8-3,694
1874,8,4,1031,769,262,1874-8-4,507
1874,8,5,992,732,260,1874-8-5,472
1874,8,6,950,694,256,1874-8-6,438
1874,8,7,1067,752,315,1874-8-7,437
1874,8,8,1700,1327,373,1874-8-8,954
1874,8,9,979,675,304,1874-8-9,371
1874,8,10,1812,679,1133,1874-8-10,-454
1874,8,11,1948,659,1289,1874-8-11,-630
1874,8,12,1557,475,1082,1874-8-12,-607
1874,8,13,1564,448,1116,1874-8-13,-668
1874,8,14,1570,420,1150,1874-8-14,-730
1874,8,15,1471,463,1008,1874-8-15,-545
1874,8,16,1260,461,799,1874-8-16,-338
1874,8,17,1144,459,685,1874-8-17,-226
1874,8,18,1013,425,588,1874-8-18,-163
1874,8,19,1245,469,776,1874-8-19,-307
1874,8,20,1587,374,1213,1874-8-20,-839
1874,8,21,766,78,688,1874-8-21,-610
1874,8,22,478,45,433,1874-8-22,-388
1874,8,23,344,0,344,1874-8-23,-344
1874,8,24,377,44,333,1874-8-24,-289
1874,8,25,280,57,223,1874-8-25,-166
1874,8,26,287,57,230,1874-8-26,-173
1874,8,27,241,24,217,1874-8-27,-193
1874,8,28,247,29,218,1874-8-28,-189
1874,8,29,278,29,249,1874-8-29,-220
1874,8,30,92,19,73,1874-8-30,-54
1874,8,31,73,8,65,1874-8-31,-57
1874,9,1,93,0,93,1874-9-1,-93
1874,9,2,127,0,127,1874-9-2,-127
1874,9,3,243,0,243,1874-9-3,-243
1874,9,4,427,69,358,1874-9-4,-289
1874,9,5,352,33,319,1874-9-5,-286
1874,9,6,33,33,0,1874-9-6,33
1874,9,7,34,34,0,1874-9-7,34
1874,9,8,34,34,0,1874-9-8,34
1874,9,9,115,63,52,1874-9-9,11
1874,9,10,160,75,85,1874-9-10,-10
1874,9,11,237,0,237,1874-9-11,-237
1874,9,12,517,129,388,1874-9-12,-259
1874,9,13,122,122,0,1874-9-13,122
1874,9,14,114,114,0,1874-9-14,114
1874,9,15,48,0,48,1874-9-15,-48
1874,9,16,39,0,39,1874-9-16,-39
1874,9,17,31,0,31,1874-9-17,-31
1874,9,18,22,0,22,1874-9-18,-22
1874,9,19,14,0,14,1874-9-19,-14
1874,9,20,14,0,14,1874-9-20,-14
1874,9,21,13,0,13,1874-9-21,-13
1874,9,22,460,65,395,1874-9-22,-330
1874,9,23,456,58,398,1874-9-23,-340
1874,9,24,465,51,414,1874-9-24,-363
1874,9,25,510,95,415,1874-9-25,-320
1874,9,26,468,88,380,1874-9-26,-292
1874,9,27,444,62,382,1874-9-27,-320
1874,9,28,1419,34,1385,1874-9-28,-1351
1874,9,29,1814,15,1799,1874-9-29,-1784
1874,9,30,1233,10,1223,1874-9-30,-1213
1874,10,1,1470,0,1470,1874-10-1,-1470
1874,10,2,1321,0,1321,1874-10-2,-1321
1874,10,3,1454,0,1454,1874-10-3,-1454
1874,10,4,1235,0,1235,1874-10-4,-1235
1874,10,5,1044,0,1044,1874-10-5,-1044
1874,10,6,941,0,941,1874-10-6,-941
1874,10,7,838,0,838,1874-10-7,-838
1874,10,8,749,15,734,1874-10-8,-719
1874,10,9,594,59,535,1874-10-9,-476
1874,10,10,672,103,569,1874-10-10,-466
1874,10,11,204,0,204,1874-10-11,-204
1874,10,12,175,0,175,1874-10-12,-175
1874,10,13,145,0,145,1874-10-13,-145
1874,10,14,111,0,111,1874-10-14,-111
1874,10,15,319,242,77,1874-10-15,165
1874,10,16,218,218,0,1874-10-16,218
1874,10,17,195,195,0,1874-10-17,195
1874,10,18,171,171,0,1874-10-18,171
1874,10,19,283,148,135,1874-10-19,13
1874,10,20,211,132,79,1874-10-20,53
1874,10,21,200,99,101,1874-10-21,-2
1874,10,22,209,66,143,1874-10-22,-77
1874,10,23,117,27,90,1874-10-23,-63
1874,10,24,-1,-1,-1,1874-10-24,0
1874,10,25,-1,-1,-1,1874-10-25,0
1874,10,26,-1,-1,-1,1874-10-26,0
1874,10,27,-1,-1,-1,1874-10-27,0
1874,10,28,-1,-1,-1,1874-10-28,0
1874,10,29,0,0,0,1874-10-29,0
1874,10,30,0,0,0,1874-10-30,0
1874,10,31,-1,-1,-1,1874-10-31,0
1874,11,1,-1,-1,-1,1874-11-1,0
1874,11,2,-1,-1,-1,1874-11-2,0
1874,11,3,446,0,446,1874-11-3,-446
1874,11,4,518,0,518,1874-11-4,-518
1874,11,5,486,0,486,1874-11-5,-486
1874,11,6,458,0,458,1874-11-6,-458
1874,11,7,557,0,557,1874-11-7,-557
1874,11,8,689,0,689,1874-11-8,-689
1874,11,9,820,0,820,1874-11-9,-820
1874,11,10,636,0,636,1874-11-10,-636
1874,11,11,451,0,451,1874-11-11,-451
1874,11,12,211,87,124,1874-11-12,-37
1874,11,13,149,149,0,1874-11-13,149
1874,11,14,222,222,0,1874-11-14,222
1874,11,15,295,295,0,1874-11-15,295
1874,11,16,368,368,0,1874-11-16,368
1874,11,17,234,234,0,1874-11-17,234
1874,11,18,335,335,0,1874-11-18,335
1874,11,19,436,436,0,1874-11-19,436
1874,11,20,903,903,0,1874-11-20,903
1874,11,21,840,840,0,1874-11-21,840
1874,11,22,777,777,0,1874-11-22,777
1874,11,23,712,712,0,1874-11-23,712
1874,11,24,320,320,0,1874-11-24,320
1874,11,25,289,289,0,1874-11-25,289
1874,11,26,257,257,0,1874-11-26,257
1874,11,27,226,226,0,1874-11-27,226
1874,11,28,-1,-1,-1,1874-11-28,0
1874,11,29,-1,-1,-1,1874-11-29,0
1874,11,30,-1,-1,-1,1874-11-30,0
1874,12,1,-1,-1,-1,1874-12-1,0
1874,12,2,0,0,0,1874-12-2,0
1874,12,3,0,0,0,1874-12-3,0
1874,12,4,0,0,0,1874-12-4,0
1874,12,5,-1,-1,-1,1874-12-5,0
1874,12,6,-1,-1,-1,1874-12-6,0
1874,12,7,111,0,111,1874-12-7,-111
1874,12,8,83,0,83,1874-12-8,-83
1874,12,9,280,162,118,1874-12-9,44
1874,12,10,242,197,45,1874-12-10,152
1874,12,11,286,250,36,1874-12-11,214
1874,12,12,462,462,0,1874-12-12,462
1874,12,13,366,366,0,1874-12-13,366
1874,12,14,269,269,0,1874-12-14,269
1874,12,15,245,245,0,1874-12-15,245
1874,12,16,221,221,0,1874-12-16,221
1874,12,17,197,197,0,1874-12-17,197
1874,12,18,126,126,0,1874-12-18,126
1874,12,19,-1,-1,-1,1874-12-19,0
1874,12,20,-1,-1,-1,1874-12-20,0
1874,12,21,-1,-1,-1,1874-12-21,0
1874,12,22,-1,-1,-1,1874-12-22,0
1874,12,23,-1,-1,-1,1874-12-23,0
1874,12,24,-1,-1,-1,1874-12-24,0
1874,12,25,-1,-1,-1,1874-12-25,0
1874,12,26,-1,-1,-1,1874-12-26,0
1874,12,27,-1,-1,-1,1874-12-27,0
1874,12,28,-1,-1,-1,1874-12-28,0
1874,12,29,-1,-1,-1,1874-12-29,0
1874,12,30,-1,-1,-1,1874-12-30,0
1874,12,31,-1,-1,-1,1874-12-31,0
1875,1,1,-1,-1,-1,1875-1-1,0
1875,1,2,215,0,215,1875-1-2,-215
1875,1,3,190,0,190,1875-1-3,-190
1875,1,4,165,0,165,1875-1-4,-165
1875,1,5,140,0,140,1875-1-5,-140
1875,1,6,0,0,0,1875-1-6,0
1875,1,7,0,0,0,1875-1-7,0
1875,1,8,0,0,0,1875-1-8,0
1875,1,9,0,0,0,1875-1-9,0
1875,1,10,0,0,0,1875-1-10,0
1875,1,11,0,0,0,1875-1-11,0
1875,1,12,0,0,0,1875-1-12,0
1875,1,13,0,0,0,1875-1-13,0
1875,1,14,0,0,0,1875-1-14,0
1875,1,15,0,0,0,1875-1-15,0
1875,1,16,42,0,42,1875-1-16,-42
1875,1,17,-1,-1,-1,1875-1-17,0
1875,1,18,-1,-1,-1,1875-1-18,0
1875,1,19,-1,-1,-1,1875-1-19,0
1875,1,20,-1,-1,-1,1875-1-20,0
1875,1,21,-1,-1,-1,1875-1-21,0
1875,1,22,638,638,0,1875-1-22,638
1875,1,23,456,456,0,1875-1-23,456
1875,1,24,276,276,0,1875-1-24,276
1875,1,25,96,96,0,1875-1-25,96
1875,1,26,27,27,0,1875-1-26,27
1875,1,27,0,0,0,1875-1-27,0
1875,1,28,0,0,0,1875-1-28,0
1875,1,29,0,0,0,1875-1-29,0
1875,1,30,0,0,0,1875-1-30,0
1875,1,31,0,0,0,1875-1-31,0
1875,2,1,150,150,0,1875-2-1,150
1875,2,2,130,130,0,1875-2-2,130
1875,2,3,110,110,0,1875-2-3,110
1875,2,4,91,91,0,1875-2-4,91
1875,2,5,127,127,0,1875-2-5,127
1875,2,6,95,95,0,1875-2-6,95
1875,2,7,121,121,0,1875-2-7,121
1875,2,8,59,59,0,1875-2-8,59
1875,2,9,145,145,0,1875-2-9,145
1875,2,10,40,40,0,1875-2-10,40
1875,2,11,39,39,0,1875-2-11,39
1875,2,12,0,0,0,1875-2-12,0
1875,2,13,0,0,0,1875-2-13,0
1875,2,14,10,10,0,1875-2-14,10
1875,2,15,0,0,0,1875-2-15,0
1875,2,16,0,0,0,1875-2-16,0
1875,2,17,0,0,0,1875-2-17,0
1875,2,18,478,478,0,1875-2-18,478
1875,2,19,542,542,0,1875-2-19,542
1875,2,20,828,655,173,1875-2-20,482
1875,2,21,1108,725,383,1875-2-21,342
1875,2,22,1097,824,273,1875-2-22,551
1875,2,23,1194,835,359,1875-2-23,476
1875,2,24,1107,820,287,1875-2-24,533
1875,2,25,1019,804,215,1875-2-25,589
1875,2,26,885,741,144,1875-2-26,597
1875,2,27,869,714,155,1875-2-27,559
1875,2,28,933,810,123,1875-2-28,687
1875,3,1,812,736,76,1875-3-1,660
1875,3,2,832,801,31,1875-3-2,770
1875,3,3,152,152,0,1875-3-3,152
1875,3,4,40,40,0,1875-3-4,40
1875,3,5,121,121,0,1875-3-5,121
1875,3,6,168,168,0,1875-3-6,168
1875,3,7,516,322,194,1875-3-7,128
1875,3,8,299,163,136,1875-3-8,27
1875,3,9,460,281,179,1875-3-9,102
1875,3,10,429,247,182,1875-3-10,65
1875,3,11,437,0,437,1875-3-11,-437
1875,3,12,184,13,171,1875-3-12,-158
1875,3,13,288,0,288,1875-3-13,-288
1875,3,14,183,0,183,1875-3-14,-183
1875,3,15,166,0,166,1875-3-15,-166
1875,3,16,132,0,132,1875-3-16,-132
1875,3,17,670,529,141,1875-3-17,388
1875,3,18,495,384,111,1875-3-18,273
1875,3,19,439,363,76,1875-3-19,287
1875,3,20,471,329,142,1875-3-20,187
1875,3,21,502,362,140,1875-3-21,222
1875,3,22,360,247,113,1875-3-22,134
1875,3,23,802,343,459,1875-3-23,-116
1875,3,24,998,296,702,1875-3-24,-406
1875,3,25,816,325,491,1875-3-25,-166
1875,3,26,538,323,215,1875-3-26,108
1875,3,27,288,288,0,1875-3-27,288
1875,3,28,366,366,0,1875-3-28,366
1875,3,29,493,422,71,1875-3-29,351
1875,3,30,316,221,95,1875-3-30,126
1875,3,31,341,238,103,1875-3-31,135
1875,4,1,317,167,150,1875-4-1,17
1875,4,2,316,122,194,1875-4-2,-72
1875,4,3,125,0,125,1875-4-3,-125
1875,4,4,66,0,66,1875-4-4,-66
1875,4,5,16,16,0,1875-4-5,16
1875,4,6,51,51,0,1875-4-6,51
1875,4,7,59,59,0,1875-4-7,59
1875,4,8,17,17,0,1875-4-8,17
1875,4,9,16,16,0,1875-4-9,16
1875,4,10,540,106,434,1875-4-10,-328
1875,4,11,580,130,450,1875-4-11,-320
1875,4,12,620,154,466,1875-4-12,-312
1875,4,13,660,178,482,1875-4-13,-304
1875,4,14,613,184,429,1875-4-14,-245
1875,4,15,487,117,370,1875-4-15,-253
1875,4,16,505,169,336,1875-4-16,-167
1875,4,17,478,148,330,1875-4-17,-182
1875,4,18,398,106,292,1875-4-18,-186
1875,4,19,328,76,252,1875-4-19,-176
1875,4,20,352,109,243,1875-4-20,-134
1875,4,21,297,51,246,1875-4-21,-195
1875,4,22,39,39,0,1875-4-22,39
1875,4,23,0,0,0,1875-4-23,0
1875,4,24,0,0,0,1875-4-24,0
1875,4,25,263,0,263,1875-4-25,-263
1875,4,26,736,552,184,1875-4-26,368
1875,4,27,1046,823,223,1875-4-27,600
1875,4,28,951,773,178,1875-4-28,595
1875,4,29,1128,981,147,1875-4-29,834
1875,4,30,811,773,38,1875-4-30,735
1875,5,1,855,766,89,1875-5-1,677
1875,5,2,707,623,84,1875-5-2,539
1875,5,3,770,691,79,1875-5-3,612
1875,5,4,616,564,52,1875-5-4,512
1875,5,5,616,590,26,1875-5-5,564
1875,5,6,397,397,0,1875-5-6,397
1875,5,7,351,351,0,1875-5-7,351
1875,5,8,0,0,0,1875-5-8,0
1875,5,9,0,0,0,1875-5-9,0
1875,5,10,0,0,0,1875-5-10,0
1875,5,11,0,0,0,1875-5-11,0
1875,5,12,0,0,0,1875-5-12,0
1875,5,13,0,0,0,1875-5-13,0
1875,5,14,0,0,0,1875-5-14,0
1875,5,15,0,0,0,1875-5-15,0
1875,5,16,0,0,0,1875-5-16,0
1875,5,17,0,0,0,1875-5-17,0
1875,5,18,0,0,0,1875-5-18,0
1875,5,19,0,0,0,1875-5-19,0
1875,5,20,0,0,0,1875-5-20,0
1875,5,21,0,0,0,1875-5-21,0
1875,5,22,13,13,0,1875-5-22,13
1875,5,23,0,0,0,1875-5-23,0
1875,5,24,81,81,0,1875-5-24,81
1875,5,25,31,31,0,1875-5-25,31
1875,5,26,27,27,0,1875-5-26,27
1875,5,27,26,26,0,1875-5-27,26
1875,5,28,18,18,0,1875-5-28,18
1875,5,29,0,0,0,1875-5-29,0
1875,5,30,0,0,0,1875-5-30,0
1875,5,31,0,0,0,1875-5-31,0
1875,6,1,79,0,79,1875-6-1,-79
1875,6,2,202,0,202,1875-6-2,-202
1875,6,3,496,0,496,1875-6-3,-496
1875,6,4,478,0,478,1875-6-4,-478
1875,6,5,520,0,520,1875-6-5,-520
1875,6,6,514,0,514,1875-6-6,-514
1875,6,7,508,0,508,1875-6-7,-508
1875,6,8,502,0,502,1875-6-8,-502
1875,6,9,468,0,468,1875-6-9,-468
1875,6,10,433,0,433,1875-6-10,-433
1875,6,11,457,0,457,1875-6-11,-457
1875,6,12,0,0,0,1875-6-12,0
1875,6,13,0,0,0,1875-6-13,0
1875,6,14,0,0,0,1875-6-14,0
1875,6,15,-1,-1,-1,1875-6-15,0
1875,6,16,179,179,0,1875-6-16,179
1875,6,17,545,545,0,1875-6-17,545
1875,6,18,634,634,0,1875-6-18,634
1875,6,19,722,722,0,1875-6-19,722
1875,6,20,527,527,0,1875-6-20,527
1875,6,21,411,393,18,1875-6-21,375
1875,6,22,646,440,206,1875-6-22,234
1875,6,23,884,333,551,1875-6-23,-218
1875,6,24,932,157,775,1875-6-24,-618
1875,6,25,856,0,856,1875-6-25,-856
1875,6,26,826,0,826,1875-6-26,-826
1875,6,27,781,0,781,1875-6-27,-781
1875,6,28,191,28,163,1875-6-28,-135
1875,6,29,162,51,111,1875-6-29,-60
1875,6,30,213,83,130,1875-6-30,-47
1875,7,1,222,106,116,1875-7-1,-10
1875,7,2,241,139,102,1875-7-2,37
1875,7,3,93,0,93,1875-7-3,-93
1875,7,4,67,0,67,1875-7-4,-67
1875,7,5,40,0,40,1875-7-5,-40
1875,7,6,38,0,38,1875-7-6,-38
1875,7,7,0,0,0,1875-7-7,0
1875,7,8,27,27,0,1875-7-8,27
1875,7,9,159,159,0,1875-7-9,159
1875,7,10,144,144,0,1875-7-10,144
1875,7,11,115,115,0,1875-7-11,115
1875,7,12,86,86,0,1875-7-12,86
1875,7,13,69,69,0,1875-7-13,69
1875,7,14,45,45,0,1875-7-14,45
1875,7,15,0,0,0,1875-7-15,0
1875,7,16,0,0,0,1875-7-16,0
1875,7,17,30,30,0,1875-7-17,30
1875,7,18,0,0,0,1875-7-18,0
1875,7,19,0,0,0,1875-7-19,0
1875,7,20,0,0,0,1875-7-20,0
1875,7,21,0,0,0,1875-7-21,0
1875,7,22,0,0,0,1875-7-22,0
1875,7,23,0,0,0,1875-7-23,0
1875,7,24,12,12,0,1875-7-24,12
1875,7,25,22,22,0,1875-7-25,22
1875,7,26,172,172,0,1875-7-26,172
1875,7,27,95,95,0,1875-7-27,95
1875,7,28,171,171,0,1875-7-28,171
1875,7,29,209,209,0,1875-7-29,209
1875,7,30,167,167,0,1875-7-30,167
1875,7,31,156,156,0,1875-7-31,156
1875,8,1,323,323,0,1875-8-1,323
1875,8,2,490,490,0,1875-8-2,490
1875,8,3,269,269,0,1875-8-3,269
1875,8,4,235,235,0,1875-8-4,235
1875,8,5,200,200,0,1875-8-5,200
1875,8,6,0,0,0,1875-8-6,0
1875,8,7,0,0,0,1875-8-7,0
1875,8,8,0,0,0,1875-8-8,0
1875,8,9,0,0,0,1875-8-9,0
1875,8,10,0,0,0,1875-8-10,0
1875,8,11,0,0,0,1875-8-11,0
1875,8,12,0,0,0,1875-8-12,0
1875,8,13,0,0,0,1875-8-13,0
1875,8,14,0,0,0,1875-8-14,0
1875,8,15,0,0,0,1875-8-15,0
1875,8,16,0,0,0,1875-8-16,0
1875,8,17,0,0,0,1875-8-17,0
1875,8,18,0,0,0,1875-8-18,0
1875,8,19,0,0,0,1875-8-19,0
1875,8,20,102,102,0,1875-8-20,102
1875,8,21,497,497,0,1875-8-21,497
1875,8,22,382,382,0,1875-8-22,382
1875,8,23,303,303,0,1875-8-23,303
1875,8,24,193,193,0,1875-8-24,193
1875,8,25,157,157,0,1875-8-25,157
1875,8,26,105,105,0,1875-8-26,105
1875,8,27,151,151,0,1875-8-27,151
1875,8,28,104,104,0,1875-8-28,104
1875,8,29,128,128,0,1875-8-29,128
1875,8,30,137,123,14,1875-8-30,109
1875,8,31,75,75,0,1875-8-31,75
1875,9,1,0,0,0,1875-9-1,0
1875,9,2,0,0,0,1875-9-2,0
1875,9,3,0,0,0,1875-9-3,0
1875,9,4,0,0,0,1875-9-4,0
1875,9,5,0,0,0,1875-9-5,0
1875,9,6,0,0,0,1875-9-6,0
1875,9,7,0,0,0,1875-9-7,0
1875,9,8,0,0,0,1875-9-8,0
1875,9,9,17,0,17,1875-9-9,-17
1875,9,10,25,0,25,1875-9-10,-25
1875,9,11,33,0,33,1875-9-11,-33
1875,9,12,0,0,0,1875-9-12,0
1875,9,13,0,0,0,1875-9-13,0
1875,9,14,173,173,0,1875-9-14,173
1875,9,15,87,87,0,1875-9-15,87
1875,9,16,43,43,0,1875-9-16,43
1875,9,17,0,0,0,1875-9-17,0
1875,9,18,0,0,0,1875-9-18,0
1875,9,19,0,0,0,1875-9-19,0
1875,9,20,0,0,0,1875-9-20,0
1875,9,21,0,0,0,1875-9-21,0
1875,9,22,0,0,0,1875-9-22,0
1875,9,23,0,0,0,1875-9-23,0
1875,9,24,0,0,0,1875-9-24,0
1875,9,25,0,0,0,1875-9-25,0
1875,9,26,0,0,0,1875-9-26,0
1875,9,27,111,0,111,1875-9-27,-111
1875,9,28,213,0,213,1875-9-28,-213
1875,9,29,185,0,185,1875-9-29,-185
1875,9,30,134,0,134,1875-9-30,-134
1875,10,1,77,0,77,1875-10-1,-77
1875,10,2,239,0,239,1875-10-2,-239
1875,10,3,155,0,155,1875-10-3,-155
1875,10,4,143,0,143,1875-10-4,-143
1875,10,5,128,43,85,1875-10-5,-42
1875,10,6,96,23,73,1875-10-6,-50
1875,10,7,142,122,20,1875-10-7,102
1875,10,8,58,58,0,1875-10-8,58
1875,10,9,32,32,0,1875-10-9,32
1875,10,10,32,32,0,1875-10-10,32
1875,10,11,0,0,0,1875-10-11,0
1875,10,12,0,0,0,1875-10-12,0
1875,10,13,0,0,0,1875-10-13,0
1875,10,14,0,0,0,1875-10-14,0
1875,10,15,0,0,0,1875-10-15,0
1875,10,16,0,0,0,1875-10-16,0
1875,10,17,0,0,0,1875-10-17,0
1875,10,18,39,0,39,1875-10-18,-39
1875,10,19,0,0,0,1875-10-19,0
1875,10,20,0,0,0,1875-10-20,0
1875,10,21,22,22,0,1875-10-21,22
1875,10,22,0,0,0,1875-10-22,0
1875,10,23,0,0,0,1875-10-23,0
1875,10,24,0,0,0,1875-10-24,0
1875,10,25,505,505,0,1875-10-25,505
1875,10,26,319,319,0,1875-10-26,319
1875,10,27,432,432,0,1875-10-27,432
1875,10,28,381,381,0,1875-10-28,381
1875,10,29,475,475,0,1875-10-29,475
1875,10,30,424,424,0,1875-10-30,424
1875,10,31,405,405,0,1875-10-31,405
1875,11,1,386,386,0,1875-11-1,386
1875,11,2,305,305,0,1875-11-2,305
1875,11,3,343,343,0,1875-11-3,343
1875,11,4,-1,-1,-1,1875-11-4,0
1875,11,5,0,0,0,1875-11-5,0
1875,11,6,0,0,0,1875-11-6,0
1875,11,7,0,0,0,1875-11-7,0
1875,11,8,0,0,0,1875-11-8,0
1875,11,9,0,0,0,1875-11-9,0
1875,11,10,0,0,0,1875-11-10,0
1875,11,11,0,0,0,1875-11-11,0
1875,11,12,0,0,0,1875-11-12,0
1875,11,13,0,0,0,1875-11-13,0
1875,11,14,0,0,0,1875-11-14,0
1875,11,15,9,9,0,1875-11-15,9
1875,11,16,0,0,0,1875-11-16,0
1875,11,17,0,0,0,1875-11-17,0
1875,11,18,197,0,197,1875-11-18,-197
1875,11,19,218,36,182,1875-11-19,-146
1875,11,20,446,144,302,1875-11-20,-158
1875,11,21,478,110,368,1875-11-21,-258
1875,11,22,507,74,433,1875-11-22,-359
1875,11,23,477,72,405,1875-11-23,-333
1875,11,24,448,51,397,1875-11-24,-346
1875,11,25,449,61,388,1875-11-25,-327
1875,11,26,330,46,284,1875-11-26,-238
1875,11,27,330,8,322,1875-11-27,-314
1875,11,28,219,0,219,1875-11-28,-219
1875,11,29,249,0,249,1875-11-29,-249
1875,11,30,234,0,234,1875-11-30,-234
1875,12,1,0,0,0,1875-12-1,0
1875,12,2,0,0,0,1875-12-2,0
1875,12,3,0,0,0,1875-12-3,0
1875,12,4,0,0,0,1875-12-4,0
1875,12,5,0,0,0,1875-12-5,0
1875,12,6,0,0,0,1875-12-6,0
1875,12,7,0,0,0,1875-12-7,0
1875,12,8,0,0,0,1875-12-8,0
1875,12,9,0,0,0,1875-12-9,0
1875,12,10,0,0,0,1875-12-10,0
1875,12,11,0,0,0,1875-12-11,0
1875,12,12,0,0,0,1875-12-12,0
1875,12,13,0,0,0,1875-12-13,0
1875,12,14,21,11,10,1875-12-14,1
1875,12,15,345,0,345,1875-12-15,-345
1875,12,16,388,0,388,1875-12-16,-388
1875,12,17,436,0,436,1875-12-17,-436
1875,12,18,427,0,427,1875-12-18,-427
1875,12,19,288,0,288,1875-12-19,-288
1875,12,20,249,0,249,1875-12-20,-249
1875,12,21,197,0,197,1875-12-21,-197
1875,12,22,166,0,166,1875-12-22,-166
1875,12,23,188,0,188,1875-12-23,-188
1875,12,24,84,0,84,1875-12-24,-84
1875,12,25,0,0,0,1875-12-25,0
1875,12,26,0,0,0,1875-12-26,0
1875,12,27,0,0,0,1875-12-27,0
1875,12,28,0,0,0,1875-12-28,0
1875,12,29,0,0,0,1875-12-29,0
1875,12,30,33,0,33,1875-12-30,-33
1875,12,31,0,0,0,1875-12-31,0
1876,1,1,0,0,0,1876-1-1,0
1876,1,2,0,0,0,1876-1-2,0
1876,1,3,0,0,0,1876-1-3,0
1876,1,4,0,0,0,1876-1-4,0
1876,1,5,16,0,16,1876-1-5,-16
1876,1,6,0,0,0,1876-1-6,0
1876,1,7,0,0,0,1876-1-7,0
1876,1,8,0,0,0,1876-1-8,0
1876,1,9,0,0,0,1876-1-9,0
1876,1,10,0,0,0,1876-1-10,0
1876,1,11,31,31,0,1876-1-11,31
1876,1,12,24,24,0,1876-1-12,24
1876,1,13,0,0,0,1876-1-13,0
1876,1,14,0,0,0,1876-1-14,0
1876,1,15,0,0,0,1876-1-15,0
1876,1,16,0,0,0,1876-1-16,0
1876,1,17,0,0,0,1876-1-17,0
1876,1,18,292,26,266,1876-1-18,-240
1876,1,19,820,162,658,1876-1-19,-496
1876,1,20,643,153,490,1876-1-20,-337
1876,1,21,516,111,405,1876-1-21,-294
1876,1,22,582,291,291,1876-1-22,0
1876,1,23,397,0,397,1876-1-23,-397
1876,1,24,564,0,564,1876-1-24,-564
1876,1,25,582,0,582,1876-1-25,-582
1876,1,26,253,0,253,1876-1-26,-253
1876,1,27,206,0,206,1876-1-27,-206
1876,1,28,52,0,52,1876-1-28,-52
1876,1,29,130,0,130,1876-1-29,-130
1876,1,30,49,0,49,1876-1-30,-49
1876,1,31,35,0,35,1876-1-31,-35
1876,2,1,30,0,30,1876-2-1,-30
1876,2,2,25,0,25,1876-2-2,-25
1876,2,3,16,0,16,1876-2-3,-16
1876,2,4,6,0,6,1876-2-4,-6
1876,2,5,0,0,0,1876-2-5,0
1876,2,6,0,0,0,1876-2-6,0
1876,2,7,0,0,0,1876-2-7,0
1876,2,8,0,0,0,1876-2-8,0
1876,2,9,0,0,0,1876-2-9,0
1876,2,10,377,0,377,1876-2-10,-377
1876,2,11,512,0,512,1876-2-11,-512
1876,2,12,647,0,647,1876-2-12,-647
1876,2,13,695,0,695,1876-2-13,-695
1876,2,14,695,0,695,1876-2-14,-695
1876,2,15,642,0,642,1876-2-15,-642
1876,2,16,711,0,711,1876-2-16,-711
1876,2,17,701,0,701,1876-2-17,-701
1876,2,18,516,0,516,1876-2-18,-516
1876,2,19,541,0,541,1876-2-19,-541
1876,2,20,471,0,471,1876-2-20,-471
1876,2,21,401,0,401,1876-2-21,-401
1876,2,22,334,0,334,1876-2-22,-334
1876,2,23,0,0,0,1876-2-23,0
1876,2,24,0,0,0,1876-2-24,0
1876,2,25,0,0,0,1876-2-25,0
1876,2,26,97,97,0,1876-2-26,97
1876,2,27,81,81,0,1876-2-27,81
1876,2,28,65,65,0,1876-2-28,65
1876,2,29,80,80,0,1876-2-29,80
1876,3,1,200,128,72,1876-3-1,56
1876,3,2,16,0,16,1876-3-2,-16
1876,3,3,0,0,0,1876-3-3,0
1876,3,4,0,0,0,1876-3-4,0
1876,3,5,0,0,0,1876-3-5,0
1876,3,6,39,39,0,1876-3-6,39
1876,3,7,26,26,0,1876-3-7,26
1876,3,8,0,0,0,1876-3-8,0
1876,3,9,100,0,100,1876-3-9,-100
1876,3,10,86,0,86,1876-3-10,-86
1876,3,11,66,0,66,1876-3-11,-66
1876,3,12,62,0,62,1876-3-12,-62
1876,3,13,273,215,58,1876-3-13,157
1876,3,14,233,176,57,1876-3-14,119
1876,3,15,168,123,45,1876-3-15,78
1876,3,16,245,185,60,1876-3-16,125
1876,3,17,405,154,251,1876-3-17,-97
1876,3,18,328,56,272,1876-3-18,-216
1876,3,19,408,57,351,1876-3-19,-294
1876,3,20,510,325,185,1876-3-20,140
1876,3,21,440,322,118,1876-3-21,204
1876,3,22,625,546,79,1876-3-22,467
1876,3,23,483,442,41,1876-3-23,401
1876,3,24,512,498,14,1876-3-24,484
1876,3,25,459,459,0,1876-3-25,459
1876,3,26,396,396,0,1876-3-26,396
1876,3,27,350,350,0,1876-3-27,350
1876,3,28,266,266,0,1876-3-28,266
1876,3,29,275,275,0,1876-3-29,275
1876,3,30,203,203,0,1876-3-30,203
1876,3,31,0,0,0,1876-3-31,0
1876,4,1,0,0,0,1876-4-1,0
1876,4,2,0,0,0,1876-4-2,0
1876,4,3,0,0,0,1876-4-3,0
1876,4,4,4,0,4,1876-4-4,-4
1876,4,5,0,0,0,1876-4-5,0
1876,4,6,99,0,99,1876-4-6,-99
1876,4,7,0,0,0,1876-4-7,0
1876,4,8,19,19,0,1876-4-8,19
1876,4,9,16,16,0,1876-4-9,16
1876,4,10,43,43,0,1876-4-10,43
1876,4,11,30,30,0,1876-4-11,30
1876,4,12,65,65,0,1876-4-12,65
1876,4,13,41,41,0,1876-4-13,41
1876,4,14,46,0,46,1876-4-14,-46
1876,4,15,24,0,24,1876-4-15,-24
1876,4,16,8,0,8,1876-4-16,-8
1876,4,17,59,0,59,1876-4-17,-59
1876,4,18,19,0,19,1876-4-18,-19
1876,4,19,0,0,0,1876-4-19,0
1876,4,20,0,0,0,1876-4-20,0
1876,4,21,0,0,0,1876-4-21,0
1876,4,22,0,0,0,1876-4-22,0
1876,4,23,0,0,0,1876-4-23,0
1876,4,24,0,0,0,1876-4-24,0
1876,4,25,0,0,0,1876-4-25,0
1876,4,26,0,0,0,1876-4-26,0
1876,4,27,0,0,0,1876-4-27,0
1876,4,28,0,0,0,1876-4-28,0
1876,4,29,0,0,0,1876-4-29,0
1876,4,30,0,0,0,1876-4-30,0
1876,5,1,0,0,0,1876-5-1,0
1876,5,2,0,0,0,1876-5-2,0
1876,5,3,0,0,0,1876-5-3,0
1876,5,4,0,0,0,1876-5-4,0
1876,5,5,0,0,0,1876-5-5,0
1876,5,6,0,0,0,1876-5-6,0
1876,5,7,229,0,229,1876-5-7,-229
1876,5,8,176,0,176,1876-5-8,-176
1876,5,9,158,0,158,1876-5-9,-158
1876,5,10,112,0,112,1876-5-10,-112
1876,5,11,89,0,89,1876-5-11,-89
1876,5,12,108,0,108,1876-5-12,-108
1876,5,13,106,0,106,1876-5-13,-106
1876,5,14,58,0,58,1876-5-14,-58
1876,5,15,9,0,9,1876-5-15,-9
1876,5,16,0,0,0,1876-5-16,0
1876,5,17,0,0,0,1876-5-17,0
1876,5,18,0,0,0,1876-5-18,0
1876,5,19,0,0,0,1876-5-19,0
1876,5,20,0,0,0,1876-5-20,0
1876,5,21,0,0,0,1876-5-21,0
1876,5,22,0,0,0,1876-5-22,0
1876,5,23,0,0,0,1876-5-23,0
1876,5,24,0,0,0,1876-5-24,0
1876,5,25,55,0,55,1876-5-25,-55
1876,5,26,31,0,31,1876-5-26,-31
1876,5,27,24,0,24,1876-5-27,-24
1876,5,28,0,0,0,1876-5-28,0
1876,5,29,0,0,0,1876-5-29,0
1876,5,30,0,0,0,1876-5-30,0
1876,5,31,0,0,0,1876-5-31,0
1876,6,1,0,0,0,1876-6-1,0
1876,6,2,0,0,0,1876-6-2,0
1876,6,3,0,0,0,1876-6-3,0
1876,6,4,0,0,0,1876-6-4,0
1876,6,5,0,0,0,1876-6-5,0
1876,6,6,0,0,0,1876-6-6,0
1876,6,7,0,0,0,1876-6-7,0
1876,6,8,0,0,0,1876-6-8,0
1876,6,9,0,0,0,1876-6-9,0
1876,6,10,0,0,0,1876-6-10,0
1876,6,11,0,0,0,1876-6-11,0
1876,6,12,0,0,0,1876-6-12,0
1876,6,13,0,0,0,1876-6-13,0
1876,6,14,0,0,0,1876-6-14,0
1876,6,15,0,0,0,1876-6-15,0
1876,6,16,0,0,0,1876-6-16,0
1876,6,17,0,0,0,1876-6-17,0
1876,6,18,0,0,0,1876-6-18,0
1876,6,19,0,0,0,1876-6-19,0
1876,6,20,0,0,0,1876-6-20,0
1876,6,21,40,40,0,1876-6-21,40
1876,6,22,22,0,22,1876-6-22,-22
1876,6,23,25,0,25,1876-6-23,-25
1876,6,24,21,0,21,1876-6-24,-21
1876,6,25,0,0,0,1876-6-25,0
1876,6,26,6,0,6,1876-6-26,-6
1876,6,27,58,58,0,1876-6-27,58
1876,6,28,76,76,0,1876-6-28,76
1876,6,29,209,209,0,1876-6-29,209
1876,6,30,0,0,0,1876-6-30,0
1876,7,1,0,0,0,1876-7-1,0
1876,7,2,-1,-1,-1,1876-7-2,0
1876,7,3,363,0,363,1876-7-3,-363
1876,7,4,250,0,250,1876-7-4,-250
1876,7,5,138,0,138,1876-7-5,-138
1876,7,6,123,56,67,1876-7-6,-11
1876,7,7,86,21,65,1876-7-7,-44
1876,7,8,124,5,119,1876-7-8,-114
1876,7,9,74,0,74,1876-7-9,-74
1876,7,10,27,4,23,1876-7-10,-19
1876,7,11,25,0,25,1876-7-11,-25
1876,7,12,0,0,0,1876-7-12,0
1876,7,13,0,0,0,1876-7-13,0
1876,7,14,0,0,0,1876-7-14,0
1876,7,15,0,0,0,1876-7-15,0
1876,7,16,0,0,0,1876-7-16,0
1876,7,17,0,0,0,1876-7-17,0
1876,7,18,0,0,0,1876-7-18,0
1876,7,19,58,58,0,1876-7-19,58
1876,7,20,58,36,22,1876-7-20,14
1876,7,21,133,8,125,1876-7-21,-117
1876,7,22,111,9,102,1876-7-22,-93
1876,7,23,90,0,90,1876-7-23,-90
1876,7,24,78,0,78,1876-7-24,-78
1876,7,25,100,0,100,1876-7-25,-100
1876,7,26,66,0,66,1876-7-26,-66
1876,7,27,42,0,42,1876-7-27,-42
1876,7,28,17,0,17,1876-7-28,-17
1876,7,29,0,0,0,1876-7-29,0
1876,7,30,0,0,0,1876-7-30,0
1876,7,31,72,0,72,1876-7-31,-72
1876,8,1,0,0,0,1876-8-1,0
1876,8,2,0,0,0,1876-8-2,0
1876,8,3,0,0,0,1876-8-3,0
1876,8,4,0,0,0,1876-8-4,0
1876,8,5,0,0,0,1876-8-5,0
1876,8,6,0,0,0,1876-8-6,0
1876,8,7,87,87,0,1876-8-7,87
1876,8,8,0,0,0,1876-8-8,0
1876,8,9,0,0,0,1876-8-9,0
1876,8,10,0,0,0,1876-8-10,0
1876,8,11,0,0,0,1876-8-11,0
1876,8,12,0,0,0,1876-8-12,0
1876,8,13,0,0,0,1876-8-13,0
1876,8,14,0,0,0,1876-8-14,0
1876,8,15,0,0,0,1876-8-15,0
1876,8,16,41,0,41,1876-8-16,-41
1876,8,17,127,0,127,1876-8-17,-127
1876,8,18,111,0,111,1876-8-18,-111
1876,8,19,80,0,80,1876-8-19,-80
1876,8,20,0,0,0,1876-8-20,0
1876,8,21,0,0,0,1876-8-21,0
1876,8,22,45,0,45,1876-8-22,-45
1876,8,23,40,0,40,1876-8-23,-40
1876,8,24,69,0,69,1876-8-24,-69
1876,8,25,97,0,97,1876-8-25,-97
1876,8,26,83,0,83,1876-8-26,-83
1876,8,27,86,0,86,1876-8-27,-86
1876,8,28,89,0,89,1876-8-28,-89
1876,8,29,27,0,27,1876-8-29,-27
1876,8,30,50,0,50,1876-8-30,-50
1876,8,31,44,0,44,1876-8-31,-44
1876,9,1,70,0,70,1876-9-1,-70
1876,9,2,189,0,189,1876-9-2,-189
1876,9,3,136,0,136,1876-9-3,-136
1876,9,4,83,0,83,1876-9-4,-83
1876,9,5,9,0,9,1876-9-5,-9
1876,9,6,0,0,0,1876-9-6,0
1876,9,7,0,0,0,1876-9-7,0
1876,9,8,0,0,0,1876-9-8,0
1876,9,9,0,0,0,1876-9-9,0
1876,9,10,0,0,0,1876-9-10,0
1876,9,11,0,0,0,1876-9-11,0
1876,9,12,0,0,0,1876-9-12,0
1876,9,13,-1,-1,-1,1876-9-13,0
1876,9,14,157,0,157,1876-9-14,-157
1876,9,15,136,0,136,1876-9-15,-136
1876,9,16,106,0,106,1876-9-16,-106
1876,9,17,116,0,116,1876-9-17,-116
1876,9,18,157,31,126,1876-9-18,-95
1876,9,19,-1,-1,-1,1876-9-19,0
1876,9,20,-1,-1,-1,1876-9-20,0
1876,9,21,0,0,0,1876-9-21,0
1876,9,22,0,0,0,1876-9-22,0
1876,9,23,0,0,0,1876-9-23,0
1876,9,24,0,0,0,1876-9-24,0
1876,9,25,0,0,0,1876-9-25,0
1876,9,26,-1,-1,-1,1876-9-26,0
1876,9,27,403,0,403,1876-9-27,-403
1876,9,28,341,0,341,1876-9-28,-341
1876,9,29,421,0,421,1876-9-29,-421
1876,9,30,390,0,390,1876-9-30,-390
1876,10,1,315,0,315,1876-10-1,-315
1876,10,2,239,0,239,1876-10-2,-239
1876,10,3,238,0,238,1876-10-3,-238
1876,10,4,180,0,180,1876-10-4,-180
1876,10,5,172,0,172,1876-10-5,-172
1876,10,6,131,0,131,1876-10-6,-131
1876,10,7,0,0,0,1876-10-7,0
1876,10,8,0,0,0,1876-10-8,0
1876,10,9,0,0,0,1876-10-9,0
1876,10,10,0,0,0,1876-10-10,0
1876,10,11,18,0,18,1876-10-11,-18
1876,10,12,99,0,99,1876-10-12,-99
1876,10,13,123,0,123,1876-10-13,-123
1876,10,14,147,0,147,1876-10-14,-147
1876,10,15,171,0,171,1876-10-15,-171
1876,10,16,195,0,195,1876-10-16,-195
1876,10,17,694,0,694,1876-10-17,-694
1876,10,18,331,0,331,1876-10-18,-331
1876,10,19,308,0,308,1876-10-19,-308
1876,10,20,270,0,270,1876-10-20,-270
1876,10,21,234,0,234,1876-10-21,-234
1876,10,22,238,0,238,1876-10-22,-238
1876,10,23,241,0,241,1876-10-23,-241
1876,10,24,179,0,179,1876-10-24,-179
1876,10,25,116,0,116,1876-10-25,-116
1876,10,26,79,0,79,1876-10-26,-79
1876,10,27,95,0,95,1876-10-27,-95
1876,10,28,0,0,0,1876-10-28,0
1876,10,29,0,0,0,1876-10-29,0
1876,10,30,0,0,0,1876-10-30,0
1876,10,31,0,0,0,1876-10-31,0
1876,11,1,0,0,0,1876-11-1,0
1876,11,2,143,143,0,1876-11-2,143
1876,11,3,271,271,0,1876-11-3,271
1876,11,4,172,172,0,1876-11-4,172
1876,11,5,0,0,0,1876-11-5,0
1876,11,6,0,0,0,1876-11-6,0
1876,11,7,0,0,0,1876-11-7,0
1876,11,8,0,0,0,1876-11-8,0
1876,11,9,28,0,28,1876-11-9,-28
1876,11,10,0,0,0,1876-11-10,0
1876,11,11,0,0,0,1876-11-11,0
1876,11,12,0,0,0,1876-11-12,0
1876,11,13,150,84,66,1876-11-13,18
1876,11,14,125,125,0,1876-11-14,125
1876,11,15,350,65,285,1876-11-15,-220
1876,11,16,249,30,219,1876-11-16,-189
1876,11,17,163,0,163,1876-11-17,-163
1876,11,18,106,0,106,1876-11-18,-106
1876,11,19,187,0,187,1876-11-19,-187
1876,11,20,63,0,63,1876-11-20,-63
1876,11,21,67,0,67,1876-11-21,-67
1876,11,22,0,0,0,1876-11-22,0
1876,11,23,0,0,0,1876-11-23,0
1876,11,24,0,0,0,1876-11-24,0
1876,11,25,0,0,0,1876-11-25,0
1876,11,26,0,0,0,1876-11-26,0
1876,11,27,0,0,0,1876-11-27,0
1876,11,28,0,0,0,1876-11-28,0
1876,11,29,0,0,0,1876-11-29,0
1876,11,30,0,0,0,1876-11-30,0
1876,12,1,0,0,0,1876-12-1,0
1876,12,2,0,0,0,1876-12-2,0
1876,12,3,0,0,0,1876-12-3,0
1876,12,4,0,0,0,1876-12-4,0
1876,12,5,0,0,0,1876-12-5,0
1876,12,6,0,0,0,1876-12-6,0
1876,12,7,0,0,0,1876-12-7,0
1876,12,8,0,0,0,1876-12-8,0
1876,12,9,0,0,0,1876-12-9,0
1876,12,10,0,0,0,1876-12-10,0
1876,12,11,0,0,0,1876-12-11,0
1876,12,12,0,0,0,1876-12-12,0
1876,12,13,0,0,0,1876-12-13,0
1876,12,14,0,0,0,1876-12-14,0
1876,12,15,0,0,0,1876-12-15,0
1876,12,16,0,0,0,1876-12-16,0
1876,12,17,0,0,0,1876-12-17,0
1876,12,18,258,258,0,1876-12-18,258
1876,12,19,394,394,0,1876-12-19,394
1876,12,20,402,402,0,1876-12-20,402
1876,12,21,150,150,0,1876-12-21,150
1876,12,22,667,667,0,1876-12-22,667
1876,12,23,274,274,0,1876-12-23,274
1876,12,24,331,331,0,1876-12-24,331
1876,12,25,388,388,0,1876-12-25,388
1876,12,26,445,445,0,1876-12-26,445
1876,12,27,501,501,0,1876-12-27,501
1876,12,28,440,440,0,1876-12-28,440
1876,12,29,378,378,0,1876-12-29,378
1876,12,30,0,0,0,1876-12-30,0
1876,12,31,0,0,0,1876-12-31,0
1877,1,1,0,0,0,1877-1-1,0
1877,1,2,0,0,0,1877-1-2,0
1877,1,3,0,0,0,1877-1-3,0
1877,1,4,0,0,0,1877-1-4,0
1877,1,5,0,0,0,1877-1-5,0
1877,1,6,58,58,0,1877-1-6,58
1877,1,7,0,0,0,1877-1-7,0
1877,1,8,18,18,0,1877-1-8,18
1877,1,9,8,8,0,1877-1-9,8
1877,1,10,471,422,49,1877-1-10,373
1877,1,11,361,315,46,1877-1-11,269
1877,1,12,220,220,0,1877-1-12,220
1877,1,13,197,197,0,1877-1-13,197
1877,1,14,206,206,0,1877-1-14,206
1877,1,15,540,540,0,1877-1-15,540
1877,1,16,541,541,0,1877-1-16,541
1877,1,17,543,543,0,1877-1-17,543
1877,1,18,548,548,0,1877-1-18,548
1877,1,19,591,591,0,1877-1-19,591
1877,1,20,418,418,0,1877-1-20,418
1877,1,21,389,389,0,1877-1-21,389
1877,1,22,358,358,0,1877-1-22,358
1877,1,23,88,88,0,1877-1-23,88
1877,1,24,86,86,0,1877-1-24,86
1877,1,25,156,156,0,1877-1-25,156
1877,1,26,28,0,28,1877-1-26,-28
1877,1,27,11,0,11,1877-1-27,-11
1877,1,28,0,0,0,1877-1-28,0
1877,1,29,0,0,0,1877-1-29,0
1877,1,30,9,0,9,1877-1-30,-9
1877,1,31,12,0,12,1877-1-31,-12
1877,2,1,13,0,13,1877-2-1,-13
1877,2,2,14,0,14,1877-2-2,-14
1877,2,3,16,0,16,1877-2-3,-16
1877,2,4,13,0,13,1877-2-4,-13
1877,2,5,10,0,10,1877-2-5,-10
1877,2,6,7,0,7,1877-2-6,-7
1877,2,7,130,124,6,1877-2-7,118
1877,2,8,154,154,0,1877-2-8,154
1877,2,9,141,141,0,1877-2-9,141
1877,2,10,128,128,0,1877-2-10,128
1877,2,11,127,127,0,1877-2-11,127
1877,2,12,126,126,0,1877-2-12,126
1877,2,13,125,125,0,1877-2-13,125
1877,2,14,124,124,0,1877-2-14,124
1877,2,15,124,124,0,1877-2-15,124
1877,2,16,123,123,0,1877-2-16,123
1877,2,17,146,146,0,1877-2-17,146
1877,2,18,0,0,0,1877-2-18,0
1877,2,19,0,0,0,1877-2-19,0
1877,2,20,0,0,0,1877-2-20,0
1877,2,21,0,0,0,1877-2-21,0
1877,2,22,0,0,0,1877-2-22,0
1877,2,23,0,0,0,1877-2-23,0
1877,2,24,0,0,0,1877-2-24,0
1877,2,25,0,0,0,1877-2-25,0
1877,2,26,112,112,0,1877-2-26,112
1877,2,27,133,133,0,1877-2-27,133
1877,2,28,88,88,0,1877-2-28,88
1877,3,1,108,43,65,1877-3-1,-22
1877,3,2,134,30,104,1877-3-2,-74
1877,3,3,159,16,143,1877-3-3,-127
1877,3,4,176,28,148,1877-3-4,-120
1877,3,5,191,39,152,1877-3-5,-113
1877,3,6,0,0,0,1877-3-6,0
1877,3,7,0,0,0,1877-3-7,0
1877,3,8,36,0,36,1877-3-8,-36
1877,3,9,37,0,37,1877-3-9,-37
1877,3,10,40,0,40,1877-3-10,-40
1877,3,11,0,0,0,1877-3-11,0
1877,3,12,0,0,0,1877-3-12,0
1877,3,13,0,0,0,1877-3-13,0
1877,3,14,0,0,0,1877-3-14,0
1877,3,15,0,0,0,1877-3-15,0
1877,3,16,0,0,0,1877-3-16,0
1877,3,17,39,0,39,1877-3-17,-39
1877,3,18,197,0,197,1877-3-18,-197
1877,3,19,261,0,261,1877-3-19,-261
1877,3,20,249,0,249,1877-3-20,-249
1877,3,21,238,0,238,1877-3-21,-238
1877,3,22,173,0,173,1877-3-22,-173
1877,3,23,0,0,0,1877-3-23,0
1877,3,24,0,0,0,1877-3-24,0
1877,3,25,0,0,0,1877-3-25,0
1877,3,26,0,0,0,1877-3-26,0
1877,3,27,0,0,0,1877-3-27,0
1877,3,28,0,0,0,1877-3-28,0
1877,3,29,0,0,0,1877-3-29,0
1877,3,30,0,0,0,1877-3-30,0
1877,3,31,0,0,0,1877-3-31,0
1877,4,1,0,0,0,1877-4-1,0
1877,4,2,0,0,0,1877-4-2,0
1877,4,3,0,0,0,1877-4-3,0
1877,4,4,0,0,0,1877-4-4,0
1877,4,5,0,0,0,1877-4-5,0
1877,4,6,63,0,63,1877-4-6,-63
1877,4,7,34,0,34,1877-4-7,-34
1877,4,8,0,0,0,1877-4-8,0
1877,4,9,0,0,0,1877-4-9,0
1877,4,10,0,0,0,1877-4-10,0
1877,4,11,0,0,0,1877-4-11,0
1877,4,12,0,0,0,1877-4-12,0
1877,4,13,0,0,0,1877-4-13,0
1877,4,14,0,0,0,1877-4-14,0
1877,4,15,-1,-1,-1,1877-4-15,0
1877,4,16,368,0,368,1877-4-16,-368
1877,4,17,401,0,401,1877-4-17,-401
1877,4,18,352,0,352,1877-4-18,-352
1877,4,19,302,0,302,1877-4-19,-302
1877,4,20,284,41,243,1877-4-20,-202
1877,4,21,73,73,0,1877-4-21,73
1877,4,22,105,105,0,1877-4-22,105
1877,4,23,210,137,73,1877-4-23,64
1877,4,24,110,69,41,1877-4-24,28
1877,4,25,116,68,48,1877-4-25,20
1877,4,26,98,46,52,1877-4-26,-6
1877,4,27,79,23,56,1877-4-27,-33
1877,4,28,33,0,33,1877-4-28,-33
1877,4,29,33,0,33,1877-4-29,-33
1877,4,30,58,25,33,1877-4-30,-8
1877,5,1,75,47,28,1877-5-1,19
1877,5,2,68,68,0,1877-5-2,68
1877,5,3,48,48,0,1877-5-3,48
1877,5,4,81,32,49,1877-5-4,-17
1877,5,5,31,0,31,1877-5-5,-31
1877,5,6,21,0,21,1877-5-6,-21
1877,5,7,162,0,162,1877-5-7,-162
1877,5,8,159,0,159,1877-5-8,-159
1877,5,9,96,35,61,1877-5-9,-26
1877,5,10,175,107,68,1877-5-10,39
1877,5,11,200,139,61,1877-5-11,78
1877,5,12,131,131,0,1877-5-12,131
1877,5,13,122,122,0,1877-5-13,122
1877,5,14,114,114,0,1877-5-14,114
1877,5,15,105,105,0,1877-5-15,105
1877,5,16,90,90,0,1877-5-16,90
1877,5,17,118,118,0,1877-5-17,118
1877,5,18,106,106,0,1877-5-18,106
1877,5,19,92,92,0,1877-5-19,92
1877,5,20,91,91,0,1877-5-20,91
1877,5,21,90,90,0,1877-5-21,90
1877,5,22,90,90,0,1877-5-22,90
1877,5,23,89,89,0,1877-5-23,89
1877,5,24,89,89,0,1877-5-24,89
1877,5,25,93,93,0,1877-5-25,93
1877,5,26,114,61,53,1877-5-26,8
1877,5,27,0,0,0,1877-5-27,0
1877,5,28,0,0,0,1877-5-28,0
1877,5,29,0,0,0,1877-5-29,0
1877,5,30,0,0,0,1877-5-30,0
1877,5,31,0,0,0,1877-5-31,0
1877,6,1,0,0,0,1877-6-1,0
1877,6,2,0,0,0,1877-6-2,0
1877,6,3,37,0,37,1877-6-3,-37
1877,6,4,238,0,238,1877-6-4,-238
1877,6,5,200,0,200,1877-6-5,-200
1877,6,6,143,0,143,1877-6-6,-143
1877,6,7,144,0,144,1877-6-7,-144
1877,6,8,159,0,159,1877-6-8,-159
1877,6,9,221,0,221,1877-6-9,-221
1877,6,10,203,0,203,1877-6-10,-203
1877,6,11,184,0,184,1877-6-11,-184
1877,6,12,-1,-1,-1,1877-6-12,0
1877,6,13,-1,-1,-1,1877-6-13,0
1877,6,14,0,0,0,1877-6-14,0
1877,6,15,0,0,0,1877-6-15,0
1877,6,16,0,0,0,1877-6-16,0
1877,6,17,0,0,0,1877-6-17,0
1877,6,18,0,0,0,1877-6-18,0
1877,6,19,0,0,0,1877-6-19,0
1877,6,20,0,0,0,1877-6-20,0
1877,6,21,0,0,0,1877-6-21,0
1877,6,22,0,0,0,1877-6-22,0
1877,6,23,0,0,0,1877-6-23,0
1877,6,24,-1,-1,-1,1877-6-24,0
1877,6,25,70,0,70,1877-6-25,-70
1877,6,26,-1,-1,-1,1877-6-26,0
1877,6,27,-1,-1,-1,1877-6-27,0
1877,6,28,30,0,30,1877-6-28,-30
1877,6,29,97,0,97,1877-6-29,-97
1877,6,30,0,0,0,1877-6-30,0
1877,7,1,0,0,0,1877-7-1,0
1877,7,2,0,0,0,1877-7-2,0
1877,7,3,31,31,0,1877-7-3,31
1877,7,4,31,31,0,1877-7-4,31
1877,7,5,25,25,0,1877-7-5,25
1877,7,6,0,0,0,1877-7-6,0
1877,7,7,0,0,0,1877-7-7,0
1877,7,8,0,0,0,1877-7-8,0
1877,7,9,0,0,0,1877-7-9,0
1877,7,10,0,0,0,1877-7-10,0
1877,7,11,0,0,0,1877-7-11,0
1877,7,12,0,0,0,1877-7-12,0
1877,7,13,0,0,0,1877-7-13,0
1877,7,14,26,0,26,1877-7-14,-26
1877,7,15,0,0,0,1877-7-15,0
1877,7,16,0,0,0,1877-7-16,0
1877,7,17,0,0,0,1877-7-17,0
1877,7,18,16,0,16,1877-7-18,-16
1877,7,19,0,0,0,1877-7-19,0
1877,7,20,0,0,0,1877-7-20,0
1877,7,21,0,0,0,1877-7-21,0
1877,7,22,0,0,0,1877-7-22,0
1877,7,23,0,0,0,1877-7-23,0
1877,7,24,0,0,0,1877-7-24,0
1877,7,25,0,0,0,1877-7-25,0
1877,7,26,0,0,0,1877-7-26,0
1877,7,27,0,0,0,1877-7-27,0
1877,7,28,0,0,0,1877-7-28,0
1877,7,29,0,0,0,1877-7-29,0
1877,7,30,0,0,0,1877-7-30,0
1877,7,31,0,0,0,1877-7-31,0
1877,8,1,0,0,0,1877-8-1,0
1877,8,2,47,47,0,1877-8-2,47
1877,8,3,20,20,0,1877-8-3,20
1877,8,4,0,0,0,1877-8-4,0
1877,8,5,0,0,0,1877-8-5,0
1877,8,6,0,0,0,1877-8-6,0
1877,8,7,0,0,0,1877-8-7,0
1877,8,8,0,0,0,1877-8-8,0
1877,8,9,0,0,0,1877-8-9,0
1877,8,10,0,0,0,1877-8-10,0
1877,8,11,0,0,0,1877-8-11,0
1877,8,12,0,0,0,1877-8-12,0
1877,8,13,0,0,0,1877-8-13,0
1877,8,14,0,0,0,1877-8-14,0
1877,8,15,0,0,0,1877-8-15,0
1877,8,16,0,0,0,1877-8-16,0
1877,8,17,0,0,0,1877-8-17,0
1877,8,18,0,0,0,1877-8-18,0
1877,8,19,0,0,0,1877-8-19,0
1877,8,20,0,0,0,1877-8-20,0
1877,8,21,0,0,0,1877-8-21,0
1877,8,22,116,116,0,1877-8-22,116
1877,8,23,149,149,0,1877-8-23,149
1877,8,24,230,230,0,1877-8-24,230
1877,8,25,183,183,0,1877-8-25,183
1877,8,26,135,135,0,1877-8-26,135
1877,8,27,88,88,0,1877-8-27,88
1877,8,28,41,41,0,1877-8-28,41
1877,8,29,30,30,0,1877-8-29,30
1877,8,30,25,25,0,1877-8-30,25
1877,8,31,19,19,0,1877-8-31,19
1877,9,1,0,0,0,1877-9-1,0
1877,9,2,0,0,0,1877-9-2,0
1877,9,3,0,0,0,1877-9-3,0
1877,9,4,117,117,0,1877-9-4,117
1877,9,5,216,216,0,1877-9-5,216
1877,9,6,213,213,0,1877-9-6,213
1877,9,7,249,249,0,1877-9-7,249
1877,9,8,204,204,0,1877-9-8,204
1877,9,9,158,158,0,1877-9-9,158
1877,9,10,140,140,0,1877-9-10,140
1877,9,11,123,123,0,1877-9-11,123
1877,9,12,181,106,75,1877-9-12,31
1877,9,13,65,0,65,1877-9-13,-65
1877,9,14,55,0,55,1877-9-14,-55
1877,9,15,45,0,45,1877-9-15,-45
1877,9,16,35,0,35,1877-9-16,-35
1877,9,17,25,0,25,1877-9-17,-25
1877,9,18,27,0,27,1877-9-18,-27
1877,9,19,12,0,12,1877-9-19,-12
1877,9,20,12,0,12,1877-9-20,-12
1877,9,21,12,0,12,1877-9-21,-12
1877,9,22,0,0,0,1877-9-22,0
1877,9,23,0,0,0,1877-9-23,0
1877,9,24,0,0,0,1877-9-24,0
1877,9,25,138,0,138,1877-9-25,-138
1877,9,26,85,0,85,1877-9-26,-85
1877,9,27,33,0,33,1877-9-27,-33
1877,9,28,35,0,35,1877-9-28,-35
1877,9,29,9,0,9,1877-9-29,-9
1877,9,30,0,0,0,1877-9-30,0
1877,10,1,8,0,8,1877-10-1,-8
1877,10,2,0,0,0,1877-10-2,0
1877,10,3,0,0,0,1877-10-3,0
1877,10,4,0,0,0,1877-10-4,0
1877,10,5,0,0,0,1877-10-5,0
1877,10,6,0,0,0,1877-10-6,0
1877,10,7,0,0,0,1877-10-7,0
1877,10,8,0,0,0,1877-10-8,0
1877,10,9,0,0,0,1877-10-9,0
1877,10,10,0,0,0,1877-10-10,0
1877,10,11,0,0,0,1877-10-11,0
1877,10,12,0,0,0,1877-10-12,0
1877,10,13,0,0,0,1877-10-13,0
1877,10,14,0,0,0,1877-10-14,0
1877,10,15,0,0,0,1877-10-15,0
1877,10,16,0,0,0,1877-10-16,0
1877,10,17,0,0,0,1877-10-17,0
1877,10,18,0,0,0,1877-10-18,0
1877,10,19,0,0,0,1877-10-19,0
1877,10,20,0,0,0,1877-10-20,0
1877,10,21,0,0,0,1877-10-21,0
1877,10,22,0,0,0,1877-10-22,0
1877,10,23,0,0,0,1877-10-23,0
1877,10,24,0,0,0,1877-10-24,0
1877,10,25,0,0,0,1877-10-25,0
1877,10,26,595,0,595,1877-10-26,-595
1877,10,27,597,0,597,1877-10-27,-597
1877,10,28,600,0,600,1877-10-28,-600
1877,10,29,603,0,603,1877-10-29,-603
1877,10,30,725,0,725,1877-10-30,-725
1877,10,31,786,0,786,1877-10-31,-786
1877,11,1,917,0,917,1877-11-1,-917
1877,11,2,846,0,846,1877-11-2,-846
1877,11,3,638,0,638,1877-11-3,-638
1877,11,4,588,0,588,1877-11-4,-588
1877,11,5,532,0,532,1877-11-5,-532
1877,11,6,544,0,544,1877-11-6,-544
1877,11,7,579,0,579,1877-11-7,-579
1877,11,8,0,0,0,1877-11-8,0
1877,11,9,0,0,0,1877-11-9,0
1877,11,10,0,0,0,1877-11-10,0
1877,11,11,0,0,0,1877-11-11,0
1877,11,12,0,0,0,1877-11-12,0
1877,11,13,0,0,0,1877-11-13,0
1877,11,14,111,0,111,1877-11-14,-111
1877,11,15,85,0,85,1877-11-15,-85
1877,11,16,58,0,58,1877-11-16,-58
1877,11,17,27,0,27,1877-11-17,-27
1877,11,18,0,0,0,1877-11-18,0
1877,11,19,0,0,0,1877-11-19,0
1877,11,20,0,0,0,1877-11-20,0
1877,11,21,0,0,0,1877-11-21,0
1877,11,22,301,0,301,1877-11-22,-301
1877,11,23,392,0,392,1877-11-23,-392
1877,11,24,562,0,562,1877-11-24,-562
1877,11,25,522,0,522,1877-11-25,-522
1877,11,26,468,0,468,1877-11-26,-468
1877,11,27,403,0,403,1877-11-27,-403
1877,11,28,343,0,343,1877-11-28,-343
1877,11,29,327,0,327,1877-11-29,-327
1877,11,30,261,0,261,1877-11-30,-261
1877,12,1,232,0,232,1877-12-1,-232
1877,12,2,203,0,203,1877-12-2,-203
1877,12,3,215,0,215,1877-12-3,-215
1877,12,4,0,0,0,1877-12-4,0
1877,12,5,0,0,0,1877-12-5,0
1877,12,6,0,0,0,1877-12-6,0
1877,12,7,0,0,0,1877-12-7,0
1877,12,8,0,0,0,1877-12-8,0
1877,12,9,0,0,0,1877-12-9,0
1877,12,10,0,0,0,1877-12-10,0
1877,12,11,0,0,0,1877-12-11,0
1877,12,12,0,0,0,1877-12-12,0
1877,12,13,0,0,0,1877-12-13,0
1877,12,14,0,0,0,1877-12-14,0
1877,12,15,0,0,0,1877-12-15,0
1877,12,16,0,0,0,1877-12-16,0
1877,12,17,0,0,0,1877-12-17,0
1877,12,18,0,0,0,1877-12-18,0
1877,12,19,0,0,0,1877-12-19,0
1877,12,20,0,0,0,1877-12-20,0
1877,12,21,37,0,37,1877-12-21,-37
1877,12,22,0,0,0,1877-12-22,0
1877,12,23,0,0,0,1877-12-23,0
1877,12,24,0,0,0,1877-12-24,0
1877,12,25,0,0,0,1877-12-25,0
1877,12,26,0,0,0,1877-12-26,0
1877,12,27,0,0,0,1877-12-27,0
1877,12,28,0,0,0,1877-12-28,0
1877,12,29,0,0,0,1877-12-29,0
1877,12,30,0,0,0,1877-12-30,0
1877,12,31,34,34,0,1877-12-31,34
1878,1,1,0,0,0,1878-1-1,0
1878,1,2,0,0,0,1878-1-2,0
1878,1,3,0,0,0,1878-1-3,0
1878,1,4,0,0,0,1878-1-4,0
1878,1,5,0,0,0,1878-1-5,0
1878,1,6,0,0,0,1878-1-6,0
1878,1,7,0,0,0,1878-1-7,0
1878,1,8,0,0,0,1878-1-8,0
1878,1,9,0,0,0,1878-1-9,0
1878,1,10,0,0,0,1878-1-10,0
1878,1,11,0,0,0,1878-1-11,0
1878,1,12,0,0,0,1878-1-12,0
1878,1,13,0,0,0,1878-1-13,0
1878,1,14,0,0,0,1878-1-14,0
1878,1,15,0,0,0,1878-1-15,0
1878,1,16,0,0,0,1878-1-16,0
1878,1,17,0,0,0,1878-1-17,0
1878,1,18,0,0,0,1878-1-18,0
1878,1,19,0,0,0,1878-1-19,0
1878,1,20,0,0,0,1878-1-20,0
1878,1,21,0,0,0,1878-1-21,0
1878,1,22,0,0,0,1878-1-22,0
1878,1,23,126,126,0,1878-1-23,126
1878,1,24,119,119,0,1878-1-24,119
1878,1,25,112,112,0,1878-1-25,112
1878,1,26,104,104,0,1878-1-26,104
1878,1,27,0,0,0,1878-1-27,0
1878,1,28,0,0,0,1878-1-28,0
1878,1,29,0,0,0,1878-1-29,0
1878,1,30,0,0,0,1878-1-30,0
1878,1,31,0,0,0,1878-1-31,0
1878,2,1,0,0,0,1878-2-1,0
1878,2,2,0,0,0,1878-2-2,0
1878,2,3,116,0,116,1878-2-3,-116
1878,2,4,71,0,71,1878-2-4,-71
1878,2,5,119,0,119,1878-2-5,-119
1878,2,6,91,0,91,1878-2-6,-91
1878,2,7,63,0,63,1878-2-7,-63
1878,2,8,36,0,36,1878-2-8,-36
1878,2,9,0,0,0,1878-2-9,0
1878,2,10,0,0,0,1878-2-10,0
1878,2,11,0,0,0,1878-2-11,0
1878,2,12,0,0,0,1878-2-12,0
1878,2,13,0,0,0,1878-2-13,0
1878,2,14,0,0,0,1878-2-14,0
1878,2,15,0,0,0,1878-2-15,0
1878,2,16,0,0,0,1878-2-16,0
1878,2,17,0,0,0,1878-2-17,0
1878,2,18,0,0,0,1878-2-18,0
1878,2,19,0,0,0,1878-2-19,0
1878,2,20,0,0,0,1878-2-20,0
1878,2,21,0,0,0,1878-2-21,0
1878,2,22,0,0,0,1878-2-22,0
1878,2,23,0,0,0,1878-2-23,0
1878,2,24,0,0,0,1878-2-24,0
1878,2,25,0,0,0,1878-2-25,0
1878,2,26,4,0,4,1878-2-26,-4
1878,2,27,8,0,8,1878-2-27,-8
1878,2,28,0,0,0,1878-2-28,0
1878,3,1,0,0,0,1878-3-1,0
1878,3,2,0,0,0,1878-3-2,0
1878,3,3,0,0,0,1878-3-3,0
1878,3,4,142,142,0,1878-3-4,142
1878,3,5,67,67,0,1878-3-5,67
1878,3,6,29,29,0,1878-3-6,29
1878,3,7,0,0,0,1878-3-7,0
1878,3,8,0,0,0,1878-3-8,0
1878,3,9,0,0,0,1878-3-9,0
1878,3,10,0,0,0,1878-3-10,0
1878,3,11,18,18,0,1878-3-11,18
1878,3,12,168,168,0,1878-3-12,168
1878,3,13,192,192,0,1878-3-13,192
1878,3,14,133,133,0,1878-3-14,133
1878,3,15,287,287,0,1878-3-15,287
1878,3,16,214,214,0,1878-3-16,214
1878,3,17,150,150,0,1878-3-17,150
1878,3,18,86,86,0,1878-3-18,86
1878,3,19,0,0,0,1878-3-19,0
1878,3,20,0,0,0,1878-3-20,0
1878,3,21,0,0,0,1878-3-21,0
1878,3,22,0,0,0,1878-3-22,0
1878,3,23,0,0,0,1878-3-23,0
1878,3,24,0,0,0,1878-3-24,0
1878,3,25,0,0,0,1878-3-25,0
1878,3,26,0,0,0,1878-3-26,0
1878,3,27,0,0,0,1878-3-27,0
1878,3,28,0,0,0,1878-3-28,0
1878,3,29,0,0,0,1878-3-29,0
1878,3,30,0,0,0,1878-3-30,0
1878,3,31,0,0,0,1878-3-31,0
1878,4,1,0,0,0,1878-4-1,0
1878,4,2,0,0,0,1878-4-2,0
1878,4,3,0,0,0,1878-4-3,0
1878,4,4,0,0,0,1878-4-4,0
1878,4,5,13,13,0,1878-4-5,13
1878,4,6,0,0,0,1878-4-6,0
1878,4,7,0,0,0,1878-4-7,0
1878,4,8,0,0,0,1878-4-8,0
1878,4,9,0,0,0,1878-4-9,0
1878,4,10,0,0,0,1878-4-10,0
1878,4,11,0,0,0,1878-4-11,0
1878,4,12,0,0,0,1878-4-12,0
1878,4,13,0,0,0,1878-4-13,0
1878,4,14,0,0,0,1878-4-14,0
1878,4,15,0,0,0,1878-4-15,0
1878,4,16,0,0,0,1878-4-16,0
1878,4,17,0,0,0,1878-4-17,0
1878,4,18,0,0,0,1878-4-18,0
1878,4,19,0,0,0,1878-4-19,0
1878,4,20,0,0,0,1878-4-20,0
1878,4,21,0,0,0,1878-4-21,0
1878,4,22,0,0,0,1878-4-22,0
1878,4,23,0,0,0,1878-4-23,0
1878,4,24,0,0,0,1878-4-24,0
1878,4,25,0,0,0,1878-4-25,0
1878,4,26,0,0,0,1878-4-26,0
1878,4,27,0,0,0,1878-4-27,0
1878,4,28,0,0,0,1878-4-28,0
1878,4,29,0,0,0,1878-4-29,0
1878,4,30,0,0,0,1878-4-30,0
1878,5,1,0,0,0,1878-5-1,0
1878,5,2,0,0,0,1878-5-2,0
1878,5,3,0,0,0,1878-5-3,0
1878,5,4,0,0,0,1878-5-4,0
1878,5,5,0,0,0,1878-5-5,0
1878,5,6,0,0,0,1878-5-6,0
1878,5,7,0,0,0,1878-5-7,0
1878,5,8,0,0,0,1878-5-8,0
1878,5,9,0,0,0,1878-5-9,0
1878,5,10,0,0,0,1878-5-10,0
1878,5,11,0,0,0,1878-5-11,0
1878,5,12,0,0,0,1878-5-12,0
1878,5,13,0,0,0,1878-5-13,0
1878,5,14,0,0,0,1878-5-14,0
1878,5,15,0,0,0,1878-5-15,0
1878,5,16,0,0,0,1878-5-16,0
1878,5,17,0,0,0,1878-5-17,0
1878,5,18,0,0,0,1878-5-18,0
1878,5,19,0,0,0,1878-5-19,0
1878,5,20,0,0,0,1878-5-20,0
1878,5,21,0,0,0,1878-5-21,0
1878,5,22,0,0,0,1878-5-22,0
1878,5,23,0,0,0,1878-5-23,0
1878,5,24,0,0,0,1878-5-24,0
1878,5,25,0,0,0,1878-5-25,0
1878,5,26,0,0,0,1878-5-26,0
1878,5,27,281,281,0,1878-5-27,281
1878,5,28,351,351,0,1878-5-28,351
1878,5,29,402,402,0,1878-5-29,402
1878,5,30,272,272,0,1878-5-30,272
1878,5,31,290,290,0,1878-5-31,290
1878,6,1,254,254,0,1878-6-1,254
1878,6,2,185,185,0,1878-6-2,185
1878,6,3,95,95,0,1878-6-3,95
1878,6,4,52,52,0,1878-6-4,52
1878,6,5,9,9,0,1878-6-5,9
1878,6,6,27,27,0,1878-6-6,27
1878,6,7,0,0,0,1878-6-7,0
1878,6,8,0,0,0,1878-6-8,0
1878,6,9,0,0,0,1878-6-9,0
1878,6,10,14,0,14,1878-6-10,-14
1878,6,11,0,0,0,1878-6-11,0
1878,6,12,0,0,0,1878-6-12,0
1878,6,13,0,0,0,1878-6-13,0
1878,6,14,0,0,0,1878-6-14,0
1878,6,15,0,0,0,1878-6-15,0
1878,6,16,0,0,0,1878-6-16,0
1878,6,17,0,0,0,1878-6-17,0
1878,6,18,0,0,0,1878-6-18,0
1878,6,19,0,0,0,1878-6-19,0
1878,6,20,0,0,0,1878-6-20,0
1878,6,21,0,0,0,1878-6-21,0
1878,6,22,0,0,0,1878-6-22,0
1878,6,23,0,0,0,1878-6-23,0
1878,6,24,0,0,0,1878-6-24,0
1878,6,25,0,0,0,1878-6-25,0
1878,6,26,56,56,0,1878-6-26,56
1878,6,27,167,167,0,1878-6-27,167
1878,6,28,277,277,0,1878-6-28,277
1878,6,29,94,94,0,1878-6-29,94
1878,6,30,0,0,0,1878-6-30,0
1878,7,1,0,0,0,1878-7-1,0
1878,7,2,0,0,0,1878-7-2,0
1878,7,3,0,0,0,1878-7-3,0
1878,7,4,0,0,0,1878-7-4,0
1878,7,5,0,0,0,1878-7-5,0
1878,7,6,0,0,0,1878-7-6,0
1878,7,7,0,0,0,1878-7-7,0
1878,7,8,0,0,0,1878-7-8,0
1878,7,9,0,0,0,1878-7-9,0
1878,7,10,0,0,0,1878-7-10,0
1878,7,11,0,0,0,1878-7-11,0
1878,7,12,0,0,0,1878-7-12,0
1878,7,13,0,0,0,1878-7-13,0
1878,7,14,0,0,0,1878-7-14,0
1878,7,15,0,0,0,1878-7-15,0
1878,7,16,0,0,0,1878-7-16,0
1878,7,17,0,0,0,1878-7-17,0
1878,7,18,0,0,0,1878-7-18,0
1878,7,19,0,0,0,1878-7-19,0
1878,7,20,0,0,0,1878-7-20,0
1878,7,21,0,0,0,1878-7-21,0
1878,7,22,0,0,0,1878-7-22,0
1878,7,23,0,0,0,1878-7-23,0
1878,7,24,0,0,0,1878-7-24,0
1878,7,25,0,0,0,1878-7-25,0
1878,7,26,11,11,0,1878-7-26,11
1878,7,27,0,0,0,1878-7-27,0
1878,7,28,0,0,0,1878-7-28,0
1878,7,29,0,0,0,1878-7-29,0
1878,7,30,0,0,0,1878-7-30,0
1878,7,31,0,0,0,1878-7-31,0
1878,8,1,0,0,0,1878-8-1,0
1878,8,2,0,0,0,1878-8-2,0
1878,8,3,0,0,0,1878-8-3,0
1878,8,4,0,0,0,1878-8-4,0
1878,8,5,0,0,0,1878-8-5,0
1878,8,6,0,0,0,1878-8-6,0
1878,8,7,0,0,0,1878-8-7,0
1878,8,8,0,0,0,1878-8-8,0
1878,8,9,0,0,0,1878-8-9,0
1878,8,10,0,0,0,1878-8-10,0
1878,8,11,0,0,0,1878-8-11,0
1878,8,12,0,0,0,1878-8-12,0
1878,8,13,0,0,0,1878-8-13,0
1878,8,14,0,0,0,1878-8-14,0
1878,8,15,0,0,0,1878-8-15,0
1878,8,16,0,0,0,1878-8-16,0
1878,8,17,0,0,0,1878-8-17,0
1878,8,18,0,0,0,1878-8-18,0
1878,8,19,0,0,0,1878-8-19,0
1878,8,20,0,0,0,1878-8-20,0
1878,8,21,0,0,0,1878-8-21,0
1878,8,22,0,0,0,1878-8-22,0
1878,8,23,0,0,0,1878-8-23,0
1878,8,24,0,0,0,1878-8-24,0
1878,8,25,0,0,0,1878-8-25,0
1878,8,26,0,0,0,1878-8-26,0
1878,8,27,0,0,0,1878-8-27,0
1878,8,28,0,0,0,1878-8-28,0
1878,8,29,0,0,0,1878-8-29,0
1878,8,30,0,0,0,1878-8-30,0
1878,8,31,0,0,0,1878-8-31,0
1878,9,1,0,0,0,1878-9-1,0
1878,9,2,141,141,0,1878-9-2,141
1878,9,3,134,134,0,1878-9-3,134
1878,9,4,165,165,0,1878-9-4,165
1878,9,5,154,154,0,1878-9-5,154
1878,9,6,142,142,0,1878-9-6,142
1878,9,7,148,148,0,1878-9-7,148
1878,9,8,178,178,0,1878-9-8,178
1878,9,9,139,139,0,1878-9-9,139
1878,9,10,145,145,0,1878-9-10,145
1878,9,11,145,145,0,1878-9-11,145
1878,9,12,126,126,0,1878-9-12,126
1878,9,13,100,100,0,1878-9-13,100
1878,9,14,0,0,0,1878-9-14,0
1878,9,15,0,0,0,1878-9-15,0
1878,9,16,0,0,0,1878-9-16,0
1878,9,17,0,0,0,1878-9-17,0
1878,9,18,0,0,0,1878-9-18,0
1878,9,19,0,0,0,1878-9-19,0
1878,9,20,0,0,0,1878-9-20,0
1878,9,21,0,0,0,1878-9-21,0
1878,9,22,0,0,0,1878-9-22,0
1878,9,23,0,0,0,1878-9-23,0
1878,9,24,0,0,0,1878-9-24,0
1878,9,25,0,0,0,1878-9-25,0
1878,9,26,0,0,0,1878-9-26,0
1878,9,27,0,0,0,1878-9-27,0
1878,9,28,0,0,0,1878-9-28,0
1878,9,29,0,0,0,1878-9-29,0
1878,9,30,0,0,0,1878-9-30,0
1878,10,1,0,0,0,1878-10-1,0
1878,10,2,0,0,0,1878-10-2,0
1878,10,3,0,0,0,1878-10-3,0
1878,10,4,0,0,0,1878-10-4,0
1878,10,5,0,0,0,1878-10-5,0
1878,10,6,0,0,0,1878-10-6,0
1878,10,7,0,0,0,1878-10-7,0
1878,10,8,0,0,0,1878-10-8,0
1878,10,9,0,0,0,1878-10-9,0
1878,10,10,0,0,0,1878-10-10,0
1878,10,11,0,0,0,1878-10-11,0
1878,10,12,0,0,0,1878-10-12,0
1878,10,13,0,0,0,1878-10-13,0
1878,10,14,0,0,0,1878-10-14,0
1878,10,15,0,0,0,1878-10-15,0
1878,10,16,0,0,0,1878-10-16,0
1878,10,17,0,0,0,1878-10-17,0
1878,10,18,0,0,0,1878-10-18,0
1878,10,19,0,0,0,1878-10-19,0
1878,10,20,0,0,0,1878-10-20,0
1878,10,21,0,0,0,1878-10-21,0
1878,10,22,0,0,0,1878-10-22,0
1878,10,23,0,0,0,1878-10-23,0
1878,10,24,0,0,0,1878-10-24,0
1878,10,25,0,0,0,1878-10-25,0
1878,10,26,0,0,0,1878-10-26,0
1878,10,27,0,0,0,1878-10-27,0
1878,10,28,0,0,0,1878-10-28,0
1878,10,29,103,103,0,1878-10-29,103
1878,10,30,91,91,0,1878-10-30,91
1878,10,31,105,105,0,1878-10-31,105
1878,11,1,91,91,0,1878-11-1,91
1878,11,2,79,79,0,1878-11-2,79
1878,11,3,71,71,0,1878-11-3,71
1878,11,4,65,65,0,1878-11-4,65
1878,11,5,71,71,0,1878-11-5,71
1878,11,6,66,66,0,1878-11-6,66
1878,11,7,71,71,0,1878-11-7,71
1878,11,8,69,69,0,1878-11-8,69
1878,11,9,37,37,0,1878-11-9,37
1878,11,10,0,0,0,1878-11-10,0
1878,11,11,0,0,0,1878-11-11,0
1878,11,12,0,0,0,1878-11-12,0
1878,11,13,0,0,0,1878-11-13,0
1878,11,14,0,0,0,1878-11-14,0
1878,11,15,0,0,0,1878-11-15,0
1878,11,16,0,0,0,1878-11-16,0
1878,11,17,0,0,0,1878-11-17,0
1878,11,18,0,0,0,1878-11-18,0
1878,11,19,0,0,0,1878-11-19,0
1878,11,20,50,50,0,1878-11-20,50
1878,11,21,19,19,0,1878-11-21,19
1878,11,22,19,19,0,1878-11-22,19
1878,11,23,0,0,0,1878-11-23,0
1878,11,24,0,0,0,1878-11-24,0
1878,11,25,0,0,0,1878-11-25,0
1878,11,26,0,0,0,1878-11-26,0
1878,11,27,0,0,0,1878-11-27,0
1878,11,28,0,0,0,1878-11-28,0
1878,11,29,0,0,0,1878-11-29,0
1878,11,30,0,0,0,1878-11-30,0
1878,12,1,0,0,0,1878-12-1,0
1878,12,2,0,0,0,1878-12-2,0
1878,12,3,0,0,0,1878-12-3,0
1878,12,4,0,0,0,1878-12-4,0
1878,12,5,0,0,0,1878-12-5,0
1878,12,6,0,0,0,1878-12-6,0
1878,12,7,0,0,0,1878-12-7,0
1878,12,8,0,0,0,1878-12-8,0
1878,12,9,0,0,0,1878-12-9,0
1878,12,10,0,0,0,1878-12-10,0
1878,12,11,0,0,0,1878-12-11,0
1878,12,12,0,0,0,1878-12-12,0
1878,12,13,0,0,0,1878-12-13,0
1878,12,14,0,0,0,1878-12-14,0
1878,12,15,0,0,0,1878-12-15,0
1878,12,16,0,0,0,1878-12-16,0
1878,12,17,0,0,0,1878-12-17,0
1878,12,18,0,0,0,1878-12-18,0
1878,12,19,36,0,36,1878-12-19,-36
1878,12,20,26,0,26,1878-12-20,-26
1878,12,21,0,0,0,1878-12-21,0
1878,12,22,0,0,0,1878-12-22,0
1878,12,23,0,0,0,1878-12-23,0
1878,12,24,0,0,0,1878-12-24,0
1878,12,25,0,0,0,1878-12-25,0
1878,12,26,0,0,0,1878-12-26,0
1878,12,27,0,0,0,1878-12-27,0
1878,12,28,0,0,0,1878-12-28,0
1878,12,29,0,0,0,1878-12-29,0
1878,12,30,0,0,0,1878-12-30,0
1878,12,31,0,0,0,1878-12-31,0
1879,1,1,0,0,0,1879-1-1,0
1879,1,2,0,0,0,1879-1-2,0
1879,1,3,0,0,0,1879-1-3,0
1879,1,4,0,0,0,1879-1-4,0
1879,1,5,0,0,0,1879-1-5,0
1879,1,6,0,0,0,1879-1-6,0
1879,1,7,0,0,0,1879-1-7,0
1879,1,8,0,0,0,1879-1-8,0
1879,1,9,0,0,0,1879-1-9,0
1879,1,10,0,0,0,1879-1-10,0
1879,1,11,0,0,0,1879-1-11,0
1879,1,12,0,0,0,1879-1-12,0
1879,1,13,0,0,0,1879-1-13,0
1879,1,14,0,0,0,1879-1-14,0
1879,1,15,0,0,0,1879-1-15,0
1879,1,16,0,0,0,1879-1-16,0
1879,1,17,0,0,0,1879-1-17,0
1879,1,18,0,0,0,1879-1-18,0
1879,1,19,0,0,0,1879-1-19,0
1879,1,20,0,0,0,1879-1-20,0
1879,1,21,0,0,0,1879-1-21,0
1879,1,22,0,0,0,1879-1-22,0
1879,1,23,0,0,0,1879-1-23,0
1879,1,24,0,0,0,1879-1-24,0
1879,1,25,0,0,0,1879-1-25,0
1879,1,26,0,0,0,1879-1-26,0
1879,1,27,0,0,0,1879-1-27,0
1879,1,28,0,0,0,1879-1-28,0
1879,1,29,0,0,0,1879-1-29,0
1879,1,30,29,0,29,1879-1-30,-29
1879,1,31,7,0,7,1879-1-31,-7
1879,2,1,0,0,0,1879-2-1,0
1879,2,2,0,0,0,1879-2-2,0
1879,2,3,0,0,0,1879-2-3,0
1879,2,4,0,0,0,1879-2-4,0
1879,2,5,0,0,0,1879-2-5,0
1879,2,6,0,0,0,1879-2-6,0
1879,2,7,0,0,0,1879-2-7,0
1879,2,8,0,0,0,1879-2-8,0
1879,2,9,0,0,0,1879-2-9,0
1879,2,10,0,0,0,1879-2-10,0
1879,2,11,0,0,0,1879-2-11,0
1879,2,12,0,0,0,1879-2-12,0
1879,2,13,0,0,0,1879-2-13,0
1879,2,14,0,0,0,1879-2-14,0
1879,2,15,0,0,0,1879-2-15,0
1879,2,16,0,0,0,1879-2-16,0
1879,2,17,0,0,0,1879-2-17,0
1879,2,18,0,0,0,1879-2-18,0
1879,2,19,0,0,0,1879-2-19,0
1879,2,20,0,0,0,1879-2-20,0
1879,2,21,0,0,0,1879-2-21,0
1879,2,22,0,0,0,1879-2-22,0
1879,2,23,0,0,0,1879-2-23,0
1879,2,24,0,0,0,1879-2-24,0
1879,2,25,0,0,0,1879-2-25,0
1879,2,26,0,0,0,1879-2-26,0
1879,2,27,0,0,0,1879-2-27,0
1879,2,28,0,0,0,1879-2-28,0
1879,3,1,0,0,0,1879-3-1,0
1879,3,2,0,0,0,1879-3-2,0
1879,3,3,0,0,0,1879-3-3,0
1879,3,4,0,0,0,1879-3-4,0
1879,3,5,0,0,0,1879-3-5,0
1879,3,6,0,0,0,1879-3-6,0
1879,3,7,0,0,0,1879-3-7,0
1879,3,8,0,0,0,1879-3-8,0
1879,3,9,0,0,0,1879-3-9,0
1879,3,10,0,0,0,1879-3-10,0
1879,3,11,0,0,0,1879-3-11,0
1879,3,12,0,0,0,1879-3-12,0
1879,3,13,0,0,0,1879-3-13,0
1879,3,14,0,0,0,1879-3-14,0
1879,3,15,0,0,0,1879-3-15,0
1879,3,16,0,0,0,1879-3-16,0
1879,3,17,0,0,0,1879-3-17,0
1879,3,18,0,0,0,1879-3-18,0
1879,3,19,0,0,0,1879-3-19,0
1879,3,20,0,0,0,1879-3-20,0
1879,3,21,0,0,0,1879-3-21,0
1879,3,22,0,0,0,1879-3-22,0
1879,3,23,0,0,0,1879-3-23,0
1879,3,24,0,0,0,1879-3-24,0
1879,3,25,0,0,0,1879-3-25,0
1879,3,26,0,0,0,1879-3-26,0
1879,3,27,0,0,0,1879-3-27,0
1879,3,28,0,0,0,1879-3-28,0
1879,3,29,0,0,0,1879-3-29,0
1879,3,30,0,0,0,1879-3-30,0
1879,3,31,0,0,0,1879-3-31,0
1879,4,1,0,0,0,1879-4-1,0
1879,4,2,0,0,0,1879-4-2,0
1879,4,3,0,0,0,1879-4-3,0
1879,4,4,0,0,0,1879-4-4,0
1879,4,5,0,0,0,1879-4-5,0
1879,4,6,0,0,0,1879-4-6,0
1879,4,7,0,0,0,1879-4-7,0
1879,4,8,0,0,0,1879-4-8,0
1879,4,9,0,0,0,1879-4-9,0
1879,4,10,0,0,0,1879-4-10,0
1879,4,11,0,0,0,1879-4-11,0
1879,4,12,0,0,0,1879-4-12,0
1879,4,13,0,0,0,1879-4-13,0
1879,4,14,0,0,0,1879-4-14,0
1879,4,15,182,0,182,1879-4-15,-182
1879,4,16,227,0,227,1879-4-16,-227
1879,4,17,144,0,144,1879-4-17,-144
1879,4,18,178,0,178,1879-4-18,-178
1879,4,19,128,0,128,1879-4-19,-128
1879,4,20,130,0,130,1879-4-20,-130
1879,4,21,140,0,140,1879-4-21,-140
1879,4,22,178,0,178,1879-4-22,-178
1879,4,23,207,0,207,1879-4-23,-207
1879,4,24,0,0,0,1879-4-24,0
1879,4,25,0,0,0,1879-4-25,0
1879,4,26,0,0,0,1879-4-26,0
1879,4,27,0,0,0,1879-4-27,0
1879,4,28,0,0,0,1879-4-28,0
1879,4,29,0,0,0,1879-4-29,0
1879,4,30,0,0,0,1879-4-30,0
1879,5,1,0,0,0,1879-5-1,0
1879,5,2,0,0,0,1879-5-2,0
1879,5,3,0,0,0,1879-5-3,0
1879,5,4,0,0,0,1879-5-4,0
1879,5,5,0,0,0,1879-5-5,0
1879,5,6,0,0,0,1879-5-6,0
1879,5,7,0,0,0,1879-5-7,0
1879,5,8,0,0,0,1879-5-8,0
1879,5,9,84,84,0,1879-5-9,84
1879,5,10,48,48,0,1879-5-10,48
1879,5,11,32,32,0,1879-5-11,32
1879,5,12,16,16,0,1879-5-12,16
1879,5,13,0,0,0,1879-5-13,0
1879,5,14,0,0,0,1879-5-14,0
1879,5,15,0,0,0,1879-5-15,0
1879,5,16,0,0,0,1879-5-16,0
1879,5,17,0,0,0,1879-5-17,0
1879,5,18,0,0,0,1879-5-18,0
1879,5,19,0,0,0,1879-5-19,0
1879,5,20,0,0,0,1879-5-20,0
1879,5,21,0,0,0,1879-5-21,0
1879,5,22,0,0,0,1879-5-22,0
1879,5,23,0,0,0,1879-5-23,0
1879,5,24,0,0,0,1879-5-24,0
1879,5,25,0,0,0,1879-5-25,0
1879,5,26,0,0,0,1879-5-26,0
1879,5,27,0,0,0,1879-5-27,0
1879,5,28,0,0,0,1879-5-28,0
1879,5,29,0,0,0,1879-5-29,0
1879,5,30,0,0,0,1879-5-30,0
1879,5,31,0,0,0,1879-5-31,0
1879,6,1,0,0,0,1879-6-1,0
1879,6,2,0,0,0,1879-6-2,0
1879,6,3,0,0,0,1879-6-3,0
1879,6,4,0,0,0,1879-6-4,0
1879,6,5,0,0,0,1879-6-5,0
1879,6,6,0,0,0,1879-6-6,0
1879,6,7,0,0,0,1879-6-7,0
1879,6,8,0,0,0,1879-6-8,0
1879,6,9,0,0,0,1879-6-9,0
1879,6,10,0,0,0,1879-6-10,0
1879,6,11,0,0,0,1879-6-11,0
1879,6,12,0,0,0,1879-6-12,0
1879,6,13,0,0,0,1879-6-13,0
1879,6,14,0,0,0,1879-6-14,0
1879,6,15,0,0,0,1879-6-15,0
1879,6,16,0,0,0,1879-6-16,0
1879,6,17,0,0,0,1879-6-17,0
1879,6,18,0,0,0,1879-6-18,0
1879,6,19,0,0,0,1879-6-19,0
1879,6,20,0,0,0,1879-6-20,0
1879,6,21,0,0,0,1879-6-21,0
1879,6,22,0,0,0,1879-6-22,0
1879,6,23,0,0,0,1879-6-23,0
1879,6,24,0,0,0,1879-6-24,0
1879,6,25,0,0,0,1879-6-25,0
1879,6,26,0,0,0,1879-6-26,0
1879,6,27,105,0,105,1879-6-27,-105
1879,6,28,143,0,143,1879-6-28,-143
1879,6,29,161,0,161,1879-6-29,-161
1879,6,30,179,0,179,1879-6-30,-179
1879,7,1,288,20,268,1879-7-1,-248
1879,7,2,143,10,133,1879-7-2,-123
1879,7,3,190,25,165,1879-7-3,-140
1879,7,4,102,12,90,1879-7-4,-78
1879,7,5,84,10,74,1879-7-5,-64
1879,7,6,0,0,0,1879-7-6,0
1879,7,7,0,0,0,1879-7-7,0
1879,7,8,0,0,0,1879-7-8,0
1879,7,9,0,0,0,1879-7-9,0
1879,7,10,0,0,0,1879-7-10,0
1879,7,11,95,95,0,1879-7-11,95
1879,7,12,206,206,0,1879-7-12,206
1879,7,13,163,163,0,1879-7-13,163
1879,7,14,121,121,0,1879-7-14,121
1879,7,15,129,129,0,1879-7-15,129
1879,7,16,72,72,0,1879-7-16,72
1879,7,17,0,0,0,1879-7-17,0
1879,7,18,0,0,0,1879-7-18,0
1879,7,19,0,0,0,1879-7-19,0
1879,7,20,0,0,0,1879-7-20,0
1879,7,21,0,0,0,1879-7-21,0
1879,7,22,0,0,0,1879-7-22,0
1879,7,23,0,0,0,1879-7-23,0
1879,7,24,0,0,0,1879-7-24,0
1879,7,25,0,0,0,1879-7-25,0
1879,7,26,0,0,0,1879-7-26,0
1879,7,27,0,0,0,1879-7-27,0
1879,7,28,0,0,0,1879-7-28,0
1879,7,29,0,0,0,1879-7-29,0
1879,7,30,0,0,0,1879-7-30,0
1879,7,31,0,0,0,1879-7-31,0
1879,8,1,0,0,0,1879-8-1,0
1879,8,2,0,0,0,1879-8-2,0
1879,8,3,0,0,0,1879-8-3,0
1879,8,4,0,0,0,1879-8-4,0
1879,8,5,0,0,0,1879-8-5,0
1879,8,6,0,0,0,1879-8-6,0
1879,8,7,0,0,0,1879-8-7,0
1879,8,8,0,0,0,1879-8-8,0
1879,8,9,0,0,0,1879-8-9,0
1879,8,10,0,0,0,1879-8-10,0
1879,8,11,69,55,14,1879-8-11,41
1879,8,12,184,127,57,1879-8-12,70
1879,8,13,167,138,29,1879-8-13,109
1879,8,14,-1,-1,-1,1879-8-14,0
1879,8,15,0,0,0,1879-8-15,0
1879,8,16,0,0,0,1879-8-16,0
1879,8,17,0,0,0,1879-8-17,0
1879,8,18,0,0,0,1879-8-18,0
1879,8,19,0,0,0,1879-8-19,0
1879,8,20,0,0,0,1879-8-20,0
1879,8,21,0,0,0,1879-8-21,0
1879,8,22,0,0,0,1879-8-22,0
1879,8,23,0,0,0,1879-8-23,0
1879,8,24,0,0,0,1879-8-24,0
1879,8,25,0,0,0,1879-8-25,0
1879,8,26,0,0,0,1879-8-26,0
1879,8,27,0,0,0,1879-8-27,0
1879,8,28,250,250,0,1879-8-28,250
1879,8,29,189,189,0,1879-8-29,189
1879,8,30,173,173,0,1879-8-30,173
1879,8,31,124,124,0,1879-8-31,124
1879,9,1,169,169,0,1879-9-1,169
1879,9,2,155,155,0,1879-9-2,155
1879,9,3,174,174,0,1879-9-3,174
1879,9,4,168,168,0,1879-9-4,168
1879,9,5,90,90,0,1879-9-5,90
1879,9,6,119,119,0,1879-9-6,119
1879,9,7,148,148,0,1879-9-7,148
1879,9,8,0,0,0,1879-9-8,0
1879,9,9,0,0,0,1879-9-9,0
1879,9,10,0,0,0,1879-9-10,0
1879,9,11,0,0,0,1879-9-11,0
1879,9,12,0,0,0,1879-9-12,0
1879,9,13,0,0,0,1879-9-13,0
1879,9,14,0,0,0,1879-9-14,0
1879,9,15,0,0,0,1879-9-15,0
1879,9,16,0,0,0,1879-9-16,0
1879,9,17,0,0,0,1879-9-17,0
1879,9,18,0,0,0,1879-9-18,0
1879,9,19,0,0,0,1879-9-19,0
1879,9,20,0,0,0,1879-9-20,0
1879,9,21,0,0,0,1879-9-21,0
1879,9,22,0,0,0,1879-9-22,0
1879,9,23,0,0,0,1879-9-23,0
1879,9,24,96,96,0,1879-9-24,96
1879,9,25,48,48,0,1879-9-25,48
1879,9,26,47,47,0,1879-9-26,47
1879,9,27,24,24,0,1879-9-27,24
1879,9,28,0,0,0,1879-9-28,0
1879,9,29,0,0,0,1879-9-29,0
1879,9,30,0,0,0,1879-9-30,0
1879,10,1,0,0,0,1879-10-1,0
1879,10,2,56,0,56,1879-10-2,-56
1879,10,3,77,0,77,1879-10-3,-77
1879,10,4,0,0,0,1879-10-4,0
1879,10,5,0,0,0,1879-10-5,0
1879,10,6,0,0,0,1879-10-6,0
1879,10,7,72,72,0,1879-10-7,72
1879,10,8,64,64,0,1879-10-8,64
1879,10,9,94,94,0,1879-10-9,94
1879,10,10,124,124,0,1879-10-10,124
1879,10,11,92,92,0,1879-10-11,92
1879,10,12,65,65,0,1879-10-12,65
1879,10,13,39,39,0,1879-10-13,39
1879,10,14,91,91,0,1879-10-14,91
1879,10,15,50,50,0,1879-10-15,50
1879,10,16,19,0,19,1879-10-16,-19
1879,10,17,20,0,20,1879-10-17,-20
1879,10,18,412,0,412,1879-10-18,-412
1879,10,19,410,0,410,1879-10-19,-410
1879,10,20,464,0,464,1879-10-20,-464
1879,10,21,377,0,377,1879-10-21,-377
1879,10,22,0,0,0,1879-10-22,0
1879,10,23,0,0,0,1879-10-23,0
1879,10,24,0,0,0,1879-10-24,0
1879,10,25,0,0,0,1879-10-25,0
1879,10,26,0,0,0,1879-10-26,0
1879,10,27,0,0,0,1879-10-27,0
1879,10,28,0,0,0,1879-10-28,0
1879,10,29,0,0,0,1879-10-29,0
1879,10,30,0,0,0,1879-10-30,0
1879,10,31,0,0,0,1879-10-31,0
1879,11,1,0,0,0,1879-11-1,0
1879,11,2,0,0,0,1879-11-2,0
1879,11,3,0,0,0,1879-11-3,0
1879,11,4,0,0,0,1879-11-4,0
1879,11,5,0,0,0,1879-11-5,0
1879,11,6,0,0,0,1879-11-6,0
1879,11,7,532,97,435,1879-11-7,-338
1879,11,8,501,61,440,1879-11-8,-379
1879,11,9,371,36,335,1879-11-9,-299
1879,11,10,319,15,304,1879-11-10,-289
1879,11,11,365,86,279,1879-11-11,-193
1879,11,12,270,0,270,1879-11-12,-270
1879,11,13,218,0,218,1879-11-13,-218
1879,11,14,157,0,157,1879-11-14,-157
1879,11,15,111,0,111,1879-11-15,-111
1879,11,16,62,0,62,1879-11-16,-62
1879,11,17,72,0,72,1879-11-17,-72
1879,11,18,25,0,25,1879-11-18,-25
1879,11,19,0,0,0,1879-11-19,0
1879,11,20,0,0,0,1879-11-20,0
1879,11,21,0,0,0,1879-11-21,0
1879,11,22,0,0,0,1879-11-22,0
1879,11,23,0,0,0,1879-11-23,0
1879,11,24,0,0,0,1879-11-24,0
1879,11,25,23,0,23,1879-11-25,-23
1879,11,26,-1,-1,-1,1879-11-26,0
1879,11,27,24,0,24,1879-11-27,-24
1879,11,28,65,10,55,1879-11-28,-45
1879,11,29,85,0,85,1879-11-29,-85
1879,11,30,60,0,60,1879-11-30,-60
1879,12,1,64,0,64,1879-12-1,-64
1879,12,2,106,0,106,1879-12-2,-106
1879,12,3,65,0,65,1879-12-3,-65
1879,12,4,12,0,12,1879-12-4,-12
1879,12,5,0,0,0,1879-12-5,0
1879,12,6,0,0,0,1879-12-6,0
1879,12,7,0,0,0,1879-12-7,0
1879,12,8,0,0,0,1879-12-8,0
1879,12,9,0,0,0,1879-12-9,0
1879,12,10,0,0,0,1879-12-10,0
1879,12,11,0,0,0,1879-12-11,0
1879,12,12,0,0,0,1879-12-12,0
1879,12,13,0,0,0,1879-12-13,0
1879,12,14,0,0,0,1879-12-14,0
1879,12,15,0,0,0,1879-12-15,0
1879,12,16,27,0,27,1879-12-16,-27
1879,12,17,161,0,161,1879-12-17,-161
1879,12,18,152,0,152,1879-12-18,-152
1879,12,19,145,0,145,1879-12-19,-145
1879,12,20,155,0,155,1879-12-20,-155
1879,12,21,160,0,160,1879-12-21,-160
1879,12,22,0,0,0,1879-12-22,0
1879,12,23,0,0,0,1879-12-23,0
1879,12,24,0,0,0,1879-12-24,0
1879,12,25,0,0,0,1879-12-25,0
1879,12,26,0,0,0,1879-12-26,0
1879,12,27,0,0,0,1879-12-27,0
1879,12,28,0,0,0,1879-12-28,0
1879,12,29,0,0,0,1879-12-29,0
1879,12,30,0,0,0,1879-12-30,0
1879,12,31,0,0,0,1879-12-31,0
1880,1,1,0,0,0,1880-1-1,0
1880,1,2,0,0,0,1880-1-2,0
1880,1,3,107,107,0,1880-1-3,107
1880,1,4,173,110,63,1880-1-4,47
1880,1,5,387,279,108,1880-1-5,171
1880,1,6,337,274,63,1880-1-6,211
1880,1,7,478,412,66,1880-1-7,346
1880,1,8,355,355,0,1880-1-8,355
1880,1,9,421,421,0,1880-1-9,421
1880,1,10,500,492,8,1880-1-10,484
1880,1,11,428,428,0,1880-1-11,428
1880,1,12,482,384,98,1880-1-12,286
1880,1,13,573,427,146,1880-1-13,281
1880,1,14,1010,334,676,1880-1-14,-342
1880,1,15,774,19,755,1880-1-15,-736
1880,1,16,580,0,580,1880-1-16,-580
1880,1,17,447,0,447,1880-1-17,-447
1880,1,18,301,0,301,1880-1-18,-301
1880,1,19,156,0,156,1880-1-19,-156
1880,1,20,82,0,82,1880-1-20,-82
1880,1,21,59,0,59,1880-1-21,-59
1880,1,22,0,0,0,1880-1-22,0
1880,1,23,0,0,0,1880-1-23,0
1880,1,24,5,5,0,1880-1-24,5
1880,1,25,0,0,0,1880-1-25,0
1880,1,26,14,14,0,1880-1-26,14
1880,1,27,0,0,0,1880-1-27,0
1880,1,28,0,0,0,1880-1-28,0
1880,1,29,0,0,0,1880-1-29,0
1880,1,30,642,448,194,1880-1-30,254
1880,1,31,746,547,199,1880-1-31,348
1880,2,1,902,704,198,1880-2-1,506
1880,2,2,533,376,157,1880-2-2,219
1880,2,3,847,675,172,1880-2-3,503
1880,2,4,711,575,136,1880-2-4,439
1880,2,5,685,541,144,1880-2-5,397
1880,2,6,683,547,136,1880-2-6,411
1880,2,7,694,574,120,1880-2-7,454
1880,2,8,608,513,95,1880-2-8,418
1880,2,9,770,699,71,1880-2-9,628
1880,2,10,564,516,48,1880-2-10,468
1880,2,11,644,644,0,1880-2-11,644
1880,2,12,345,345,0,1880-2-12,345
1880,2,13,241,241,0,1880-2-13,241
1880,2,14,0,0,0,1880-2-14,0
1880,2,15,0,0,0,1880-2-15,0
1880,2,16,0,0,0,1880-2-16,0
1880,2,17,0,0,0,1880-2-17,0
1880,2,18,0,0,0,1880-2-18,0
1880,2,19,0,0,0,1880-2-19,0
1880,2,20,0,0,0,1880-2-20,0
1880,2,21,66,0,66,1880-2-21,-66
1880,2,22,236,8,228,1880-2-22,-220
1880,2,23,281,0,281,1880-2-23,-281
1880,2,24,184,0,184,1880-2-24,-184
1880,2,25,183,0,183,1880-2-25,-183
1880,2,26,170,0,170,1880-2-26,-170
1880,2,27,142,0,142,1880-2-27,-142
1880,2,28,153,0,153,1880-2-28,-153
1880,2,29,149,0,149,1880-2-29,-149
1880,3,1,168,30,138,1880-3-1,-108
1880,3,2,222,55,167,1880-3-2,-112
1880,3,3,246,63,183,1880-3-3,-120
1880,3,4,127,0,127,1880-3-4,-127
1880,3,5,0,0,0,1880-3-5,0
1880,3,6,54,0,54,1880-3-6,-54
1880,3,7,47,0,47,1880-3-7,-47
1880,3,8,155,108,47,1880-3-8,61
1880,3,9,227,210,17,1880-3-9,193
1880,3,10,131,111,20,1880-3-10,91
1880,3,11,180,102,78,1880-3-11,24
1880,3,12,164,164,0,1880-3-12,164
1880,3,13,317,254,63,1880-3-13,191
1880,3,14,589,502,87,1880-3-14,415
1880,3,15,358,286,72,1880-3-15,214
1880,3,16,209,157,52,1880-3-16,105
1880,3,17,173,123,50,1880-3-17,73
1880,3,18,207,174,33,1880-3-18,141
1880,3,19,13,0,13,1880-3-19,-13
1880,3,20,0,0,0,1880-3-20,0
1880,3,21,0,0,0,1880-3-21,0
1880,3,22,0,0,0,1880-3-22,0
1880,3,23,0,0,0,1880-3-23,0
1880,3,24,0,0,0,1880-3-24,0
1880,3,25,0,0,0,1880-3-25,0
1880,3,26,0,0,0,1880-3-26,0
1880,3,27,18,0,18,1880-3-27,-18
1880,3,28,53,0,53,1880-3-28,-53
1880,3,29,87,0,87,1880-3-29,-87
1880,3,30,389,275,114,1880-3-30,161
1880,3,31,289,205,84,1880-3-31,121
1880,4,1,154,138,16,1880-4-1,122
1880,4,2,193,193,0,1880-4-2,193
1880,4,3,199,199,0,1880-4-3,199
1880,4,4,196,196,0,1880-4-4,196
1880,4,5,193,193,0,1880-4-5,193
1880,4,6,176,176,0,1880-4-6,176
1880,4,7,179,179,0,1880-4-7,179
1880,4,8,103,103,0,1880-4-8,103
1880,4,9,78,78,0,1880-4-9,78
1880,4,10,-1,-1,-1,1880-4-10,0
1880,4,11,-1,-1,-1,1880-4-11,0
1880,4,12,281,0,281,1880-4-12,-281
1880,4,13,224,0,224,1880-4-13,-224
1880,4,14,216,0,216,1880-4-14,-216
1880,4,15,145,0,145,1880-4-15,-145
1880,4,16,39,0,39,1880-4-16,-39
1880,4,17,0,0,0,1880-4-17,0
1880,4,18,0,0,0,1880-4-18,0
1880,4,19,0,0,0,1880-4-19,0
1880,4,20,0,0,0,1880-4-20,0
1880,4,21,0,0,0,1880-4-21,0
1880,4,22,0,0,0,1880-4-22,0
1880,4,23,0,0,0,1880-4-23,0
1880,4,24,0,0,0,1880-4-24,0
1880,4,25,900,900,0,1880-4-25,900
1880,4,26,741,741,0,1880-4-26,741
1880,4,27,765,765,0,1880-4-27,765
1880,4,28,958,958,0,1880-4-28,958
1880,4,29,408,408,0,1880-4-29,408
1880,4,30,354,354,0,1880-4-30,354
1880,5,1,266,266,0,1880-5-1,266
1880,5,2,761,761,0,1880-5-2,761
1880,5,3,634,634,0,1880-5-3,634
1880,5,4,545,545,0,1880-5-4,545
1880,5,5,476,476,0,1880-5-5,476
1880,5,6,429,429,0,1880-5-6,429
1880,5,7,370,350,20,1880-5-7,330
1880,5,8,482,482,0,1880-5-8,482
1880,5,9,422,422,0,1880-5-9,422
1880,5,10,609,609,0,1880-5-10,609
1880,5,11,433,433,0,1880-5-11,433
1880,5,12,392,392,0,1880-5-12,392
1880,5,13,475,475,0,1880-5-13,475
1880,5,14,512,512,0,1880-5-14,512
1880,5,15,0,0,0,1880-5-15,0
1880,5,16,0,0,0,1880-5-16,0
1880,5,17,0,0,0,1880-5-17,0
1880,5,18,0,0,0,1880-5-18,0
1880,5,19,0,0,0,1880-5-19,0
1880,5,20,70,70,0,1880-5-20,70
1880,5,21,28,28,0,1880-5-21,28
1880,5,22,0,0,0,1880-5-22,0
1880,5,23,0,0,0,1880-5-23,0
1880,5,24,93,93,0,1880-5-24,93
1880,5,25,320,320,0,1880-5-25,320
1880,5,26,576,576,0,1880-5-26,576
1880,5,27,691,691,0,1880-5-27,691
1880,5,28,792,792,0,1880-5-28,792
1880,5,29,937,937,0,1880-5-29,937
1880,5,30,1237,1237,0,1880-5-30,1237
1880,5,31,1128,1128,0,1880-5-31,1128
1880,6,1,759,759,0,1880-6-1,759
1880,6,2,345,345,0,1880-6-2,345
1880,6,3,285,285,0,1880-6-3,285
1880,6,4,72,72,0,1880-6-4,72
1880,6,5,0,0,0,1880-6-5,0
1880,6,6,44,44,0,1880-6-6,44
1880,6,7,17,17,0,1880-6-7,17
1880,6,8,76,34,42,1880-6-8,-8
1880,6,9,113,66,47,1880-6-9,19
1880,6,10,134,106,28,1880-6-10,78
1880,6,11,77,48,29,1880-6-11,19
1880,6,12,66,66,0,1880-6-12,66
1880,6,13,0,0,0,1880-6-13,0
1880,6,14,0,0,0,1880-6-14,0
1880,6,15,190,190,0,1880-6-15,190
1880,6,16,176,176,0,1880-6-16,176
1880,6,17,619,252,367,1880-6-17,-115
1880,6,18,757,270,487,1880-6-18,-217
1880,6,19,959,426,533,1880-6-19,-107
1880,6,20,912,157,755,1880-6-20,-598
1880,6,21,994,177,817,1880-6-21,-640
1880,6,22,865,115,750,1880-6-22,-635
1880,6,23,1167,96,1071,1880-6-23,-975
1880,6,24,1084,0,1084,1880-6-24,-1084
1880,6,25,1076,0,1076,1880-6-25,-1076
1880,6,26,1258,0,1258,1880-6-26,-1258
1880,6,27,1475,0,1475,1880-6-27,-1475
1880,6,28,583,0,583,1880-6-28,-583
1880,6,29,287,20,267,1880-6-29,-247
1880,6,30,255,0,255,1880-6-30,-255
1880,7,1,245,0,245,1880-7-1,-245
1880,7,2,247,0,247,1880-7-2,-247
1880,7,3,305,0,305,1880-7-3,-305
1880,7,4,351,0,351,1880-7-4,-351
1880,7,5,196,0,196,1880-7-5,-196
1880,7,6,171,0,171,1880-7-6,-171
1880,7,7,387,0,387,1880-7-7,-387
1880,7,8,603,0,603,1880-7-8,-603
1880,7,9,328,0,328,1880-7-9,-328
1880,7,10,17,0,17,1880-7-10,-17
1880,7,11,10,0,10,1880-7-11,-10
1880,7,12,0,0,0,1880-7-12,0
1880,7,13,26,0,26,1880-7-13,-26
1880,7,14,0,0,0,1880-7-14,0
1880,7,15,0,0,0,1880-7-15,0
1880,7,16,0,0,0,1880-7-16,0
1880,7,17,0,0,0,1880-7-17,0
1880,7,18,0,0,0,1880-7-18,0
1880,7,19,0,0,0,1880-7-19,0
1880,7,20,199,199,0,1880-7-20,199
1880,7,21,385,385,0,1880-7-21,385
1880,7,22,542,542,0,1880-7-22,542
1880,7,23,570,570,0,1880-7-23,570
1880,7,24,447,447,0,1880-7-24,447
1880,7,25,357,357,0,1880-7-25,357
1880,7,26,315,315,0,1880-7-26,315
1880,7,27,305,305,0,1880-7-27,305
1880,7,28,258,258,0,1880-7-28,258
1880,7,29,68,68,0,1880-7-29,68
1880,7,30,37,37,0,1880-7-30,37
1880,7,31,19,19,0,1880-7-31,19
1880,8,1,-1,-1,-1,1880-8-1,0
1880,8,2,762,762,0,1880-8-2,762
1880,8,3,727,727,0,1880-8-3,727
1880,8,4,740,740,0,1880-8-4,740
1880,8,5,806,806,0,1880-8-5,806
1880,8,6,609,609,0,1880-8-6,609
1880,8,7,713,713,0,1880-8-7,713
1880,8,8,941,865,76,1880-8-8,789
1880,8,9,1180,982,198,1880-8-9,784
1880,8,10,1334,1095,239,1880-8-10,856
1880,8,11,1272,1136,136,1880-8-11,1000
1880,8,12,1388,1167,221,1880-8-12,946
1880,8,13,1148,854,294,1880-8-13,560
1880,8,14,849,539,310,1880-8-14,229
1880,8,15,830,503,327,1880-8-15,176
1880,8,16,894,551,343,1880-8-16,208
1880,8,17,829,496,333,1880-8-17,163
1880,8,18,969,617,352,1880-8-18,265
1880,8,19,1004,788,216,1880-8-19,572
1880,8,20,1063,926,137,1880-8-20,789
1880,8,21,915,915,0,1880-8-21,915
1880,8,22,664,664,0,1880-8-22,664
1880,8,23,867,867,0,1880-8-23,867
1880,8,24,108,108,0,1880-8-24,108
1880,8,25,-1,-1,-1,1880-8-25,0
1880,8,26,-1,-1,-1,1880-8-26,0
1880,8,27,-1,-1,-1,1880-8-27,0
1880,8,28,247,211,36,1880-8-28,175
1880,8,29,199,199,0,1880-8-29,199
1880,8,30,448,448,0,1880-8-30,448
1880,8,31,669,669,0,1880-8-31,669
1880,9,1,555,555,0,1880-9-1,555
1880,9,2,434,365,69,1880-9-2,296
1880,9,3,142,126,16,1880-9-3,110
1880,9,4,259,259,0,1880-9-4,259
1880,9,5,454,367,87,1880-9-5,280
1880,9,6,605,330,275,1880-9-6,55
1880,9,7,732,488,244,1880-9-7,244
1880,9,8,1284,678,606,1880-9-8,72
1880,9,9,1458,528,930,1880-9-9,-402
1880,9,10,1759,391,1368,1880-9-10,-977
1880,9,11,2250,340,1910,1880-9-11,-1570
1880,9,12,2280,282,1998,1880-9-12,-1716
1880,9,13,2210,221,1989,1880-9-13,-1768
1880,9,14,2309,270,2039,1880-9-14,-1769
1880,9,15,1963,319,1644,1880-9-15,-1325
1880,9,16,942,284,658,1880-9-16,-374
1880,9,17,335,335,0,1880-9-17,335
1880,9,18,483,483,0,1880-9-18,483
1880,9,19,277,277,0,1880-9-19,277
1880,9,20,311,311,0,1880-9-20,311
1880,9,21,505,505,0,1880-9-21,505
1880,9,22,216,137,79,1880-9-22,58
1880,9,23,146,101,45,1880-9-23,56
1880,9,24,280,130,150,1880-9-24,-20
1880,9,25,432,79,353,1880-9-25,-274
1880,9,26,397,169,228,1880-9-26,-59
1880,9,27,559,216,343,1880-9-27,-127
1880,9,28,886,159,727,1880-9-28,-568
1880,9,29,1647,530,1117,1880-9-29,-587
1880,9,30,1685,425,1260,1880-9-30,-835
1880,10,1,1445,368,1077,1880-10-1,-709
1880,10,2,1136,394,742,1880-10-2,-348
1880,10,3,1902,669,1233,1880-10-3,-564
1880,10,4,1239,436,803,1880-10-4,-367
1880,10,5,571,351,220,1880-10-5,131
1880,10,6,424,374,50,1880-10-6,324
1880,10,7,219,83,136,1880-10-7,-53
1880,10,8,91,52,39,1880-10-8,13
1880,10,9,103,91,12,1880-10-9,79
1880,10,10,130,77,53,1880-10-10,24
1880,10,11,116,51,65,1880-10-11,-14
1880,10,12,252,221,31,1880-10-12,190
1880,10,13,372,231,141,1880-10-13,90
1880,10,14,560,431,129,1880-10-14,302
1880,10,15,298,298,0,1880-10-15,298
1880,10,16,293,293,0,1880-10-16,293
1880,10,17,249,249,0,1880-10-17,249
1880,10,18,219,219,0,1880-10-18,219
1880,10,19,848,385,463,1880-10-19,-78
1880,10,20,956,527,429,1880-10-20,98
1880,10,21,1152,756,396,1880-10-21,360
1880,10,22,985,688,297,1880-10-22,391
1880,10,23,1212,763,449,1880-10-23,314
1880,10,24,1043,620,423,1880-10-24,197
1880,10,25,574,277,297,1880-10-25,-20
1880,10,26,355,199,156,1880-10-26,43
1880,10,27,260,11,249,1880-10-27,-238
1880,10,28,166,25,141,1880-10-28,-116
1880,10,29,127,85,42,1880-10-29,43
1880,10,30,40,0,40,1880-10-30,-40
1880,10,31,68,0,68,1880-10-31,-68
1880,11,1,239,127,112,1880-11-1,15
1880,11,2,328,179,149,1880-11-2,30
1880,11,3,199,68,131,1880-11-3,-63
1880,11,4,99,8,91,1880-11-4,-83
1880,11,5,81,0,81,1880-11-5,-81
1880,11,6,0,0,0,1880-11-6,0
1880,11,7,0,0,0,1880-11-7,0
1880,11,8,30,30,0,1880-11-8,30
1880,11,9,22,11,11,1880-11-9,0
1880,11,10,0,0,0,1880-11-10,0
1880,11,11,0,0,0,1880-11-11,0
1880,11,12,0,0,0,1880-11-12,0
1880,11,13,64,64,0,1880-11-13,64
1880,11,14,227,220,7,1880-11-14,213
1880,11,15,548,548,0,1880-11-15,548
1880,11,16,419,419,0,1880-11-16,419
1880,11,17,442,356,86,1880-11-17,270
1880,11,18,474,283,191,1880-11-18,92
1880,11,19,704,236,468,1880-11-19,-232
1880,11,20,782,238,544,1880-11-20,-306
1880,11,21,582,240,342,1880-11-21,-102
1880,11,22,516,242,274,1880-11-22,-32
1880,11,23,389,111,278,1880-11-23,-167
1880,11,24,1120,1074,46,1880-11-24,1028
1880,11,25,1397,1265,132,1880-11-25,1133
1880,11,26,1602,1449,153,1880-11-26,1296
1880,11,27,1281,1230,51,1880-11-27,1179
1880,11,28,1212,1191,21,1880-11-28,1170
1880,11,29,997,989,8,1880-11-29,981
1880,11,30,738,738,0,1880-11-30,738
1880,12,1,704,704,0,1880-12-1,704
1880,12,2,575,575,0,1880-12-2,575
1880,12,3,1017,446,571,1880-12-3,-125
1880,12,4,1194,519,675,1880-12-4,-156
1880,12,5,627,0,627,1880-12-5,-627
1880,12,6,717,138,579,1880-12-6,-441
1880,12,7,826,203,623,1880-12-7,-420
1880,12,8,600,0,600,1880-12-8,-600
1880,12,9,595,0,595,1880-12-9,-595
1880,12,10,531,0,531,1880-12-10,-531
1880,12,11,532,0,532,1880-12-11,-532
1880,12,12,447,0,447,1880-12-12,-447
1880,12,13,481,0,481,1880-12-13,-481
1880,12,14,0,0,0,1880-12-14,0
1880,12,15,0,0,0,1880-12-15,0
1880,12,16,86,86,0,1880-12-16,86
1880,12,17,178,178,0,1880-12-17,178
1880,12,18,138,138,0,1880-12-18,138
1880,12,19,159,159,0,1880-12-19,159
1880,12,20,168,168,0,1880-12-20,168
1880,12,21,381,381,0,1880-12-21,381
1880,12,22,435,435,0,1880-12-22,435
1880,12,23,422,422,0,1880-12-23,422
1880,12,24,475,475,0,1880-12-24,475
1880,12,25,280,280,0,1880-12-25,280
1880,12,26,225,225,0,1880-12-26,225
1880,12,27,653,337,316,1880-12-27,21
1880,12,28,296,204,92,1880-12-28,112
1880,12,29,366,263,103,1880-12-29,160
1880,12,30,494,252,242,1880-12-30,10
1880,12,31,677,233,444,1880-12-31,-211
1881,1,1,476,214,262,1881-1-1,-48
1881,1,2,456,0,456,1881-1-2,-456
1881,1,3,1095,445,650,1881-1-3,-205
1881,1,4,1117,550,567,1881-1-4,-17
1881,1,5,533,391,142,1881-1-5,249
1881,1,6,555,482,73,1881-1-6,409
1881,1,7,449,449,0,1881-1-7,449
1881,1,8,373,373,0,1881-1-8,373
1881,1,9,298,298,0,1881-1-9,298
1881,1,10,298,298,0,1881-1-10,298
1881,1,11,274,274,0,1881-1-11,274
1881,1,12,171,171,0,1881-1-12,171
1881,1,13,242,242,0,1881-1-13,242
1881,1,14,229,229,0,1881-1-14,229
1881,1,15,0,0,0,1881-1-15,0
1881,1,16,0,0,0,1881-1-16,0
1881,1,17,345,236,109,1881-1-17,127
1881,1,18,481,309,172,1881-1-18,137
1881,1,19,887,706,181,1881-1-19,525
1881,1,20,933,714,219,1881-1-20,495
1881,1,21,768,683,85,1881-1-21,598
1881,1,22,304,247,57,1881-1-22,190
1881,1,23,92,42,50,1881-1-23,-8
1881,1,24,361,33,328,1881-1-24,-295
1881,1,25,543,28,515,1881-1-25,-487
1881,1,26,753,14,739,1881-1-26,-725
1881,1,27,818,98,720,1881-1-27,-622
1881,1,28,958,222,736,1881-1-28,-514
1881,1,29,1439,431,1008,1881-1-29,-577
1881,1,30,1797,549,1248,1881-1-30,-699
1881,1,31,1097,452,645,1881-1-31,-193
1881,2,1,887,309,578,1881-2-1,-269
1881,2,2,866,395,471,1881-2-2,-76
1881,2,3,1050,669,381,1881-2-3,288
1881,2,4,1076,737,339,1881-2-4,398
1881,2,5,633,633,0,1881-2-5,633
1881,2,6,901,901,0,1881-2-6,901
1881,2,7,1227,1227,0,1881-2-7,1227
1881,2,8,1339,1339,0,1881-2-8,1339
1881,2,9,801,792,9,1881-2-9,783
1881,2,10,700,700,0,1881-2-10,700
1881,2,11,659,659,0,1881-2-11,659
1881,2,12,398,363,35,1881-2-12,328
1881,2,13,350,330,20,1881-2-13,310
1881,2,14,614,365,249,1881-2-14,116
1881,2,15,632,338,294,1881-2-15,44
1881,2,16,605,301,304,1881-2-16,-3
1881,2,17,634,245,389,1881-2-17,-144
1881,2,18,580,169,411,1881-2-18,-242
1881,2,19,518,144,374,1881-2-19,-230
1881,2,20,552,105,447,1881-2-20,-342
1881,2,21,724,166,558,1881-2-21,-392
1881,2,22,560,142,418,1881-2-22,-276
1881,2,23,587,127,460,1881-2-23,-333
1881,2,24,700,280,420,1881-2-24,-140
1881,2,25,565,208,357,1881-2-25,-149
1881,2,26,373,112,261,1881-2-26,-149
1881,2,27,361,105,256,1881-2-27,-151
1881,2,28,34,34,0,1881-2-28,34
1881,3,1,33,33,0,1881-3-1,33
1881,3,2,0,0,0,1881-3-2,0
1881,3,3,52,52,0,1881-3-3,52
1881,3,4,54,54,0,1881-3-4,54
1881,3,5,88,88,0,1881-3-5,88
1881,3,6,78,78,0,1881-3-6,78
1881,3,7,36,30,6,1881-3-7,24
1881,3,8,257,140,117,1881-3-8,23
1881,3,9,581,343,238,1881-3-9,105
1881,3,10,960,712,248,1881-3-10,464
1881,3,11,830,670,160,1881-3-11,510
1881,3,12,827,564,263,1881-3-12,301
1881,3,13,1394,740,654,1881-3-13,86
1881,3,14,1521,618,903,1881-3-14,-285
1881,3,15,1573,645,928,1881-3-15,-283
1881,3,16,1476,389,1087,1881-3-16,-698
1881,3,17,1158,325,833,1881-3-17,-508
1881,3,18,952,103,849,1881-3-18,-746
1881,3,19,818,201,617,1881-3-19,-416
1881,3,20,1113,661,452,1881-3-20,209
1881,3,21,1143,782,361,1881-3-21,421
1881,3,22,1374,950,424,1881-3-22,526
1881,3,23,1087,860,227,1881-3-23,633
1881,3,24,784,784,0,1881-3-24,784
1881,3,25,649,649,0,1881-3-25,649
1881,3,26,367,367,0,1881-3-26,367
1881,3,27,191,191,0,1881-3-27,191
1881,3,28,69,55,14,1881-3-28,41
1881,3,29,119,102,17,1881-3-29,85
1881,3,30,101,59,42,1881-3-30,17
1881,3,31,170,26,144,1881-3-31,-118
1881,4,1,493,27,466,1881-4-1,-439
1881,4,2,457,27,430,1881-4-2,-403
1881,4,3,433,100,333,1881-4-3,-233
1881,4,4,533,126,407,1881-4-4,-281
1881,4,5,445,95,350,1881-4-5,-255
1881,4,6,446,96,350,1881-4-6,-254
1881,4,7,534,62,472,1881-4-7,-410
1881,4,8,354,88,266,1881-4-8,-178
1881,4,9,417,75,342,1881-4-9,-267
1881,4,10,223,32,191,1881-4-10,-159
1881,4,11,204,29,175,1881-4-11,-146
1881,4,12,274,35,239,1881-4-12,-204
1881,4,13,338,116,222,1881-4-13,-106
1881,4,14,365,86,279,1881-4-14,-193
1881,4,15,467,34,433,1881-4-15,-399
1881,4,16,562,18,544,1881-4-16,-526
1881,4,17,648,0,648,1881-4-17,-648
1881,4,18,774,249,525,1881-4-18,-276
1881,4,19,889,537,352,1881-4-19,185
1881,4,20,1060,744,316,1881-4-20,428
1881,4,21,775,455,320,1881-4-21,135
1881,4,22,873,282,591,1881-4-22,-309
1881,4,23,731,278,453,1881-4-23,-175
1881,4,24,536,264,272,1881-4-24,-8
1881,4,25,784,610,174,1881-4-25,436
1881,4,26,838,624,214,1881-4-26,410
1881,4,27,647,405,242,1881-4-27,163
1881,4,28,617,617,0,1881-4-28,617
1881,4,29,160,160,0,1881-4-29,160
1881,4,30,30,30,0,1881-4-30,30
1881,5,1,79,79,0,1881-5-1,79
1881,5,2,34,34,0,1881-5-2,34
1881,5,3,60,0,60,1881-5-3,-60
1881,5,4,94,0,94,1881-5-4,-94
1881,5,5,217,11,206,1881-5-5,-195
1881,5,6,196,0,196,1881-5-6,-196
1881,5,7,160,25,135,1881-5-7,-110
1881,5,8,214,70,144,1881-5-8,-74
1881,5,9,281,126,155,1881-5-9,-29
1881,5,10,271,198,73,1881-5-10,125
1881,5,11,288,235,53,1881-5-11,182
1881,5,12,333,333,0,1881-5-12,333
1881,5,13,270,270,0,1881-5-13,270
1881,5,14,225,225,0,1881-5-14,225
1881,5,15,214,214,0,1881-5-15,214
1881,5,16,213,213,0,1881-5-16,213
1881,5,17,142,142,0,1881-5-17,142
1881,5,18,177,177,0,1881-5-18,177
1881,5,19,226,191,35,1881-5-19,156
1881,5,20,312,170,142,1881-5-20,28
1881,5,21,339,98,241,1881-5-21,-143
1881,5,22,246,0,246,1881-5-22,-246
1881,5,23,446,118,328,1881-5-23,-210
1881,5,24,385,155,230,1881-5-24,-75
1881,5,25,501,208,293,1881-5-25,-85
1881,5,26,397,167,230,1881-5-26,-63
1881,5,27,1030,188,842,1881-5-27,-654
1881,5,28,1109,152,957,1881-5-28,-805
1881,5,29,1046,128,918,1881-5-29,-790
1881,5,30,1211,117,1094,1881-5-30,-977
1881,5,31,969,75,894,1881-5-31,-819
1881,6,1,1196,86,1110,1881-6-1,-1024
1881,6,2,1026,206,820,1881-6-2,-614
1881,6,3,944,243,701,1881-6-3,-458
1881,6,4,848,327,521,1881-6-4,-194
1881,6,5,520,218,302,1881-6-5,-84
1881,6,6,213,113,100,1881-6-6,13
1881,6,7,96,96,0,1881-6-7,96
1881,6,8,110,110,0,1881-6-8,110
1881,6,9,405,405,0,1881-6-9,405
1881,6,10,526,394,132,1881-6-10,262
1881,6,11,638,364,274,1881-6-11,90
1881,6,12,577,342,235,1881-6-12,107
1881,6,13,724,354,370,1881-6-13,-16
1881,6,14,518,293,225,1881-6-14,68
1881,6,15,851,378,473,1881-6-15,-95
1881,6,16,554,176,378,1881-6-16,-202
1881,6,17,517,187,330,1881-6-17,-143
1881,6,18,456,132,324,1881-6-18,-192
1881,6,19,231,0,231,1881-6-19,-231
1881,6,20,146,8,138,1881-6-20,-130
1881,6,21,78,0,78,1881-6-21,-78
1881,6,22,32,0,32,1881-6-22,-32
1881,6,23,638,539,99,1881-6-23,440
1881,6,24,876,803,73,1881-6-24,730
1881,6,25,718,660,58,1881-6-25,602
1881,6,26,281,281,0,1881-6-26,281
1881,6,27,973,718,255,1881-6-27,463
1881,6,28,1396,895,501,1881-6-28,394
1881,6,29,1359,841,518,1881-6-29,323
1881,6,30,925,481,444,1881-6-30,37
1881,7,1,1049,540,509,1881-7-1,31
1881,7,2,942,444,498,1881-7-2,-54
1881,7,3,899,387,512,1881-7-3,-125
1881,7,4,486,478,8,1881-7-4,470
1881,7,5,499,439,60,1881-7-5,379
1881,7,6,376,376,0,1881-7-6,376
1881,7,7,479,479,0,1881-7-7,479
1881,7,8,365,365,0,1881-7-8,365
1881,7,9,760,328,432,1881-7-9,-104
1881,7,10,799,379,420,1881-7-10,-41
1881,7,11,1006,597,409,1881-7-11,188
1881,7,12,902,461,441,1881-7-12,20
1881,7,13,851,394,457,1881-7-13,-63
1881,7,14,823,368,455,1881-7-14,-87
1881,7,15,808,297,511,1881-7-15,-214
1881,7,16,420,14,406,1881-7-16,-392
1881,7,17,193,9,184,1881-7-17,-175
1881,7,18,665,556,109,1881-7-18,447
1881,7,19,748,612,136,1881-7-19,476
1881,7,20,559,559,0,1881-7-20,559
1881,7,21,771,771,0,1881-7-21,771
1881,7,22,645,645,0,1881-7-22,645
1881,7,23,909,909,0,1881-7-23,909
1881,7,24,1453,1306,147,1881-7-24,1159
1881,7,25,2036,1532,504,1881-7-25,1028
1881,7,26,2062,1639,423,1881-7-26,1216
1881,7,27,1334,987,347,1881-7-27,640
1881,7,28,1664,1392,272,1881-7-28,1120
1881,7,29,1515,1259,256,1881-7-29,1003
1881,7,30,1569,1255,314,1881-7-30,941
1881,7,31,1586,1267,319,1881-7-31,948
1881,8,1,1857,1533,324,1881-8-1,1209
1881,8,2,2356,1725,631,1881-8-2,1094
1881,8,3,1363,1306,57,1881-8-3,1249
1881,8,4,1140,1079,61,1881-8-4,1018
1881,8,5,405,337,68,1881-8-5,269
1881,8,6,445,300,145,1881-8-6,155
1881,8,7,378,252,126,1881-8-7,126
1881,8,8,485,220,265,1881-8-8,-45
1881,8,9,314,197,117,1881-8-9,80
1881,8,10,272,179,93,1881-8-10,86
1881,8,11,247,172,75,1881-8-11,97
1881,8,12,222,171,51,1881-8-12,120
1881,8,13,192,128,64,1881-8-13,64
1881,8,14,0,0,0,1881-8-14,0
1881,8,15,0,0,0,1881-8-15,0
1881,8,16,0,0,0,1881-8-16,0
1881,8,17,36,36,0,1881-8-17,36
1881,8,18,78,78,0,1881-8-18,78
1881,8,19,34,34,0,1881-8-19,34
1881,8,20,224,213,11,1881-8-20,202
1881,8,21,200,200,0,1881-8-21,200
1881,8,22,422,422,0,1881-8-22,422
1881,8,23,772,772,0,1881-8-23,772
1881,8,24,961,961,0,1881-8-24,961
1881,8,25,1025,1001,24,1881-8-25,977
1881,8,26,1124,1026,98,1881-8-26,928
1881,8,27,1464,1373,91,1881-8-27,1282
1881,8,28,1442,1347,95,1881-8-28,1252
1881,8,29,1448,1229,219,1881-8-29,1010
1881,8,30,2091,1604,487,1881-8-30,1117
1881,8,31,1880,1273,607,1881-8-31,666
1881,9,1,1875,1105,770,1881-9-1,335
1881,9,2,1287,701,586,1881-9-2,115
1881,9,3,1016,519,497,1881-9-3,22
1881,9,4,608,0,608,1881-9-4,-608
1881,9,5,715,0,715,1881-9-5,-715
1881,9,6,703,110,593,1881-9-6,-483
1881,9,7,778,271,507,1881-9-7,-236
1881,9,8,568,284,284,1881-9-8,0
1881,9,9,741,547,194,1881-9-9,353
1881,9,10,601,601,0,1881-9-10,601
1881,9,11,940,940,0,1881-9-11,940
1881,9,12,1506,1358,148,1881-9-12,1210
1881,9,13,1770,1554,216,1881-9-13,1338
1881,9,14,1661,1445,216,1881-9-14,1229
1881,9,15,1483,1295,188,1881-9-15,1107
1881,9,16,780,693,87,1881-9-16,606
1881,9,17,713,713,0,1881-9-17,713
1881,9,18,664,664,0,1881-9-18,664
1881,9,19,1056,1056,0,1881-9-19,1056
1881,9,20,792,792,0,1881-9-20,792
1881,9,21,672,672,0,1881-9-21,672
1881,9,22,566,566,0,1881-9-22,566
1881,9,23,560,560,0,1881-9-23,560
1881,9,24,562,562,0,1881-9-24,562
1881,9,25,621,621,0,1881-9-25,621
1881,9,26,555,546,9,1881-9-26,537
1881,9,27,534,505,29,1881-9-27,476
1881,9,28,571,549,22,1881-9-28,527
1881,9,29,629,568,61,1881-9-29,507
1881,9,30,483,464,19,1881-9-30,445
1881,10,1,519,490,29,1881-10-1,461
1881,10,2,351,308,43,1881-10-2,265
1881,10,3,349,282,67,1881-10-3,215
1881,10,4,449,356,93,1881-10-4,263
1881,10,5,456,253,203,1881-10-5,50
1881,10,6,694,434,260,1881-10-6,174
1881,10,7,950,676,274,1881-10-7,402
1881,10,8,666,401,265,1881-10-8,136
1881,10,9,685,326,359,1881-10-9,-33
1881,10,10,916,465,451,1881-10-10,14
1881,10,11,602,357,245,1881-10-11,112
1881,10,12,592,350,242,1881-10-12,108
1881,10,13,431,283,148,1881-10-13,135
1881,10,14,605,577,28,1881-10-14,549
1881,10,15,553,553,0,1881-10-15,553
1881,10,16,716,716,0,1881-10-16,716
1881,10,17,1217,1019,198,1881-10-17,821
1881,10,18,876,686,190,1881-10-18,496
1881,10,19,1145,767,378,1881-10-19,389
1881,10,20,1461,1025,436,1881-10-20,589
1881,10,21,1220,933,287,1881-10-21,646
1881,10,22,1167,842,325,1881-10-22,517
1881,10,23,1083,863,220,1881-10-23,643
1881,10,24,1166,915,251,1881-10-24,664
1881,10,25,1214,996,218,1881-10-25,778
1881,10,26,885,648,237,1881-10-26,411
1881,10,27,502,292,210,1881-10-27,82
1881,10,28,238,108,130,1881-10-28,-22
1881,10,29,127,102,25,1881-10-29,77
1881,10,30,23,0,23,1881-10-30,-23
1881,10,31,0,0,0,1881-10-31,0
1881,11,1,62,62,0,1881-11-1,62
1881,11,2,99,99,0,1881-11-2,99
1881,11,3,119,119,0,1881-11-3,119
1881,11,4,117,117,0,1881-11-4,117
1881,11,5,122,122,0,1881-11-5,122
1881,11,6,104,104,0,1881-11-6,104
1881,11,7,440,235,205,1881-11-7,30
1881,11,8,368,189,179,1881-11-8,10
1881,11,9,369,205,164,1881-11-9,41
1881,11,10,407,263,144,1881-11-10,119
1881,11,11,831,721,110,1881-11-11,611
1881,11,12,890,818,72,1881-11-12,746
1881,11,13,1255,929,326,1881-11-13,603
1881,11,14,877,659,218,1881-11-14,441
1881,11,15,780,780,0,1881-11-15,780
1881,11,16,1117,1105,12,1881-11-16,1093
1881,11,17,1723,1714,9,1881-11-17,1705
1881,11,18,1576,1576,0,1881-11-18,1576
1881,11,19,1316,1316,0,1881-11-19,1316
1881,11,20,1398,1374,24,1881-11-20,1350
1881,11,21,1669,1654,15,1881-11-21,1639
1881,11,22,1336,1318,18,1881-11-22,1300
1881,11,23,1511,1416,95,1881-11-23,1321
1881,11,24,1172,1088,84,1881-11-24,1004
1881,11,25,1157,1103,54,1881-11-25,1049
1881,11,26,1374,1335,39,1881-11-26,1296
1881,11,27,1049,693,356,1881-11-27,337
1881,11,28,709,34,675,1881-11-28,-641
1881,11,29,838,37,801,1881-11-29,-764
1881,11,30,428,0,428,1881-11-30,-428
1881,12,1,585,94,491,1881-12-1,-397
1881,12,2,1333,679,654,1881-12-2,25
1881,12,3,1690,796,894,1881-12-3,-98
1881,12,4,1525,716,809,1881-12-4,-93
1881,12,5,1074,805,269,1881-12-5,536
1881,12,6,986,792,194,1881-12-6,598
1881,12,7,917,674,243,1881-12-7,431
1881,12,8,860,589,271,1881-12-8,318
1881,12,9,645,507,138,1881-12-9,369
1881,12,10,435,435,0,1881-12-10,435
1881,12,11,522,489,33,1881-12-11,456
1881,12,12,775,763,12,1881-12-12,751
1881,12,13,1000,1000,0,1881-12-13,1000
1881,12,14,1087,1083,4,1881-12-14,1079
1881,12,15,941,941,0,1881-12-15,941
1881,12,16,867,867,0,1881-12-16,867
1881,12,17,615,615,0,1881-12-17,615
1881,12,18,588,588,0,1881-12-18,588
1881,12,19,492,492,0,1881-12-19,492
1881,12,20,477,443,34,1881-12-20,409
1881,12,21,556,525,31,1881-12-21,494
1881,12,22,462,409,53,1881-12-22,356
1881,12,23,411,402,9,1881-12-23,393
1881,12,24,0,0,0,1881-12-24,0
1881,12,25,45,0,45,1881-12-25,-45
1881,12,26,113,0,113,1881-12-26,-113
1881,12,27,166,0,166,1881-12-27,-166
1881,12,28,209,31,178,1881-12-28,-147
1881,12,29,143,0,143,1881-12-29,-143
1881,12,30,139,11,128,1881-12-30,-117
1881,12,31,218,101,117,1881-12-31,-16
1882,1,1,186,105,81,1882-1-1,24
1882,1,2,255,151,104,1882-1-2,47
1882,1,3,249,232,17,1882-1-3,215
1882,1,4,110,103,7,1882-1-4,96
1882,1,5,306,282,24,1882-1-5,258
1882,1,6,467,426,41,1882-1-6,385
1882,1,7,586,586,0,1882-1-7,586
1882,1,8,419,419,0,1882-1-8,419
1882,1,9,190,153,37,1882-1-9,116
1882,1,10,-1,-1,-1,1882-1-10,0
1882,1,11,-1,-1,-1,1882-1-11,0
1882,1,12,-1,-1,-1,1882-1-12,0
1882,1,13,592,592,0,1882-1-13,592
1882,1,14,357,357,0,1882-1-14,357
1882,1,15,237,237,0,1882-1-15,237
1882,1,16,274,274,0,1882-1-16,274
1882,1,17,221,221,0,1882-1-17,221
1882,1,18,213,213,0,1882-1-18,213
1882,1,19,564,413,151,1882-1-19,262
1882,1,20,778,564,214,1882-1-20,350
1882,1,21,404,102,302,1882-1-21,-200
1882,1,22,293,76,217,1882-1-22,-141
1882,1,23,259,34,225,1882-1-23,-191
1882,1,24,319,0,319,1882-1-24,-319
1882,1,25,411,207,204,1882-1-25,3
1882,1,26,426,224,202,1882-1-26,22
1882,1,27,424,289,135,1882-1-27,154
1882,1,28,569,382,187,1882-1-28,195
1882,1,29,416,315,101,1882-1-29,214
1882,1,30,324,324,0,1882-1-30,324
1882,1,31,342,342,0,1882-1-31,342
1882,2,1,482,466,16,1882-2-1,450
1882,2,2,547,520,27,1882-2-2,493
1882,2,3,526,442,84,1882-2-3,358
1882,2,4,649,506,143,1882-2-4,363
1882,2,5,575,350,225,1882-2-5,125
1882,2,6,484,226,258,1882-2-6,-32
1882,2,7,663,269,394,1882-2-7,-125
1882,2,8,824,227,597,1882-2-8,-370
1882,2,9,850,290,560,1882-2-9,-270
1882,2,10,1428,895,533,1882-2-10,362
1882,2,11,1356,844,512,1882-2-11,332
1882,2,12,1784,721,1063,1882-2-12,-342
1882,2,13,912,515,397,1882-2-13,118
1882,2,14,1024,631,393,1882-2-14,238
1882,2,15,1145,663,482,1882-2-15,181
1882,2,16,1014,625,389,1882-2-16,236
1882,2,17,838,477,361,1882-2-17,116
1882,2,18,695,316,379,1882-2-18,-63
1882,2,19,335,71,264,1882-2-19,-193
1882,2,20,396,74,322,1882-2-20,-248
1882,2,21,374,0,374,1882-2-21,-374
1882,2,22,537,0,537,1882-2-22,-537
1882,2,23,370,0,370,1882-2-23,-370
1882,2,24,346,0,346,1882-2-24,-346
1882,2,25,174,0,174,1882-2-25,-174
1882,2,26,72,0,72,1882-2-26,-72
1882,2,27,259,7,252,1882-2-27,-245
1882,2,28,188,0,188,1882-2-28,-188
1882,3,1,227,0,227,1882-3-1,-227
1882,3,2,328,0,328,1882-3-2,-328
1882,3,3,508,36,472,1882-3-3,-436
1882,3,4,554,41,513,1882-3-4,-472
1882,3,5,560,250,310,1882-3-5,-60
1882,3,6,600,235,365,1882-3-6,-130
1882,3,7,637,290,347,1882-3-7,-57
1882,3,8,799,333,466,1882-3-8,-133
1882,3,9,941,407,534,1882-3-9,-127
1882,3,10,930,442,488,1882-3-10,-46
1882,3,11,1322,481,841,1882-3-11,-360
1882,3,12,1090,513,577,1882-3-12,-64
1882,3,13,1126,516,610,1882-3-13,-94
1882,3,14,1188,513,675,1882-3-14,-162
1882,3,15,956,407,549,1882-3-15,-142
1882,3,16,845,366,479,1882-3-16,-113
1882,3,17,490,22,468,1882-3-17,-446
1882,3,18,507,0,507,1882-3-18,-507
1882,3,19,504,0,504,1882-3-19,-504
1882,3,20,987,202,785,1882-3-20,-583
1882,3,21,1667,174,1493,1882-3-21,-1319
1882,3,22,1766,0,1766,1882-3-22,-1766
1882,3,23,1673,19,1654,1882-3-23,-1635
1882,3,24,1292,63,1229,1882-3-24,-1166
1882,3,25,1507,127,1380,1882-3-25,-1253
1882,3,26,1520,367,1153,1882-3-26,-786
1882,3,27,1186,410,776,1882-3-27,-366
1882,3,28,1042,374,668,1882-3-28,-294
1882,3,29,706,400,306,1882-3-29,94
1882,3,30,712,316,396,1882-3-30,-80
1882,3,31,625,159,466,1882-3-31,-307
1882,4,1,754,267,487,1882-4-1,-220
1882,4,2,638,304,334,1882-4-2,-30
1882,4,3,395,298,97,1882-4-3,201
1882,4,4,563,494,69,1882-4-4,425
1882,4,5,490,442,48,1882-4-5,394
1882,4,6,709,674,35,1882-4-6,639
1882,4,7,725,668,57,1882-4-7,611
1882,4,8,697,620,77,1882-4-8,543
1882,4,9,505,416,89,1882-4-9,327
1882,4,10,484,322,162,1882-4-10,160
1882,4,11,1307,352,955,1882-4-11,-603
1882,4,12,848,260,588,1882-4-12,-328
1882,4,13,2137,267,1870,1882-4-13,-1603
1882,4,14,3247,192,3055,1882-4-14,-2863
1882,4,15,2581,141,2440,1882-4-15,-2299
1882,4,16,3504,364,3140,1882-4-16,-2776
1882,4,17,4667,485,4182,1882-4-17,-3697
1882,4,18,4929,334,4595,1882-4-18,-4261
1882,4,19,3934,257,3677,1882-4-19,-3420
1882,4,20,4314,213,4101,1882-4-20,-3888
1882,4,21,5116,361,4755,1882-4-21,-4394
1882,4,22,3293,228,3065,1882-4-22,-2837
1882,4,23,3321,252,3069,1882-4-23,-2817
1882,4,24,2113,217,1896,1882-4-24,-1679
1882,4,25,997,138,859,1882-4-25,-721
1882,4,26,366,203,163,1882-4-26,40
1882,4,27,686,504,182,1882-4-27,322
1882,4,28,412,187,225,1882-4-28,-38
1882,4,29,114,114,0,1882-4-29,114
1882,4,30,126,126,0,1882-4-30,126
1882,5,1,1312,1312,0,1882-5-1,1312
1882,5,2,786,786,0,1882-5-2,786
1882,5,3,787,787,0,1882-5-3,787
1882,5,4,603,567,36,1882-5-4,531
1882,5,5,815,741,74,1882-5-5,667
1882,5,6,1080,826,254,1882-5-6,572
1882,5,7,1266,920,346,1882-5-7,574
1882,5,8,1508,1134,374,1882-5-8,760
1882,5,9,1232,937,295,1882-5-9,642
1882,5,10,2135,1339,796,1882-5-10,543
1882,5,11,2421,917,1504,1882-5-11,-587
1882,5,12,3126,1239,1887,1882-5-12,-648
1882,5,13,3187,1417,1770,1882-5-13,-353
1882,5,14,3251,735,2516,1882-5-14,-1781
1882,5,15,3055,647,2408,1882-5-15,-1761
1882,5,16,2984,499,2485,1882-5-16,-1986
1882,5,17,2866,395,2471,1882-5-17,-2076
1882,5,18,2877,226,2651,1882-5-18,-2425
1882,5,19,2091,91,2000,1882-5-19,-1909
1882,5,20,1818,55,1763,1882-5-20,-1708
1882,5,21,1602,16,1586,1882-5-21,-1570
1882,5,22,1152,9,1143,1882-5-22,-1134
1882,5,23,903,0,903,1882-5-23,-903
1882,5,24,951,0,951,1882-5-24,-951
1882,5,25,750,201,549,1882-5-25,-348
1882,5,26,494,242,252,1882-5-26,-10
1882,5,27,230,230,0,1882-5-27,230
1882,5,28,198,198,0,1882-5-28,198
1882,5,29,578,568,10,1882-5-29,558
1882,5,30,541,530,11,1882-5-30,519
1882,5,31,509,500,9,1882-5-31,491
1882,6,1,444,439,5,1882-6-1,434
1882,6,2,444,444,0,1882-6-2,444
1882,6,3,452,446,6,1882-6-3,440
1882,6,4,402,402,0,1882-6-4,402
1882,6,5,333,333,0,1882-6-5,333
1882,6,6,328,328,0,1882-6-6,328
1882,6,7,169,145,24,1882-6-7,121
1882,6,8,111,102,9,1882-6-8,93
1882,6,9,490,45,445,1882-6-9,-400
1882,6,10,299,12,287,1882-6-10,-275
1882,6,11,529,18,511,1882-6-11,-493
1882,6,12,584,5,579,1882-6-12,-574
1882,6,13,520,0,520,1882-6-13,-520
1882,6,14,828,62,766,1882-6-14,-704
1882,6,15,856,86,770,1882-6-15,-684
1882,6,16,1015,114,901,1882-6-16,-787
1882,6,17,1200,327,873,1882-6-17,-546
1882,6,18,987,344,643,1882-6-18,-299
1882,6,19,774,361,413,1882-6-19,-52
1882,6,20,686,503,183,1882-6-20,320
1882,6,21,355,355,0,1882-6-21,355
1882,6,22,339,339,0,1882-6-22,339
1882,6,23,387,387,0,1882-6-23,387
1882,6,24,220,220,0,1882-6-24,220
1882,6,25,168,123,45,1882-6-25,78
1882,6,26,228,150,78,1882-6-26,72
1882,6,27,603,209,394,1882-6-27,-185
1882,6,28,997,319,678,1882-6-28,-359
1882,6,29,940,197,743,1882-6-29,-546
1882,6,30,1047,242,805,1882-6-30,-563
1882,7,1,1269,404,865,1882-7-1,-461
1882,7,2,723,280,443,1882-7-2,-163
1882,7,3,522,238,284,1882-7-3,-46
1882,7,4,437,123,314,1882-7-4,-191
1882,7,5,376,24,352,1882-7-5,-328
1882,7,6,117,0,117,1882-7-6,-117
1882,7,7,101,0,101,1882-7-7,-101
1882,7,8,61,0,61,1882-7-8,-61
1882,7,9,0,0,0,1882-7-9,0
1882,7,10,47,47,0,1882-7-10,47
1882,7,11,113,113,0,1882-7-11,113
1882,7,12,295,295,0,1882-7-12,295
1882,7,13,278,278,0,1882-7-13,278
1882,7,14,877,877,0,1882-7-14,877
1882,7,15,1248,1248,0,1882-7-15,1248
1882,7,16,805,805,0,1882-7-16,805
1882,7,17,561,535,26,1882-7-17,509
1882,7,18,694,564,130,1882-7-18,434
1882,7,19,595,494,101,1882-7-19,393
1882,7,20,573,460,113,1882-7-20,347
1882,7,21,702,530,172,1882-7-21,358
1882,7,22,578,415,163,1882-7-22,252
1882,7,23,715,583,132,1882-7-23,451
1882,7,24,682,549,133,1882-7-24,416
1882,7,25,417,343,74,1882-7-25,269
1882,7,26,185,121,64,1882-7-26,57
1882,7,27,253,114,139,1882-7-27,-25
1882,7,28,168,28,140,1882-7-28,-112
1882,7,29,294,61,233,1882-7-29,-172
1882,7,30,285,0,285,1882-7-30,-285
1882,7,31,337,0,337,1882-7-31,-337
1882,8,1,416,0,416,1882-8-1,-416
1882,8,2,495,0,495,1882-8-2,-495
1882,8,3,453,10,443,1882-8-3,-433
1882,8,4,489,0,489,1882-8-4,-489
1882,8,5,463,0,463,1882-8-5,-463
1882,8,6,436,0,436,1882-8-6,-436
1882,8,7,0,0,0,1882-8-7,0
1882,8,8,29,29,0,1882-8-8,29
1882,8,9,232,232,0,1882-8-9,232
1882,8,10,442,434,8,1882-8-10,426
1882,8,11,757,757,0,1882-8-11,757
1882,8,12,679,679,0,1882-8-12,679
1882,8,13,576,576,0,1882-8-13,576
1882,8,14,472,472,0,1882-8-14,472
1882,8,15,512,512,0,1882-8-15,512
1882,8,16,194,194,0,1882-8-16,194
1882,8,17,107,104,3,1882-8-17,101
1882,8,18,342,297,45,1882-8-18,252
1882,8,19,665,624,41,1882-8-19,583
1882,8,20,1129,960,169,1882-8-20,791
1882,8,21,1143,695,448,1882-8-21,247
1882,8,22,1784,809,975,1882-8-22,-166
1882,8,23,1726,842,884,1882-8-23,-42
1882,8,24,1270,801,469,1882-8-24,332
1882,8,25,826,717,109,1882-8-25,608
1882,8,26,691,567,124,1882-8-26,443
1882,8,27,635,516,119,1882-8-27,397
1882,8,28,639,529,110,1882-8-28,419
1882,8,29,686,561,125,1882-8-29,436
1882,8,30,198,99,99,1882-8-30,0
1882,8,31,349,301,48,1882-8-31,253
1882,9,1,293,167,126,1882-9-1,41
1882,9,2,1184,464,720,1882-9-2,-256
1882,9,3,1126,640,486,1882-9-3,154
1882,9,4,1029,1009,20,1882-9-4,989
1882,9,5,1926,1899,27,1882-9-5,1872
1882,9,6,1557,1557,0,1882-9-6,1557
1882,9,7,1246,1246,0,1882-9-7,1246
1882,9,8,613,613,0,1882-9-8,613
1882,9,9,361,361,0,1882-9-9,361
1882,9,10,269,269,0,1882-9-10,269
1882,9,11,204,204,0,1882-9-11,204
1882,9,12,280,280,0,1882-9-12,280
1882,9,13,922,922,0,1882-9-13,922
1882,9,14,927,927,0,1882-9-14,927
1882,9,15,943,932,11,1882-9-15,921
1882,9,16,890,890,0,1882-9-16,890
1882,9,17,642,642,0,1882-9-17,642
1882,9,18,767,703,64,1882-9-18,639
1882,9,19,576,521,55,1882-9-19,466
1882,9,20,505,482,23,1882-9-20,459
1882,9,21,488,488,0,1882-9-21,488
1882,9,22,519,519,0,1882-9-22,519
1882,9,23,539,539,0,1882-9-23,539
1882,9,24,399,399,0,1882-9-24,399
1882,9,25,2650,564,2086,1882-9-25,-1522
1882,9,26,1881,354,1527,1882-9-26,-1173
1882,9,27,1974,456,1518,1882-9-27,-1062
1882,9,28,2008,552,1456,1882-9-28,-904
1882,9,29,1962,560,1402,1882-9-29,-842
1882,9,30,2126,570,1556,1882-9-30,-986
1882,10,1,2214,624,1590,1882-10-1,-966
1882,10,2,2101,521,1580,1882-10-2,-1059
1882,10,3,1995,486,1509,1882-10-3,-1023
1882,10,4,1903,373,1530,1882-10-4,-1157
1882,10,5,1751,312,1439,1882-10-5,-1127
1882,10,6,1522,220,1302,1882-10-6,-1082
1882,10,7,418,191,227,1882-10-7,-36
1882,10,8,50,50,0,1882-10-8,50
1882,10,9,26,26,0,1882-10-9,26
1882,10,10,272,272,0,1882-10-10,272
1882,10,11,176,176,0,1882-10-11,176
1882,10,12,222,222,0,1882-10-12,222
1882,10,13,688,688,0,1882-10-13,688
1882,10,14,808,808,0,1882-10-14,808
1882,10,15,630,630,0,1882-10-15,630
1882,10,16,727,727,0,1882-10-16,727
1882,10,17,664,664,0,1882-10-17,664
1882,10,18,963,950,13,1882-10-18,937
1882,10,19,1031,1018,13,1882-10-19,1005
1882,10,20,1344,1336,8,1882-10-20,1328
1882,10,21,1171,1171,0,1882-10-21,1171
1882,10,22,2679,1356,1323,1882-10-22,33
1882,10,23,2514,1301,1213,1882-10-23,88
1882,10,24,2138,1126,1012,1882-10-24,114
1882,10,25,2132,1021,1111,1882-10-25,-90
1882,10,26,2198,1160,1038,1882-10-26,122
1882,10,27,2305,1277,1028,1882-10-27,249
1882,10,28,2789,1841,948,1882-10-28,893
1882,10,29,2244,1080,1164,1882-10-29,-84
1882,10,30,1704,687,1017,1882-10-30,-330
1882,10,31,1828,650,1178,1882-10-31,-528
1882,11,1,1605,552,1053,1882-11-1,-501
1882,11,2,1567,558,1009,1882-11-2,-451
1882,11,3,1489,595,894,1882-11-3,-299
1882,11,4,1961,521,1440,1882-11-4,-919
1882,11,5,1705,492,1213,1882-11-5,-721
1882,11,6,1786,379,1407,1882-11-6,-1028
1882,11,7,1503,246,1257,1882-11-7,-1011
1882,11,8,1388,256,1132,1882-11-8,-876
1882,11,9,1283,31,1252,1882-11-9,-1221
1882,11,10,876,26,850,1882-11-10,-824
1882,11,11,1450,55,1395,1882-11-11,-1340
1882,11,12,1618,531,1087,1882-11-12,-556
1882,11,13,2467,1460,1007,1882-11-13,453
1882,11,14,2779,1771,1008,1882-11-14,763
1882,11,15,2766,2036,730,1882-11-15,1306
1882,11,16,2988,2417,571,1882-11-16,1846
1882,11,17,2771,2523,248,1882-11-17,2275
1882,11,18,2937,2743,194,1882-11-18,2549
1882,11,19,3407,2648,759,1882-11-19,1889
1882,11,20,2684,2129,555,1882-11-20,1574
1882,11,21,2120,1774,346,1882-11-21,1428
1882,11,22,2542,2083,459,1882-11-22,1624
1882,11,23,2545,2119,426,1882-11-23,1693
1882,11,24,2343,1620,723,1882-11-24,897
1882,11,25,1592,661,931,1882-11-25,-270
1882,11,26,1010,265,745,1882-11-26,-480
1882,11,27,1240,354,886,1882-11-27,-532
1882,11,28,1314,293,1021,1882-11-28,-728
1882,11,29,1110,182,928,1882-11-29,-746
1882,11,30,1088,173,915,1882-11-30,-742
1882,12,1,953,136,817,1882-12-1,-681
1882,12,2,253,60,193,1882-12-2,-133
1882,12,3,93,11,82,1882-12-3,-71
1882,12,4,0,0,0,1882-12-4,0
1882,12,5,23,0,23,1882-12-5,-23
1882,12,6,84,54,30,1882-12-6,24
1882,12,7,83,43,40,1882-12-7,3
1882,12,8,113,48,65,1882-12-8,-17
1882,12,9,431,128,303,1882-12-9,-175
1882,12,10,885,576,309,1882-12-10,267
1882,12,11,985,592,393,1882-12-11,199
1882,12,12,618,613,5,1882-12-12,608
1882,12,13,488,474,14,1882-12-13,460
1882,12,14,374,351,23,1882-12-14,328
1882,12,15,416,416,0,1882-12-15,416
1882,12,16,409,409,0,1882-12-16,409
1882,12,17,387,387,0,1882-12-17,387
1882,12,18,202,202,0,1882-12-18,202
1882,12,19,359,246,113,1882-12-19,133
1882,12,20,297,140,157,1882-12-20,-17
1882,12,21,159,35,124,1882-12-21,-89
1882,12,22,188,85,103,1882-12-22,-18
1882,12,23,66,0,66,1882-12-23,-66
1882,12,24,130,77,53,1882-12-24,24
1882,12,25,73,30,43,1882-12-25,-13
1882,12,26,399,0,399,1882-12-26,-399
1882,12,27,40,24,16,1882-12-27,8
1882,12,28,318,18,300,1882-12-28,-282
1882,12,29,285,25,260,1882-12-29,-235
1882,12,30,682,15,667,1882-12-30,-652
1882,12,31,1147,75,1072,1882-12-31,-997
1883,1,1,1700,494,1206,1883-1-1,-712
1883,1,2,2015,802,1213,1883-1-2,-411
1883,1,3,1665,602,1063,1883-1-3,-461
1883,1,4,1523,633,890,1883-1-4,-257
1883,1,5,1428,593,835,1883-1-5,-242
1883,1,6,1022,447,575,1883-1-6,-128
1883,1,7,756,299,457,1883-1-7,-158
1883,1,8,211,72,139,1883-1-8,-67
1883,1,9,238,103,135,1883-1-9,-32
1883,1,10,908,184,724,1883-1-10,-540
1883,1,11,719,35,684,1883-1-11,-649
1883,1,12,762,221,541,1883-1-12,-320
1883,1,13,920,287,633,1883-1-13,-346
1883,1,14,973,291,682,1883-1-14,-391
1883,1,15,870,271,599,1883-1-15,-328
1883,1,16,1421,301,1120,1883-1-16,-819
1883,1,17,1336,226,1110,1883-1-17,-884
1883,1,18,1344,258,1086,1883-1-18,-828
1883,1,19,1338,268,1070,1883-1-19,-802
1883,1,20,1094,270,824,1883-1-20,-554
1883,1,21,876,299,577,1883-1-21,-278
1883,1,22,641,330,311,1883-1-22,19
1883,1,23,404,136,268,1883-1-23,-132
1883,1,24,137,0,137,1883-1-24,-137
1883,1,25,145,0,145,1883-1-25,-145
1883,1,26,297,93,204,1883-1-26,-111
1883,1,27,404,68,336,1883-1-27,-268
1883,1,28,257,69,188,1883-1-28,-119
1883,1,29,300,116,184,1883-1-29,-68
1883,1,30,323,68,255,1883-1-30,-187
1883,1,31,316,190,126,1883-1-31,64
1883,2,1,561,330,231,1883-2-1,99
1883,2,2,526,202,324,1883-2-2,-122
1883,2,3,574,208,366,1883-2-3,-158
1883,2,4,425,193,232,1883-2-4,-39
1883,2,5,437,204,233,1883-2-5,-29
1883,2,6,927,608,319,1883-2-6,289
1883,2,7,1110,851,259,1883-2-7,592
1883,2,8,1187,685,502,1883-2-8,183
1883,2,9,1414,706,708,1883-2-9,-2
1883,2,10,1103,469,634,1883-2-10,-165
1883,2,11,1367,848,519,1883-2-11,329
1883,2,12,1509,1033,476,1883-2-12,557
1883,2,13,1467,1073,394,1883-2-13,679
1883,2,14,1249,938,311,1883-2-14,627
1883,2,15,1329,955,374,1883-2-15,581
1883,2,16,899,695,204,1883-2-16,491
1883,2,17,816,669,147,1883-2-17,522
1883,2,18,714,573,141,1883-2-18,432
1883,2,19,793,574,219,1883-2-19,355
1883,2,20,503,418,85,1883-2-20,333
1883,2,21,434,413,21,1883-2-21,392
1883,2,22,614,614,0,1883-2-22,614
1883,2,23,0,0,0,1883-2-23,0
1883,2,24,34,0,34,1883-2-24,-34
1883,2,25,34,0,34,1883-2-25,-34
1883,2,26,168,16,152,1883-2-26,-136
1883,2,27,201,29,172,1883-2-27,-143
1883,2,28,179,26,153,1883-2-28,-127
1883,3,1,134,13,121,1883-3-1,-108
1883,3,2,74,0,74,1883-3-2,-74
1883,3,3,46,0,46,1883-3-3,-46
1883,3,4,48,0,48,1883-3-4,-48
1883,3,5,0,0,0,1883-3-5,0
1883,3,6,0,0,0,1883-3-6,0
1883,3,7,170,0,170,1883-3-7,-170
1883,3,8,204,63,141,1883-3-8,-78
1883,3,9,123,32,91,1883-3-9,-59
1883,3,10,373,29,344,1883-3-10,-315
1883,3,11,339,50,289,1883-3-11,-239
1883,3,12,550,168,382,1883-3-12,-214
1883,3,13,627,176,451,1883-3-13,-275
1883,3,14,560,207,353,1883-3-14,-146
1883,3,15,496,177,319,1883-3-15,-142
1883,3,16,927,180,747,1883-3-16,-567
1883,3,17,898,122,776,1883-3-17,-654
1883,3,18,944,36,908,1883-3-18,-872
1883,3,19,856,38,818,1883-3-19,-780
1883,3,20,721,20,701,1883-3-20,-681
1883,3,21,703,18,685,1883-3-21,-667
1883,3,22,918,43,875,1883-3-22,-832
1883,3,23,922,0,922,1883-3-23,-922
1883,3,24,1125,0,1125,1883-3-24,-1125
1883,3,25,749,0,749,1883-3-25,-749
1883,3,26,848,0,848,1883-3-26,-848
1883,3,27,567,0,567,1883-3-27,-567
1883,3,28,1198,669,529,1883-3-28,140
1883,3,29,1391,674,717,1883-3-29,-43
1883,3,30,1521,1012,509,1883-3-30,503
1883,3,31,1225,679,546,1883-3-31,133
1883,4,1,1200,769,431,1883-4-1,338
1883,4,2,1297,795,502,1883-4-2,293
1883,4,3,1305,688,617,1883-4-3,71
1883,4,4,1055,630,425,1883-4-4,205
1883,4,5,1415,753,662,1883-4-5,91
1883,4,6,1620,865,755,1883-4-6,110
1883,4,7,929,461,468,1883-4-7,-7
1883,4,8,904,355,549,1883-4-8,-194
1883,4,9,945,384,561,1883-4-9,-177
1883,4,10,532,83,449,1883-4-10,-366
1883,4,11,370,56,314,1883-4-11,-258
1883,4,12,1503,460,1043,1883-4-12,-583
1883,4,13,2387,551,1836,1883-4-13,-1285
1883,4,14,2626,584,2042,1883-4-14,-1458
1883,4,15,2149,423,1726,1883-4-15,-1303
1883,4,16,1724,262,1462,1883-4-16,-1200
1883,4,17,1883,433,1450,1883-4-17,-1017
1883,4,18,2026,539,1487,1883-4-18,-948
1883,4,19,1835,447,1388,1883-4-19,-941
1883,4,20,1011,0,1011,1883-4-20,-1011
1883,4,21,960,0,960,1883-4-21,-960
1883,4,22,1121,166,955,1883-4-22,-789
1883,4,23,770,135,635,1883-4-23,-500
1883,4,24,334,227,107,1883-4-24,120
1883,4,25,581,370,211,1883-4-25,159
1883,4,26,455,287,168,1883-4-26,119
1883,4,27,262,242,20,1883-4-27,222
1883,4,28,292,252,40,1883-4-28,212
1883,4,29,303,242,61,1883-4-29,181
1883,4,30,181,181,0,1883-4-30,181
1883,5,1,183,183,0,1883-5-1,183
1883,5,2,144,144,0,1883-5-2,144
1883,5,3,208,186,22,1883-5-3,164
1883,5,4,206,58,148,1883-5-4,-90
1883,5,5,150,0,150,1883-5-5,-150
1883,5,6,128,23,105,1883-5-6,-82
1883,5,7,226,80,146,1883-5-7,-66
1883,5,8,270,159,111,1883-5-8,48
1883,5,9,777,278,499,1883-5-9,-221
1883,5,10,983,583,400,1883-5-10,183
1883,5,11,841,387,454,1883-5-11,-67
1883,5,12,671,265,406,1883-5-12,-141
1883,5,13,756,314,442,1883-5-13,-128
1883,5,14,687,271,416,1883-5-14,-145
1883,5,15,486,134,352,1883-5-15,-218
1883,5,16,517,182,335,1883-5-16,-153
1883,5,17,700,186,514,1883-5-17,-328
1883,5,18,572,172,400,1883-5-18,-228
1883,5,19,649,212,437,1883-5-19,-225
1883,5,20,475,170,305,1883-5-20,-135
1883,5,21,313,130,183,1883-5-21,-53
1883,5,22,7,7,0,1883-5-22,7
1883,5,23,60,46,14,1883-5-23,32
1883,5,24,46,46,0,1883-5-24,46
1883,5,25,30,30,0,1883-5-25,30
1883,5,26,0,0,0,1883-5-26,0
1883,5,27,0,0,0,1883-5-27,0
1883,5,28,0,0,0,1883-5-28,0
1883,5,29,9,9,0,1883-5-29,9
1883,5,30,90,90,0,1883-5-30,90
1883,5,31,336,336,0,1883-5-31,336
1883,6,1,336,185,151,1883-6-1,34
1883,6,2,1336,307,1029,1883-6-2,-722
1883,6,3,1553,247,1306,1883-6-3,-1059
1883,6,4,1994,417,1577,1883-6-4,-1160
1883,6,5,1550,206,1344,1883-6-5,-1138
1883,6,6,1482,123,1359,1883-6-6,-1236
1883,6,7,1245,189,1056,1883-6-7,-867
1883,6,8,721,114,607,1883-6-8,-493
1883,6,9,490,90,400,1883-6-9,-310
1883,6,10,328,57,271,1883-6-10,-214
1883,6,11,343,26,317,1883-6-11,-291
1883,6,12,450,0,450,1883-6-12,-450
1883,6,13,772,111,661,1883-6-13,-550
1883,6,14,891,106,785,1883-6-14,-679
1883,6,15,755,82,673,1883-6-15,-591
1883,6,16,718,18,700,1883-6-16,-682
1883,6,17,1079,22,1057,1883-6-17,-1035
1883,6,18,772,28,744,1883-6-18,-716
1883,6,19,740,18,722,1883-6-19,-704
1883,6,20,1311,14,1297,1883-6-20,-1283
1883,6,21,1623,0,1623,1883-6-21,-1623
1883,6,22,1705,0,1705,1883-6-22,-1705
1883,6,23,2250,0,2250,1883-6-23,-2250
1883,6,24,1824,11,1813,1883-6-24,-1802
1883,6,25,2740,801,1939,1883-6-25,-1138
1883,6,26,2650,996,1654,1883-6-26,-658
1883,6,27,3040,1427,1613,1883-6-27,-186
1883,6,28,2725,1516,1209,1883-6-28,307
1883,6,29,3024,1807,1217,1883-6-29,590
1883,6,30,3096,2092,1004,1883-6-30,1088
1883,7,1,2229,1769,460,1883-7-1,1309
1883,7,2,2191,1721,470,1883-7-2,1251
1883,7,3,2478,1704,774,1883-7-3,930
1883,7,4,2386,1503,883,1883-7-4,620
1883,7,5,1905,1323,582,1883-7-5,741
1883,7,6,1693,1129,564,1883-7-6,565
1883,7,7,1650,939,711,1883-7-7,228
1883,7,8,630,0,630,1883-7-8,-630
1883,7,9,1117,0,1117,1883-7-9,-1117
1883,7,10,1344,0,1344,1883-7-10,-1344
1883,7,11,1598,72,1526,1883-7-11,-1454
1883,7,12,1713,105,1608,1883-7-12,-1503
1883,7,13,1851,232,1619,1883-7-13,-1387
1883,7,14,1547,200,1347,1883-7-14,-1147
1883,7,15,1637,203,1434,1883-7-15,-1231
1883,7,16,1613,126,1487,1883-7-16,-1361
1883,7,17,1631,32,1599,1883-7-17,-1567
1883,7,18,1757,47,1710,1883-7-18,-1663
1883,7,19,2922,71,2851,1883-7-19,-2780
1883,7,20,3482,199,3283,1883-7-20,-3084
1883,7,21,3404,287,3117,1883-7-21,-2830
1883,7,22,2789,164,2625,1883-7-22,-2461
1883,7,23,2831,135,2696,1883-7-23,-2561
1883,7,24,3079,286,2793,1883-7-24,-2507
1883,7,25,2843,211,2632,1883-7-25,-2421
1883,7,26,1813,137,1676,1883-7-26,-1539
1883,7,27,1902,137,1765,1883-7-27,-1628
1883,7,28,1573,134,1439,1883-7-28,-1305
1883,7,29,1213,112,1101,1883-7-29,-989
1883,7,30,1458,98,1360,1883-7-30,-1262
1883,7,31,1959,101,1858,1883-7-31,-1757
1883,8,1,333,90,243,1883-8-1,-153
1883,8,2,183,60,123,1883-8-2,-63
1883,8,3,54,0,54,1883-8-3,-54
1883,8,4,0,0,0,1883-8-4,0
1883,8,5,0,0,0,1883-8-5,0
1883,8,6,0,0,0,1883-8-6,0
1883,8,7,164,124,40,1883-8-7,84
1883,8,8,514,94,420,1883-8-8,-326
1883,8,9,349,15,334,1883-8-9,-319
1883,8,10,478,79,399,1883-8-10,-320
1883,8,11,452,191,261,1883-8-11,-70
1883,8,12,472,171,301,1883-8-12,-130
1883,8,13,438,151,287,1883-8-13,-136
1883,8,14,718,81,637,1883-8-14,-556
1883,8,15,331,29,302,1883-8-15,-273
1883,8,16,403,20,383,1883-8-16,-363
1883,8,17,551,77,474,1883-8-17,-397
1883,8,18,558,48,510,1883-8-18,-462
1883,8,19,383,83,300,1883-8-19,-217
1883,8,20,433,31,402,1883-8-20,-371
1883,8,21,746,0,746,1883-8-21,-746
1883,8,22,779,0,779,1883-8-22,-779
1883,8,23,769,0,769,1883-8-23,-769
1883,8,24,727,0,727,1883-8-24,-727
1883,8,25,602,36,566,1883-8-25,-530
1883,8,26,690,200,490,1883-8-26,-290
1883,8,27,697,282,415,1883-8-27,-133
1883,8,28,1055,328,727,1883-8-28,-399
1883,8,29,1180,267,913,1883-8-29,-646
1883,8,30,2041,206,1835,1883-8-30,-1629
1883,8,31,2363,221,2142,1883-8-31,-1921
1883,9,1,2464,326,2138,1883-9-1,-1812
1883,9,2,2177,306,1871,1883-9-2,-1565
1883,9,3,2274,466,1808,1883-9-3,-1342
1883,9,4,1840,295,1545,1883-9-4,-1250
1883,9,5,1716,268,1448,1883-9-5,-1180
1883,9,6,1482,266,1216,1883-9-6,-950
1883,9,7,1317,264,1053,1883-9-7,-789
1883,9,8,2143,298,1845,1883-9-8,-1547
1883,9,9,1721,248,1473,1883-9-9,-1225
1883,9,10,1474,352,1122,1883-9-10,-770
1883,9,11,1380,336,1044,1883-9-11,-708
1883,9,12,1895,710,1185,1883-9-12,-475
1883,9,13,1769,681,1088,1883-9-13,-407
1883,9,14,1870,675,1195,1883-9-14,-520
1883,9,15,1791,550,1241,1883-9-15,-691
1883,9,16,1705,431,1274,1883-9-16,-843
1883,9,17,1708,406,1302,1883-9-17,-896
1883,9,18,1691,424,1267,1883-9-18,-843
1883,9,19,1471,441,1030,1883-9-19,-589
1883,9,20,931,529,402,1883-9-20,127
1883,9,21,394,394,0,1883-9-21,394
1883,9,22,516,511,5,1883-9-22,506
1883,9,23,407,407,0,1883-9-23,407
1883,9,24,0,0,0,1883-9-24,0
1883,9,25,0,0,0,1883-9-25,0
1883,9,26,120,0,120,1883-9-26,-120
1883,9,27,109,0,109,1883-9-27,-109
1883,9,28,181,0,181,1883-9-28,-181
1883,9,29,186,22,164,1883-9-29,-142
1883,9,30,175,7,168,1883-9-30,-161
1883,10,1,128,0,128,1883-10-1,-128
1883,10,2,529,0,529,1883-10-2,-529
1883,10,3,418,0,418,1883-10-3,-418
1883,10,4,483,0,483,1883-10-4,-483
1883,10,5,790,0,790,1883-10-5,-790
1883,10,6,939,101,838,1883-10-6,-737
1883,10,7,1108,62,1046,1883-10-7,-984
1883,10,8,1160,141,1019,1883-10-8,-878
1883,10,9,1459,463,996,1883-10-9,-533
1883,10,10,2205,654,1551,1883-10-10,-897
1883,10,11,2509,749,1760,1883-10-11,-1011
1883,10,12,3096,889,2207,1883-10-12,-1318
1883,10,13,4283,1223,3060,1883-10-13,-1837
1883,10,14,4061,1326,2735,1883-10-14,-1409
1883,10,15,4630,2072,2558,1883-10-15,-486
1883,10,16,4007,1768,2239,1883-10-16,-471
1883,10,17,3205,1384,1821,1883-10-17,-437
1883,10,18,1360,33,1327,1883-10-18,-1294
1883,10,19,1374,0,1374,1883-10-19,-1374
1883,10,20,1403,0,1403,1883-10-20,-1403
1883,10,21,1576,265,1311,1883-10-21,-1046
1883,10,22,1349,335,1014,1883-10-22,-679
1883,10,23,1201,152,1049,1883-10-23,-897
1883,10,24,1231,90,1141,1883-10-24,-1051
1883,10,25,1008,117,891,1883-10-25,-774
1883,10,26,1315,93,1222,1883-10-26,-1129
1883,10,27,1622,57,1565,1883-10-27,-1508
1883,10,28,1890,182,1708,1883-10-28,-1526
1883,10,29,1887,661,1226,1883-10-29,-565
1883,10,30,1839,777,1062,1883-10-30,-285
1883,10,31,1528,753,775,1883-10-31,-22
1883,11,1,1781,1049,732,1883-11-1,317
1883,11,2,1698,964,734,1883-11-2,230
1883,11,3,1485,842,643,1883-11-3,199
1883,11,4,1285,704,581,1883-11-4,123
1883,11,5,1264,623,641,1883-11-5,-18
1883,11,6,1013,483,530,1883-11-6,-47
1883,11,7,1169,312,857,1883-11-7,-545
1883,11,8,596,282,314,1883-11-8,-32
1883,11,9,1105,107,998,1883-11-9,-891
1883,11,10,1421,88,1333,1883-11-10,-1245
1883,11,11,1416,63,1353,1883-11-11,-1290
1883,11,12,1448,76,1372,1883-11-12,-1296
1883,11,13,1983,133,1850,1883-11-13,-1717
1883,11,14,2115,119,1996,1883-11-14,-1877
1883,11,15,2766,547,2219,1883-11-15,-1672
1883,11,16,2727,613,2114,1883-11-16,-1501
1883,11,17,3057,809,2248,1883-11-17,-1439
1883,11,18,3086,922,2164,1883-11-18,-1242
1883,11,19,3120,842,2278,1883-11-19,-1436
1883,11,20,3158,851,2307,1883-11-20,-1456
1883,11,21,1906,773,1133,1883-11-21,-360
1883,11,22,2709,565,2144,1883-11-22,-1579
1883,11,23,2974,734,2240,1883-11-23,-1506
1883,11,24,2092,1022,1070,1883-11-24,-48
1883,11,25,1816,980,836,1883-11-25,144
1883,11,26,531,0,531,1883-11-26,-531
1883,11,27,457,14,443,1883-11-27,-429
1883,11,28,417,43,374,1883-11-28,-331
1883,11,29,486,174,312,1883-11-29,-138
1883,11,30,687,413,274,1883-11-30,139
1883,12,1,578,368,210,1883-12-1,158
1883,12,2,547,363,184,1883-12-2,179
1883,12,3,449,310,139,1883-12-3,171
1883,12,4,385,257,128,1883-12-4,129
1883,12,5,0,0,0,1883-12-5,0
1883,12,6,297,59,238,1883-12-6,-179
1883,12,7,386,40,346,1883-12-7,-306
1883,12,8,570,27,543,1883-12-8,-516
1883,12,9,643,183,460,1883-12-9,-277
1883,12,10,997,441,556,1883-12-10,-115
1883,12,11,1477,752,725,1883-12-11,27
1883,12,12,1248,576,672,1883-12-12,-96
1883,12,13,1432,591,841,1883-12-13,-250
1883,12,14,1133,376,757,1883-12-14,-381
1883,12,15,737,365,372,1883-12-15,-7
1883,12,16,762,358,404,1883-12-16,-46
1883,12,17,901,429,472,1883-12-17,-43
1883,12,18,596,306,290,1883-12-18,16
1883,12,19,1486,316,1170,1883-12-19,-854
1883,12,20,2185,540,1645,1883-12-20,-1105
1883,12,21,2739,475,2264,1883-12-21,-1789
1883,12,22,3175,546,2629,1883-12-22,-2083
1883,12,23,3153,481,2672,1883-12-23,-2191
1883,12,24,2588,429,2159,1883-12-24,-1730
1883,12,25,2602,374,2228,1883-12-25,-1854
1883,12,26,2305,432,1873,1883-12-26,-1441
1883,12,27,1919,345,1574,1883-12-27,-1229
1883,12,28,1651,319,1332,1883-12-28,-1013
1883,12,29,1511,322,1189,1883-12-29,-867
1883,12,30,1095,193,902,1883-12-30,-709
1883,12,31,920,182,738,1883-12-31,-556
1884,1,1,754,170,584,1884-1-1,-414
1884,1,2,1096,633,463,1884-1-2,170
1884,1,3,1048,536,512,1884-1-3,24
1884,1,4,1686,1645,41,1884-1-4,1604
1884,1,5,1907,1461,446,1884-1-5,1015
1884,1,6,2395,1495,900,1884-1-6,595
1884,1,7,2626,1754,872,1884-1-7,882
1884,1,8,2331,1563,768,1884-1-8,795
1884,1,9,2078,1345,733,1884-1-9,612
1884,1,10,2339,1595,744,1884-1-10,851
1884,1,11,2534,1800,734,1884-1-11,1066
1884,1,12,2171,1732,439,1884-1-12,1293
1884,1,13,2000,1458,542,1884-1-13,916
1884,1,14,1827,1248,579,1884-1-14,669
1884,1,15,1747,768,979,1884-1-15,-211
1884,1,16,1127,48,1079,1884-1-16,-1031
1884,1,17,1848,226,1622,1884-1-17,-1396
1884,1,18,1477,165,1312,1884-1-18,-1147
1884,1,19,1285,163,1122,1884-1-19,-959
1884,1,20,1302,175,1127,1884-1-20,-952
1884,1,21,1247,97,1150,1884-1-21,-1053
1884,1,22,1200,89,1111,1884-1-22,-1022
1884,1,23,1028,97,931,1884-1-23,-834
1884,1,24,957,236,721,1884-1-24,-485
1884,1,25,1187,551,636,1884-1-25,-85
1884,1,26,995,595,400,1884-1-26,195
1884,1,27,1564,910,654,1884-1-27,256
1884,1,28,2120,1397,723,1884-1-28,674
1884,1,29,1521,1333,188,1884-1-29,1145
1884,1,30,1965,1290,675,1884-1-30,615
1884,1,31,2400,1634,766,1884-1-31,868
1884,2,1,2637,1884,753,1884-2-1,1131
1884,2,2,2118,1453,665,1884-2-2,788
1884,2,3,1690,1060,630,1884-2-3,430
1884,2,4,1934,1340,594,1884-2-4,746
1884,2,5,1626,1080,546,1884-2-5,534
1884,2,6,1651,1134,517,1884-2-6,617
1884,2,7,1557,1038,519,1884-2-7,519
1884,2,8,1196,708,488,1884-2-8,220
1884,2,9,1270,842,428,1884-2-9,414
1884,2,10,2216,1610,606,1884-2-10,1004
1884,2,11,1817,1234,583,1884-2-11,651
1884,2,12,1056,915,141,1884-2-12,774
1884,2,13,1470,911,559,1884-2-13,352
1884,2,14,1670,957,713,1884-2-14,244
1884,2,15,1690,855,835,1884-2-15,20
1884,2,16,1356,564,792,1884-2-16,-228
1884,2,17,1411,634,777,1884-2-17,-143
1884,2,18,1691,893,798,1884-2-18,95
1884,2,19,1243,877,366,1884-2-19,511
1884,2,20,1254,860,394,1884-2-20,466
1884,2,21,948,526,422,1884-2-21,104
1884,2,22,966,613,353,1884-2-22,260
1884,2,23,1028,647,381,1884-2-23,266
1884,2,24,1322,672,650,1884-2-24,22
1884,2,25,1673,1165,508,1884-2-25,657
1884,2,26,1852,1568,284,1884-2-26,1284
1884,2,27,1710,1414,296,1884-2-27,1118
1884,2,28,1130,606,524,1884-2-28,82
1884,2,29,1389,600,789,1884-2-29,-189
1884,3,1,1348,522,826,1884-3-1,-304
1884,3,2,1276,577,699,1884-3-2,-122
1884,3,3,1373,655,718,1884-3-3,-63
1884,3,4,1331,531,800,1884-3-4,-269
1884,3,5,1418,453,965,1884-3-5,-512
1884,3,6,1579,466,1113,1884-3-6,-647
1884,3,7,1341,306,1035,1884-3-7,-729
1884,3,8,997,165,832,1884-3-8,-667
1884,3,9,1501,429,1072,1884-3-9,-643
1884,3,10,1573,459,1114,1884-3-10,-655
1884,3,11,1419,449,970,1884-3-11,-521
1884,3,12,1066,266,800,1884-3-12,-534
1884,3,13,717,211,506,1884-3-13,-295
1884,3,14,1231,554,677,1884-3-14,-123
1884,3,15,1873,676,1197,1884-3-15,-521
1884,3,16,1441,661,780,1884-3-16,-119
1884,3,17,1349,748,601,1884-3-17,147
1884,3,18,1758,779,979,1884-3-18,-200
1884,3,19,1561,777,784,1884-3-19,-7
1884,3,20,1350,699,651,1884-3-20,48
1884,3,21,1141,638,503,1884-3-21,135
1884,3,22,1581,496,1085,1884-3-22,-589
1884,3,23,1305,359,946,1884-3-23,-587
1884,3,24,1201,403,798,1884-3-24,-395
1884,3,25,1101,328,773,1884-3-25,-445
1884,3,26,751,21,730,1884-3-26,-709
1884,3,27,633,6,627,1884-3-27,-621
1884,3,28,630,0,630,1884-3-28,-630
1884,3,29,777,0,777,1884-3-29,-777
1884,3,30,380,0,380,1884-3-30,-380
1884,3,31,423,0,423,1884-3-31,-423
1884,4,1,509,0,509,1884-4-1,-509
1884,4,2,1531,0,1531,1884-4-2,-1531
1884,4,3,2663,0,2663,1884-4-3,-2663
1884,4,4,3188,0,3188,1884-4-4,-3188
1884,4,5,3510,14,3496,1884-4-5,-3482
1884,4,6,3620,68,3552,1884-4-6,-3484
1884,4,7,1791,37,1754,1884-4-7,-1717
1884,4,8,1279,11,1268,1884-4-8,-1257
1884,4,9,1143,69,1074,1884-4-9,-1005
1884,4,10,1171,73,1098,1884-4-10,-1025
1884,4,11,1390,139,1251,1884-4-11,-1112
1884,4,12,1187,120,1067,1884-4-12,-947
1884,4,13,1082,124,958,1884-4-13,-834
1884,4,14,1014,93,921,1884-4-14,-828
1884,4,15,1048,112,936,1884-4-15,-824
1884,4,16,585,133,452,1884-4-16,-319
1884,4,17,585,200,385,1884-4-17,-185
1884,4,18,766,358,408,1884-4-18,-50
1884,4,19,1132,491,641,1884-4-19,-150
1884,4,20,1447,636,811,1884-4-20,-175
1884,4,21,1521,297,1224,1884-4-21,-927
1884,4,22,1788,17,1771,1884-4-22,-1754
1884,4,23,2132,0,2132,1884-4-23,-2132
1884,4,24,1985,0,1985,1884-4-24,-1985
1884,4,25,1624,0,1624,1884-4-25,-1624
1884,4,26,1637,0,1637,1884-4-26,-1637
1884,4,27,1645,0,1645,1884-4-27,-1645
1884,4,28,1541,0,1541,1884-4-28,-1541
1884,4,29,1442,0,1442,1884-4-29,-1442
1884,4,30,1481,0,1481,1884-4-30,-1481
1884,5,1,1484,0,1484,1884-5-1,-1484
1884,5,2,904,0,904,1884-5-2,-904
1884,5,3,850,0,850,1884-5-3,-850
1884,5,4,437,0,437,1884-5-4,-437
1884,5,5,693,0,693,1884-5-5,-693
1884,5,6,670,74,596,1884-5-6,-522
1884,5,7,1064,291,773,1884-5-7,-482
1884,5,8,227,212,15,1884-5-8,197
1884,5,9,759,422,337,1884-5-9,85
1884,5,10,1108,620,488,1884-5-10,132
1884,5,11,1582,902,680,1884-5-11,222
1884,5,12,1533,849,684,1884-5-12,165
1884,5,13,1349,701,648,1884-5-13,53
1884,5,14,1361,733,628,1884-5-14,105
1884,5,15,1200,447,753,1884-5-15,-306
1884,5,16,1141,64,1077,1884-5-16,-1013
1884,5,17,1249,77,1172,1884-5-17,-1095
1884,5,18,1444,51,1393,1884-5-18,-1342
1884,5,19,1641,9,1632,1884-5-19,-1623
1884,5,20,1504,0,1504,1884-5-20,-1504
1884,5,21,1373,0,1373,1884-5-21,-1373
1884,5,22,1264,149,1115,1884-5-22,-966
1884,5,23,1386,190,1196,1884-5-23,-1006
1884,5,24,1397,137,1260,1884-5-24,-1123
1884,5,25,1473,175,1298,1884-5-25,-1123
1884,5,26,1369,206,1163,1884-5-26,-957
1884,5,27,1351,264,1087,1884-5-27,-823
1884,5,28,1477,584,893,1884-5-28,-309
1884,5,29,1353,602,751,1884-5-29,-149
1884,5,30,1449,616,833,1884-5-30,-217
1884,5,31,1443,589,854,1884-5-31,-265
1884,6,1,1251,484,767,1884-6-1,-283
1884,6,2,948,313,635,1884-6-2,-322
1884,6,3,1198,664,534,1884-6-3,130
1884,6,4,716,448,268,1884-6-4,180
1884,6,5,655,389,266,1884-6-5,123
1884,6,6,803,349,454,1884-6-6,-105
1884,6,7,726,226,500,1884-6-7,-274
1884,6,8,448,0,448,1884-6-8,-448
1884,6,9,398,0,398,1884-6-9,-398
1884,6,10,348,0,348,1884-6-10,-348
1884,6,11,450,86,364,1884-6-11,-278
1884,6,12,393,128,265,1884-6-12,-137
1884,6,13,386,121,265,1884-6-13,-144
1884,6,14,398,105,293,1884-6-14,-188
1884,6,15,428,93,335,1884-6-15,-242
1884,6,16,385,76,309,1884-6-16,-233
1884,6,17,199,0,199,1884-6-17,-199
1884,6,18,196,0,196,1884-6-18,-196
1884,6,19,195,0,195,1884-6-19,-195
1884,6,20,344,101,243,1884-6-20,-142
1884,6,21,220,51,169,1884-6-21,-118
1884,6,22,338,66,272,1884-6-22,-206
1884,6,23,247,60,187,1884-6-23,-127
1884,6,24,157,55,102,1884-6-24,-47
1884,6,25,264,145,119,1884-6-25,26
1884,6,26,526,253,273,1884-6-26,-20
1884,6,27,605,265,340,1884-6-27,-75
1884,6,28,519,118,401,1884-6-28,-283
1884,6,29,556,143,413,1884-6-29,-270
1884,6,30,750,331,419,1884-6-30,-88
1884,7,1,817,402,415,1884-7-1,-13
1884,7,2,899,487,412,1884-7-2,75
1884,7,3,1342,662,680,1884-7-3,-18
1884,7,4,1704,792,912,1884-7-4,-120
1884,7,5,1576,749,827,1884-7-5,-78
1884,7,6,1037,325,712,1884-7-6,-387
1884,7,7,863,265,598,1884-7-7,-333
1884,7,8,838,355,483,1884-7-8,-128
1884,7,9,547,427,120,1884-7-9,307
1884,7,10,338,267,71,1884-7-10,196
1884,7,11,252,146,106,1884-7-11,40
1884,7,12,426,203,223,1884-7-12,-20
1884,7,13,213,213,0,1884-7-13,213
1884,7,14,242,242,0,1884-7-14,242
1884,7,15,272,272,0,1884-7-15,272
1884,7,16,301,301,0,1884-7-16,301
1884,7,17,331,331,0,1884-7-17,331
1884,7,18,360,360,0,1884-7-18,360
1884,7,19,586,399,187,1884-7-19,212
1884,7,20,283,84,199,1884-7-20,-115
1884,7,21,242,0,242,1884-7-21,-242
1884,7,22,285,0,285,1884-7-22,-285
1884,7,23,327,0,327,1884-7-23,-327
1884,7,24,370,0,370,1884-7-24,-370
1884,7,25,387,0,387,1884-7-25,-387
1884,7,26,572,20,552,1884-7-26,-532
1884,7,27,591,23,568,1884-7-27,-545
1884,7,28,142,127,15,1884-7-28,112
1884,7,29,245,232,13,1884-7-29,219
1884,7,30,348,337,11,1884-7-30,326
1884,7,31,664,441,223,1884-7-31,218
1884,8,1,1314,608,706,1884-8-1,-98
1884,8,2,1512,411,1101,1884-8-2,-690
1884,8,3,1413,451,962,1884-8-3,-511
1884,8,4,1873,488,1385,1884-8-4,-897
1884,8,5,1059,356,703,1884-8-5,-347
1884,8,6,419,282,137,1884-8-6,145
1884,8,7,249,167,82,1884-8-7,85
1884,8,8,458,214,244,1884-8-8,-30
1884,8,9,427,195,232,1884-8-9,-37
1884,8,10,539,382,157,1884-8-10,225
1884,8,11,475,326,149,1884-8-11,177
1884,8,12,462,351,111,1884-8-12,240
1884,8,13,907,613,294,1884-8-13,319
1884,8,14,979,649,330,1884-8-14,319
1884,8,15,955,618,337,1884-8-15,281
1884,8,16,259,0,259,1884-8-16,-259
1884,8,17,287,37,250,1884-8-17,-213
1884,8,18,252,55,197,1884-8-18,-142
1884,8,19,193,33,160,1884-8-19,-127
1884,8,20,551,64,487,1884-8-20,-423
1884,8,21,709,206,503,1884-8-21,-297
1884,8,22,830,410,420,1884-8-22,-10
1884,8,23,616,356,260,1884-8-23,96
1884,8,24,595,449,146,1884-8-24,303
1884,8,25,725,612,113,1884-8-25,499
1884,8,26,1007,812,195,1884-8-26,617
1884,8,27,1319,1130,189,1884-8-27,941
1884,8,28,770,631,139,1884-8-28,492
1884,8,29,1068,850,218,1884-8-29,632
1884,8,30,168,0,168,1884-8-30,-168
1884,8,31,151,0,151,1884-8-31,-151
1884,9,1,133,0,133,1884-9-1,-133
1884,9,2,117,0,117,1884-9-2,-117
1884,9,3,79,0,79,1884-9-3,-79
1884,9,4,62,0,62,1884-9-4,-62
1884,9,5,69,17,52,1884-9-5,-35
1884,9,6,155,78,77,1884-9-6,1
1884,9,7,537,38,499,1884-9-7,-461
1884,9,8,939,405,534,1884-9-8,-129
1884,9,9,997,667,330,1884-9-9,337
1884,9,10,1008,831,177,1884-9-10,654
1884,9,11,1067,944,123,1884-9-11,821
1884,9,12,1496,1385,111,1884-9-12,1274
1884,9,13,1681,1598,83,1884-9-13,1515
1884,9,14,1952,1893,59,1884-9-14,1834
1884,9,15,2280,2246,34,1884-9-15,2212
1884,9,16,2574,2574,0,1884-9-16,2574
1884,9,17,2620,2620,0,1884-9-17,2620
1884,9,18,1160,1142,18,1884-9-18,1124
1884,9,19,1142,1120,22,1884-9-19,1098
1884,9,20,1212,1126,86,1884-9-20,1040
1884,9,21,991,930,61,1884-9-21,869
1884,9,22,1144,923,221,1884-9-22,702
1884,9,23,1485,873,612,1884-9-23,261
1884,9,24,1119,500,619,1884-9-24,-119
1884,9,25,1380,523,857,1884-9-25,-334
1884,9,26,1114,329,785,1884-9-26,-456
1884,9,27,1199,264,935,1884-9-27,-671
1884,9,28,1087,0,1087,1884-9-28,-1087
1884,9,29,1239,0,1239,1884-9-29,-1239
1884,9,30,1416,25,1391,1884-9-30,-1366
1884,10,1,759,15,744,1884-10-1,-729
1884,10,2,1313,469,844,1884-10-2,-375
1884,10,3,1863,1055,808,1884-10-3,247
1884,10,4,1720,1000,720,1884-10-4,280
1884,10,5,1810,992,818,1884-10-5,174
1884,10,6,1146,846,300,1884-10-6,546
1884,10,7,1212,896,316,1884-10-7,580
1884,10,8,1042,919,123,1884-10-8,796
1884,10,9,995,980,15,1884-10-9,965
1884,10,10,896,896,0,1884-10-10,896
1884,10,11,941,941,0,1884-10-11,941
1884,10,12,810,810,0,1884-10-12,810
1884,10,13,707,707,0,1884-10-13,707
1884,10,14,568,568,0,1884-10-14,568
1884,10,15,673,237,436,1884-10-15,-199
1884,10,16,447,0,447,1884-10-16,-447
1884,10,17,222,0,222,1884-10-17,-222
1884,10,18,310,0,310,1884-10-18,-310
1884,10,19,174,0,174,1884-10-19,-174
1884,10,20,185,4,181,1884-10-20,-177
1884,10,21,343,25,318,1884-10-21,-293
1884,10,22,635,0,635,1884-10-22,-635
1884,10,23,917,0,917,1884-10-23,-917
1884,10,24,1340,0,1340,1884-10-24,-1340
1884,10,25,1856,0,1856,1884-10-25,-1856
1884,10,26,1933,72,1861,1884-10-26,-1789
1884,10,27,1568,84,1484,1884-10-27,-1400
1884,10,28,1117,73,1044,1884-10-28,-971
1884,10,29,1151,223,928,1884-10-29,-705
1884,10,30,1047,222,825,1884-10-30,-603
1884,10,31,1130,197,933,1884-10-31,-736
1884,11,1,1077,171,906,1884-11-1,-735
1884,11,2,727,139,588,1884-11-2,-449
1884,11,3,127,127,0,1884-11-3,127
1884,11,4,115,115,0,1884-11-4,115
1884,11,5,80,80,0,1884-11-5,80
1884,11,6,96,96,0,1884-11-6,96
1884,11,7,55,55,0,1884-11-7,55
1884,11,8,0,0,0,1884-11-8,0
1884,11,9,8,0,8,1884-11-9,-8
1884,11,10,344,66,278,1884-11-10,-212
1884,11,11,573,29,544,1884-11-11,-515
1884,11,12,791,70,721,1884-11-12,-651
1884,11,13,710,94,616,1884-11-13,-522
1884,11,14,594,41,553,1884-11-14,-512
1884,11,15,292,68,224,1884-11-15,-156
1884,11,16,362,154,208,1884-11-16,-54
1884,11,17,148,148,0,1884-11-17,148
1884,11,18,147,137,10,1884-11-18,127
1884,11,19,252,199,53,1884-11-19,146
1884,11,20,411,289,122,1884-11-20,167
1884,11,21,376,228,148,1884-11-21,80
1884,11,22,431,160,271,1884-11-22,-111
1884,11,23,521,119,402,1884-11-23,-283
1884,11,24,672,50,622,1884-11-24,-572
1884,11,25,657,20,637,1884-11-25,-617
1884,11,26,718,0,718,1884-11-26,-718
1884,11,27,725,0,725,1884-11-27,-725
1884,11,28,884,142,742,1884-11-28,-600
1884,11,29,503,371,132,1884-11-29,239
1884,11,30,745,607,138,1884-11-30,469
1884,12,1,987,843,144,1884-12-1,699
1884,12,2,919,774,145,1884-12-2,629
1884,12,3,784,733,51,1884-12-3,682
1884,12,4,775,741,34,1884-12-4,707
1884,12,5,896,868,28,1884-12-5,840
1884,12,6,983,958,25,1884-12-6,933
1884,12,7,917,901,16,1884-12-7,885
1884,12,8,989,979,10,1884-12-8,969
1884,12,9,776,501,275,1884-12-9,226
1884,12,10,617,156,461,1884-12-10,-305
1884,12,11,641,160,481,1884-12-11,-321
1884,12,12,443,137,306,1884-12-12,-169
1884,12,13,436,139,297,1884-12-13,-158
1884,12,14,559,130,429,1884-12-14,-299
1884,12,15,349,44,305,1884-12-15,-261
1884,12,16,301,9,292,1884-12-16,-283
1884,12,17,565,8,557,1884-12-17,-549
1884,12,18,515,57,458,1884-12-18,-401
1884,12,19,758,69,689,1884-12-19,-620
1884,12,20,1319,678,641,1884-12-20,37
1884,12,21,1582,956,626,1884-12-21,330
1884,12,22,1693,1172,521,1884-12-22,651
1884,12,23,1373,1038,335,1884-12-23,703
1884,12,24,1170,904,266,1884-12-24,638
1884,12,25,1474,1187,287,1884-12-25,900
1884,12,26,1037,983,54,1884-12-26,929
1884,12,27,1016,977,39,1884-12-27,938
1884,12,28,861,853,8,1884-12-28,845
1884,12,29,770,762,8,1884-12-29,754
1884,12,30,697,661,36,1884-12-30,625
1884,12,31,643,576,67,1884-12-31,509
1885,1,1,562,510,52,1885-1-1,458
1885,1,2,213,108,105,1885-1-2,3
1885,1,3,303,169,134,1885-1-3,35
1885,1,4,306,196,110,1885-1-4,86
1885,1,5,312,163,149,1885-1-5,14
1885,1,6,67,44,23,1885-1-6,21
1885,1,7,39,19,20,1885-1-7,-1
1885,1,8,39,18,21,1885-1-8,-3
1885,1,9,30,18,12,1885-1-9,6
1885,1,10,38,38,0,1885-1-10,38
1885,1,11,0,0,0,1885-1-11,0
1885,1,12,55,0,55,1885-1-12,-55
1885,1,13,87,0,87,1885-1-13,-87
1885,1,14,84,0,84,1885-1-14,-84
1885,1,15,55,0,55,1885-1-15,-55
1885,1,16,103,0,103,1885-1-16,-103
1885,1,17,196,0,196,1885-1-17,-196
1885,1,18,302,0,302,1885-1-18,-302
1885,1,19,-1,-1,-1,1885-1-19,0
1885,1,20,1144,21,1123,1885-1-20,-1102
1885,1,21,1313,62,1251,1885-1-21,-1189
1885,1,22,1226,49,1177,1885-1-22,-1128
1885,1,23,1431,34,1397,1885-1-23,-1363
1885,1,24,1317,87,1230,1885-1-24,-1143
1885,1,25,1026,192,834,1885-1-25,-642
1885,1,26,931,198,733,1885-1-26,-535
1885,1,27,849,247,602,1885-1-27,-355
1885,1,28,1011,248,763,1885-1-28,-515
1885,1,29,877,104,773,1885-1-29,-669
1885,1,30,631,143,488,1885-1-30,-345
1885,1,31,812,264,548,1885-1-31,-284
1885,2,1,973,211,762,1885-2-1,-551
1885,2,2,917,196,721,1885-2-2,-525
1885,2,3,1132,197,935,1885-2-3,-738
1885,2,4,1310,199,1111,1885-2-4,-912
1885,2,5,1143,164,979,1885-2-5,-815
1885,2,6,1099,168,931,1885-2-6,-763
1885,2,7,1021,157,864,1885-2-7,-707
1885,2,8,1843,235,1608,1885-2-8,-1373
1885,2,9,1700,205,1495,1885-2-9,-1290
1885,2,10,1791,325,1466,1885-2-10,-1141
1885,2,11,1948,248,1700,1885-2-11,-1452
1885,2,12,1302,426,876,1885-2-12,-450
1885,2,13,1197,460,737,1885-2-13,-277
1885,2,14,1037,418,619,1885-2-14,-201
1885,2,15,1162,474,688,1885-2-15,-214
1885,2,16,1428,430,998,1885-2-16,-568
1885,2,17,1378,467,911,1885-2-17,-444
1885,2,18,1159,406,753,1885-2-18,-347
1885,2,19,1183,497,686,1885-2-19,-189
1885,2,20,1017,358,659,1885-2-20,-301
1885,2,21,800,357,443,1885-2-21,-86
1885,2,22,1101,444,657,1885-2-22,-213
1885,2,23,530,120,410,1885-2-23,-290
1885,2,24,354,28,326,1885-2-24,-298
1885,2,25,305,21,284,1885-2-25,-263
1885,2,26,378,16,362,1885-2-26,-346
1885,2,27,376,24,352,1885-2-27,-328
1885,2,28,742,94,648,1885-2-28,-554
1885,3,1,871,100,771,1885-3-1,-671
1885,3,2,965,95,870,1885-3-2,-775
1885,3,3,970,44,926,1885-3-3,-882
1885,3,4,1646,30,1616,1885-3-4,-1586
1885,3,5,1913,14,1899,1885-3-5,-1885
1885,3,6,1926,0,1926,1885-3-6,-1926
1885,3,7,1821,0,1821,1885-3-7,-1821
1885,3,8,1944,0,1944,1885-3-8,-1944
1885,3,9,1181,0,1181,1885-3-9,-1181
1885,3,10,1074,277,797,1885-3-10,-520
1885,3,11,1025,599,426,1885-3-11,173
1885,3,12,816,594,222,1885-3-12,372
1885,3,13,748,569,179,1885-3-13,390
1885,3,14,647,451,196,1885-3-14,255
1885,3,15,629,424,205,1885-3-15,219
1885,3,16,561,321,240,1885-3-16,81
1885,3,17,280,274,6,1885-3-17,268
1885,3,18,224,215,9,1885-3-18,206
1885,3,19,185,165,20,1885-3-19,145
1885,3,20,98,70,28,1885-3-20,42
1885,3,21,102,102,0,1885-3-21,102
1885,3,22,91,91,0,1885-3-22,91
1885,3,23,0,0,0,1885-3-23,0
1885,3,24,20,0,20,1885-3-24,-20
1885,3,25,203,0,203,1885-3-25,-203
1885,3,26,477,0,477,1885-3-26,-477
1885,3,27,557,0,557,1885-3-27,-557
1885,3,28,653,4,649,1885-3-28,-645
1885,3,29,587,0,587,1885-3-29,-587
1885,3,30,414,0,414,1885-3-30,-414
1885,3,31,528,0,528,1885-3-31,-528
1885,4,1,555,0,555,1885-4-1,-555
1885,4,2,617,0,617,1885-4-2,-617
1885,4,3,550,0,550,1885-4-3,-550
1885,4,4,1075,483,592,1885-4-4,-109
1885,4,5,1212,534,678,1885-4-5,-144
1885,4,6,1394,749,645,1885-4-6,104
1885,4,7,960,898,62,1885-4-7,836
1885,4,8,1275,1208,67,1885-4-8,1141
1885,4,9,1497,1464,33,1885-4-9,1431
1885,4,10,1762,1672,90,1885-4-10,1582
1885,4,11,1423,1390,33,1885-4-11,1357
1885,4,12,1418,1401,17,1885-4-12,1384
1885,4,13,1354,1340,14,1885-4-13,1326
1885,4,14,852,852,0,1885-4-14,852
1885,4,15,506,506,0,1885-4-15,506
1885,4,16,522,343,179,1885-4-16,164
1885,4,17,515,270,245,1885-4-17,25
1885,4,18,431,185,246,1885-4-18,-61
1885,4,19,337,6,331,1885-4-19,-325
1885,4,20,328,0,328,1885-4-20,-328
1885,4,21,441,0,441,1885-4-21,-441
1885,4,22,605,0,605,1885-4-22,-605
1885,4,23,584,0,584,1885-4-23,-584
1885,4,24,491,0,491,1885-4-24,-491
1885,4,25,481,0,481,1885-4-25,-481
1885,4,26,475,52,423,1885-4-26,-371
1885,4,27,763,76,687,1885-4-27,-611
1885,4,28,940,128,812,1885-4-28,-684
1885,4,29,963,138,825,1885-4-29,-687
1885,4,30,1335,504,831,1885-4-30,-327
1885,5,1,1497,877,620,1885-5-1,257
1885,5,2,1326,800,526,1885-5-2,274
1885,5,3,1153,750,403,1885-5-3,347
1885,5,4,1136,795,341,1885-5-4,454
1885,5,5,1193,870,323,1885-5-5,547
1885,5,6,1485,949,536,1885-5-6,413
1885,5,7,1470,753,717,1885-5-7,36
1885,5,8,1642,779,863,1885-5-8,-84
1885,5,9,1388,629,759,1885-5-9,-130
1885,5,10,663,478,185,1885-5-10,293
1885,5,11,546,404,142,1885-5-11,262
1885,5,12,382,283,99,1885-5-12,184
1885,5,13,-1,-1,-1,1885-5-13,0
1885,5,14,173,110,63,1885-5-14,47
1885,5,15,134,69,65,1885-5-15,4
1885,5,16,230,164,66,1885-5-16,98
1885,5,17,151,113,38,1885-5-17,75
1885,5,18,780,530,250,1885-5-18,280
1885,5,19,870,633,237,1885-5-19,396
1885,5,20,1798,1246,552,1885-5-20,694
1885,5,21,1668,1184,484,1885-5-21,700
1885,5,22,1692,1225,467,1885-5-22,758
1885,5,23,1540,1018,522,1885-5-23,496
1885,5,24,1617,1014,603,1885-5-24,411
1885,5,25,-1,-1,-1,1885-5-25,0
1885,5,26,1626,912,714,1885-5-26,198
1885,5,27,1380,780,600,1885-5-27,180
1885,5,28,904,565,339,1885-5-28,226
1885,5,29,915,610,305,1885-5-29,305
1885,5,30,789,449,340,1885-5-30,109
1885,5,31,564,144,420,1885-5-31,-276
1885,6,1,1080,127,953,1885-6-1,-826
1885,6,2,1358,139,1219,1885-6-2,-1080
1885,6,3,1415,123,1292,1885-6-3,-1169
1885,6,4,1427,64,1363,1885-6-4,-1299
1885,6,5,1244,57,1187,1885-6-5,-1130
1885,6,6,1297,52,1245,1885-6-6,-1193
1885,6,7,1505,16,1489,1885-6-7,-1473
1885,6,8,1955,16,1939,1885-6-8,-1923
1885,6,9,1727,18,1709,1885-6-9,-1691
1885,6,10,1508,0,1508,1885-6-10,-1508
1885,6,11,1418,2,1416,1885-6-11,-1414
1885,6,12,1824,104,1720,1885-6-12,-1616
1885,6,13,1671,91,1580,1885-6-13,-1489
1885,6,14,1107,237,870,1885-6-14,-633
1885,6,15,1731,635,1096,1885-6-15,-461
1885,6,16,2418,1436,982,1885-6-16,454
1885,6,17,2556,1578,978,1885-6-17,600
1885,6,18,2451,1603,848,1885-6-18,755
1885,6,19,1885,1588,297,1885-6-19,1291
1885,6,20,2089,1781,308,1885-6-20,1473
1885,6,21,2328,2023,305,1885-6-21,1718
1885,6,22,2086,1916,170,1885-6-22,1746
1885,6,23,2197,1781,416,1885-6-23,1365
1885,6,24,1990,1480,510,1885-6-24,970
1885,6,25,1604,1245,359,1885-6-25,886
1885,6,26,-1,-1,-1,1885-6-26,0
1885,6,27,1166,430,736,1885-6-27,-306
1885,6,28,926,0,926,1885-6-28,-926
1885,6,29,1591,0,1591,1885-6-29,-1591
1885,6,30,1817,0,1817,1885-6-30,-1817
1885,7,1,1950,0,1950,1885-7-1,-1950
1885,7,2,1648,0,1648,1885-7-2,-1648
1885,7,3,1049,0,1049,1885-7-3,-1049
1885,7,4,972,0,972,1885-7-4,-972
1885,7,5,929,0,929,1885-7-5,-929
1885,7,6,1217,0,1217,1885-7-6,-1217
1885,7,7,1671,0,1671,1885-7-7,-1671
1885,7,8,1679,0,1679,1885-7-8,-1679
1885,7,9,1774,0,1774,1885-7-9,-1774
1885,7,10,1841,0,1841,1885-7-10,-1841
1885,7,11,1905,0,1905,1885-7-11,-1905
1885,7,12,1219,848,371,1885-7-12,477
1885,7,13,1085,689,396,1885-7-13,293
1885,7,14,1085,727,358,1885-7-14,369
1885,7,15,1070,639,431,1885-7-15,208
1885,7,16,1053,488,565,1885-7-16,-77
1885,7,17,1464,387,1077,1885-7-17,-690
1885,7,18,1554,449,1105,1885-7-18,-656
1885,7,19,1197,336,861,1885-7-19,-525
1885,7,20,1185,295,890,1885-7-20,-595
1885,7,21,940,224,716,1885-7-21,-492
1885,7,22,884,193,691,1885-7-22,-498
1885,7,23,940,154,786,1885-7-23,-632
1885,7,24,1041,245,796,1885-7-24,-551
1885,7,25,654,0,654,1885-7-25,-654
1885,7,26,624,0,624,1885-7-26,-624
1885,7,27,775,0,775,1885-7-27,-775
1885,7,28,885,0,885,1885-7-28,-885
1885,7,29,799,0,799,1885-7-29,-799
1885,7,30,364,0,364,1885-7-30,-364
1885,7,31,365,0,365,1885-7-31,-365
1885,8,1,375,0,375,1885-8-1,-375
1885,8,2,356,0,356,1885-8-2,-356
1885,8,3,313,21,292,1885-8-3,-271
1885,8,4,228,76,152,1885-8-4,-76
1885,8,5,483,93,390,1885-8-5,-297
1885,8,6,443,94,349,1885-8-6,-255
1885,8,7,697,106,591,1885-8-7,-485
1885,8,8,878,232,646,1885-8-8,-414
1885,8,9,790,197,593,1885-8-9,-396
1885,8,10,890,173,717,1885-8-10,-544
1885,8,11,983,318,665,1885-8-11,-347
1885,8,12,766,216,550,1885-8-12,-334
1885,8,13,751,261,490,1885-8-13,-229
1885,8,14,802,193,609,1885-8-14,-416
1885,8,15,693,174,519,1885-8-15,-345
1885,8,16,783,214,569,1885-8-16,-355
1885,8,17,541,162,379,1885-8-17,-217
1885,8,18,427,171,256,1885-8-18,-85
1885,8,19,356,103,253,1885-8-19,-150
1885,8,20,357,33,324,1885-8-20,-291
1885,8,21,203,14,189,1885-8-21,-175
1885,8,22,246,2,244,1885-8-22,-242
1885,8,23,545,60,485,1885-8-23,-425
1885,8,24,576,0,576,1885-8-24,-576
1885,8,25,454,0,454,1885-8-25,-454
1885,8,26,310,0,310,1885-8-26,-310
1885,8,27,578,37,541,1885-8-27,-504
1885,8,28,957,361,596,1885-8-28,-235
1885,8,29,1080,374,706,1885-8-29,-332
1885,8,30,-1,-1,-1,1885-8-30,0
1885,8,31,1080,491,589,1885-8-31,-98
1885,9,1,1242,552,690,1885-9-1,-138
1885,9,2,1895,592,1303,1885-9-2,-711
1885,9,3,1331,399,932,1885-9-3,-533
1885,9,4,812,368,444,1885-9-4,-76
1885,9,5,836,252,584,1885-9-5,-332
1885,9,6,694,194,500,1885-9-6,-306
1885,9,7,409,229,180,1885-9-7,49
1885,9,8,772,199,573,1885-9-8,-374
1885,9,9,760,130,630,1885-9-9,-500
1885,9,10,779,0,779,1885-9-10,-779
1885,9,11,656,0,656,1885-9-11,-656
1885,9,12,725,0,725,1885-9-12,-725
1885,9,13,767,0,767,1885-9-13,-767
1885,9,14,806,0,806,1885-9-14,-806
1885,9,15,464,0,464,1885-9-15,-464
1885,9,16,529,0,529,1885-9-16,-529
1885,9,17,536,0,536,1885-9-17,-536
1885,9,18,490,0,490,1885-9-18,-490
1885,9,19,579,16,563,1885-9-19,-547
1885,9,20,3,3,0,1885-9-20,3
1885,9,21,416,214,202,1885-9-21,12
1885,9,22,426,258,168,1885-9-22,90
1885,9,23,220,106,114,1885-9-23,-8
1885,9,24,158,101,57,1885-9-24,44
1885,9,25,499,346,153,1885-9-25,193
1885,9,26,526,381,145,1885-9-26,236
1885,9,27,583,428,155,1885-9-27,273
1885,9,28,498,372,126,1885-9-28,246
1885,9,29,554,396,158,1885-9-29,238
1885,9,30,416,288,128,1885-9-30,160
1885,10,1,875,272,603,1885-10-1,-331
1885,10,2,1117,280,837,1885-10-2,-557
1885,10,3,970,189,781,1885-10-3,-592
1885,10,4,717,32,685,1885-10-4,-653
1885,10,5,945,17,928,1885-10-5,-911
1885,10,6,867,0,867,1885-10-6,-867
1885,10,7,859,0,859,1885-10-7,-859
1885,10,8,824,0,824,1885-10-8,-824
1885,10,9,647,0,647,1885-10-9,-647
1885,10,10,685,0,685,1885-10-10,-685
1885,10,11,704,0,704,1885-10-11,-704
1885,10,12,685,0,685,1885-10-12,-685
1885,10,13,176,0,176,1885-10-13,-176
1885,10,14,19,0,19,1885-10-14,-19
1885,10,15,0,0,0,1885-10-15,0
1885,10,16,0,0,0,1885-10-16,0
1885,10,17,367,367,0,1885-10-17,367
1885,10,18,678,673,5,1885-10-18,668
1885,10,19,642,538,104,1885-10-19,434
1885,10,20,519,443,76,1885-10-20,367
1885,10,21,656,388,268,1885-10-21,120
1885,10,22,678,380,298,1885-10-22,82
1885,10,23,773,399,374,1885-10-23,25
1885,10,24,720,311,409,1885-10-24,-98
1885,10,25,1040,219,821,1885-10-25,-602
1885,10,26,1389,272,1117,1885-10-26,-845
1885,10,27,1144,206,938,1885-10-27,-732
1885,10,28,984,164,820,1885-10-28,-656
1885,10,29,837,0,837,1885-10-29,-837
1885,10,30,891,0,891,1885-10-30,-891
1885,10,31,867,0,867,1885-10-31,-867
1885,11,1,542,0,542,1885-11-1,-542
1885,11,2,301,0,301,1885-11-2,-301
1885,11,3,314,0,314,1885-11-3,-314
1885,11,4,264,0,264,1885-11-4,-264
1885,11,5,190,0,190,1885-11-5,-190
1885,11,6,267,0,267,1885-11-6,-267
1885,11,7,281,0,281,1885-11-7,-281
1885,11,8,241,50,191,1885-11-8,-141
1885,11,9,332,42,290,1885-11-9,-248
1885,11,10,563,181,382,1885-11-10,-201
1885,11,11,606,170,436,1885-11-11,-266
1885,11,12,485,168,317,1885-11-12,-149
1885,11,13,949,798,151,1885-11-13,647
1885,11,14,865,813,52,1885-11-14,761
1885,11,15,852,780,72,1885-11-15,708
1885,11,16,897,803,94,1885-11-16,709
1885,11,17,874,796,78,1885-11-17,718
1885,11,18,886,748,138,1885-11-18,610
1885,11,19,823,722,101,1885-11-19,621
1885,11,20,639,586,53,1885-11-20,533
1885,11,21,454,388,66,1885-11-21,322
1885,11,22,398,334,64,1885-11-22,270
1885,11,23,352,314,38,1885-11-23,276
1885,11,24,315,310,5,1885-11-24,305
1885,11,25,0,0,0,1885-11-25,0
1885,11,26,19,0,19,1885-11-26,-19
1885,11,27,0,0,0,1885-11-27,0
1885,11,28,30,0,30,1885-11-28,-30
1885,11,29,17,0,17,1885-11-29,-17
1885,11,30,0,0,0,1885-11-30,0
1885,12,1,0,0,0,1885-12-1,0
1885,12,2,54,54,0,1885-12-2,54
1885,12,3,125,125,0,1885-12-3,125
1885,12,4,95,95,0,1885-12-4,95
1885,12,5,232,232,0,1885-12-5,232
1885,12,6,0,0,0,1885-12-6,0
1885,12,7,0,0,0,1885-12-7,0
1885,12,8,0,0,0,1885-12-8,0
1885,12,9,22,0,22,1885-12-9,-22
1885,12,10,117,117,0,1885-12-10,117
1885,12,11,177,177,0,1885-12-11,177
1885,12,12,221,205,16,1885-12-12,189
1885,12,13,251,213,38,1885-12-13,175
1885,12,14,192,172,20,1885-12-14,152
1885,12,15,148,148,0,1885-12-15,148
1885,12,16,144,144,0,1885-12-16,144
1885,12,17,143,143,0,1885-12-17,143
1885,12,18,114,105,9,1885-12-18,96
1885,12,19,181,110,71,1885-12-19,39
1885,12,20,402,291,111,1885-12-20,180
1885,12,21,415,319,96,1885-12-21,223
1885,12,22,335,235,100,1885-12-22,135
1885,12,23,392,189,203,1885-12-23,-14
1885,12,24,425,194,231,1885-12-24,-37
1885,12,25,524,235,289,1885-12-25,-54
1885,12,26,379,210,169,1885-12-26,41
1885,12,27,424,337,87,1885-12-27,250
1885,12,28,366,302,64,1885-12-28,238
1885,12,29,264,238,26,1885-12-29,212
1885,12,30,301,285,16,1885-12-30,269
1885,12,31,392,392,0,1885-12-31,392
1886,1,1,266,266,0,1886-1-1,266
1886,1,2,537,134,403,1886-1-2,-269
1886,1,3,-1,-1,-1,1886-1-3,0
1886,1,4,671,32,639,1886-1-4,-607
1886,1,5,582,17,565,1886-1-5,-548
1886,1,6,501,10,491,1886-1-6,-481
1886,1,7,600,14,586,1886-1-7,-572
1886,1,8,938,10,928,1886-1-8,-918
1886,1,9,908,3,905,1886-1-9,-902
1886,1,10,909,4,905,1886-1-10,-901
1886,1,11,970,0,970,1886-1-11,-970
1886,1,12,993,0,993,1886-1-12,-993
1886,1,13,1305,90,1215,1886-1-13,-1125
1886,1,14,1227,224,1003,1886-1-14,-779
1886,1,15,1233,189,1044,1886-1-15,-855
1886,1,16,1160,195,965,1886-1-16,-770
1886,1,17,1181,111,1070,1886-1-17,-959
1886,1,18,-1,-1,-1,1886-1-18,0
1886,1,19,674,24,650,1886-1-19,-626
1886,1,20,552,22,530,1886-1-20,-508
1886,1,21,203,42,161,1886-1-21,-119
1886,1,22,7,7,0,1886-1-22,7
1886,1,23,11,0,11,1886-1-23,-11
1886,1,24,0,0,0,1886-1-24,0
1886,1,25,0,0,0,1886-1-25,0
1886,1,26,0,0,0,1886-1-26,0
1886,1,27,0,0,0,1886-1-27,0
1886,1,28,0,0,0,1886-1-28,0
1886,1,29,0,0,0,1886-1-29,0
1886,1,30,196,0,196,1886-1-30,-196
1886,1,31,167,0,167,1886-1-31,-167
1886,2,1,182,0,182,1886-2-1,-182
1886,2,2,246,0,246,1886-2-2,-246
1886,2,3,219,0,219,1886-2-3,-219
1886,2,4,667,0,667,1886-2-4,-667
1886,2,5,685,0,685,1886-2-5,-685
1886,2,6,558,0,558,1886-2-6,-558
1886,2,7,641,41,600,1886-2-7,-559
1886,2,8,618,77,541,1886-2-8,-464
1886,2,9,637,29,608,1886-2-9,-579
1886,2,10,550,41,509,1886-2-10,-468
1886,2,11,536,10,526,1886-2-11,-516
1886,2,12,508,25,483,1886-2-12,-458
1886,2,13,544,103,441,1886-2-13,-338
1886,2,14,408,75,333,1886-2-14,-258
1886,2,15,366,55,311,1886-2-15,-256
1886,2,16,349,90,259,1886-2-16,-169
1886,2,17,171,126,45,1886-2-17,81
1886,2,18,47,0,47,1886-2-18,-47
1886,2,19,32,0,32,1886-2-19,-32
1886,2,20,130,0,130,1886-2-20,-130
1886,2,21,61,0,61,1886-2-21,-61
1886,2,22,55,0,55,1886-2-22,-55
1886,2,23,17,0,17,1886-2-23,-17
1886,2,24,0,0,0,1886-2-24,0
1886,2,25,38,0,38,1886-2-25,-38
1886,2,26,65,8,57,1886-2-26,-49
1886,2,27,25,0,25,1886-2-27,-25
1886,2,28,407,0,407,1886-2-28,-407
1886,3,1,1054,0,1054,1886-3-1,-1054
1886,3,2,1101,38,1063,1886-3-2,-1025
1886,3,3,1337,113,1224,1886-3-3,-1111
1886,3,4,1501,329,1172,1886-3-4,-843
1886,3,5,1982,427,1555,1886-3-5,-1128
1886,3,6,2222,740,1482,1886-3-6,-742
1886,3,7,2081,735,1346,1886-3-7,-611
1886,3,8,2425,1034,1391,1886-3-8,-357
1886,3,9,1386,116,1270,1886-3-9,-1154
1886,3,10,1247,118,1129,1886-3-10,-1011
1886,3,11,1323,91,1232,1886-3-11,-1141
1886,3,12,1053,93,960,1886-3-12,-867
1886,3,13,946,43,903,1886-3-13,-860
1886,3,14,880,44,836,1886-3-14,-792
1886,3,15,814,0,814,1886-3-15,-814
1886,3,16,620,0,620,1886-3-16,-620
1886,3,17,68,0,68,1886-3-17,-68
1886,3,18,419,268,151,1886-3-18,117
1886,3,19,380,275,105,1886-3-19,170
1886,3,20,574,380,194,1886-3-20,186
1886,3,21,402,386,16,1886-3-21,370
1886,3,22,454,452,2,1886-3-22,450
1886,3,23,632,632,0,1886-3-23,632
1886,3,24,872,872,0,1886-3-24,872
1886,3,25,765,765,0,1886-3-25,765
1886,3,26,798,776,22,1886-3-26,754
1886,3,27,777,682,95,1886-3-27,587
1886,3,28,872,569,303,1886-3-28,266
1886,3,29,946,420,526,1886-3-29,-106
1886,3,30,1028,445,583,1886-3-30,-138
1886,3,31,1039,264,775,1886-3-31,-511
1886,4,1,1202,225,977,1886-4-1,-752
1886,4,2,1407,215,1192,1886-4-2,-977
1886,4,3,1569,265,1304,1886-4-3,-1039
1886,4,4,1663,384,1279,1886-4-4,-895
1886,4,5,951,20,931,1886-4-5,-911
1886,4,6,526,18,508,1886-4-6,-490
1886,4,7,587,17,570,1886-4-7,-553
1886,4,8,414,11,403,1886-4-8,-392
1886,4,9,368,0,368,1886-4-9,-368
1886,4,10,298,0,298,1886-4-10,-298
1886,4,11,279,0,279,1886-4-11,-279
1886,4,12,176,0,176,1886-4-12,-176
1886,4,13,0,0,0,1886-4-13,0
1886,4,14,0,0,0,1886-4-14,0
1886,4,15,149,141,8,1886-4-15,133
1886,4,16,155,151,4,1886-4-16,147
1886,4,17,149,149,0,1886-4-17,149
1886,4,18,136,136,0,1886-4-18,136
1886,4,19,329,164,165,1886-4-19,-1
1886,4,20,911,201,710,1886-4-20,-509
1886,4,21,863,246,617,1886-4-21,-371
1886,4,22,786,155,631,1886-4-22,-476
1886,4,23,719,109,610,1886-4-23,-501
1886,4,24,567,80,487,1886-4-24,-407
1886,4,25,545,34,511,1886-4-25,-477
1886,4,26,536,62,474,1886-4-26,-412
1886,4,27,568,0,568,1886-4-27,-568
1886,4,28,776,0,776,1886-4-28,-776
1886,4,29,999,0,999,1886-4-29,-999
1886,4,30,1080,13,1067,1886-4-30,-1054
1886,5,1,775,0,775,1886-5-1,-775
1886,5,2,2199,809,1390,1886-5-2,-581
1886,5,3,2389,942,1447,1886-5-3,-505
1886,5,4,2003,944,1059,1886-5-4,-115
1886,5,5,2210,1048,1162,1886-5-5,-114
1886,5,6,2158,1125,1033,1886-5-6,92
1886,5,7,1205,1054,151,1886-5-7,903
1886,5,8,1087,925,162,1886-5-8,763
1886,5,9,909,778,131,1886-5-9,647
1886,5,10,651,651,0,1886-5-10,651
1886,5,11,495,495,0,1886-5-11,495
1886,5,12,276,258,18,1886-5-12,240
1886,5,13,236,131,105,1886-5-13,26
1886,5,14,80,0,80,1886-5-14,-80
1886,5,15,0,0,0,1886-5-15,0
1886,5,16,0,0,0,1886-5-16,0
1886,5,17,0,0,0,1886-5-17,0
1886,5,18,0,0,0,1886-5-18,0
1886,5,19,0,0,0,1886-5-19,0
1886,5,20,15,0,15,1886-5-20,-15
1886,5,21,287,0,287,1886-5-21,-287
1886,5,22,293,7,286,1886-5-22,-279
1886,5,23,437,57,380,1886-5-23,-323
1886,5,24,571,138,433,1886-5-24,-295
1886,5,25,387,0,387,1886-5-25,-387
1886,5,26,364,0,364,1886-5-26,-364
1886,5,27,405,0,405,1886-5-27,-405
1886,5,28,357,0,357,1886-5-28,-357
1886,5,29,370,18,352,1886-5-29,-334
1886,5,30,495,76,419,1886-5-30,-343
1886,5,31,687,20,667,1886-5-31,-647
1886,6,1,538,15,523,1886-6-1,-508
1886,6,2,285,50,235,1886-6-2,-185
1886,6,3,126,91,35,1886-6-3,56
1886,6,4,397,67,330,1886-6-4,-263
1886,6,5,674,65,609,1886-6-5,-544
1886,6,6,813,139,674,1886-6-6,-535
1886,6,7,871,79,792,1886-6-7,-713
1886,6,8,859,93,766,1886-6-8,-673
1886,6,9,646,16,630,1886-6-9,-614
1886,6,10,541,7,534,1886-6-10,-527
1886,6,11,475,0,475,1886-6-11,-475
1886,6,12,377,0,377,1886-6-12,-377
1886,6,13,0,0,0,1886-6-13,0
1886,6,14,0,0,0,1886-6-14,0
1886,6,15,0,0,0,1886-6-15,0
1886,6,16,113,0,113,1886-6-16,-113
1886,6,17,378,0,378,1886-6-17,-378
1886,6,18,355,0,355,1886-6-18,-355
1886,6,19,358,0,358,1886-6-19,-358
1886,6,20,340,0,340,1886-6-20,-340
1886,6,21,259,0,259,1886-6-21,-259
1886,6,22,313,78,235,1886-6-22,-157
1886,6,23,366,138,228,1886-6-23,-90
1886,6,24,261,111,150,1886-6-24,-39
1886,6,25,156,0,156,1886-6-25,-156
1886,6,26,109,0,109,1886-6-26,-109
1886,6,27,384,61,323,1886-6-27,-262
1886,6,28,530,145,385,1886-6-28,-240
1886,6,29,638,77,561,1886-6-29,-484
1886,6,30,780,69,711,1886-6-30,-642
1886,7,1,742,52,690,1886-7-1,-638
1886,7,2,615,52,563,1886-7-2,-511
1886,7,3,545,21,524,1886-7-3,-503
1886,7,4,486,13,473,1886-7-4,-460
1886,7,5,410,0,410,1886-7-5,-410
1886,7,6,427,0,427,1886-7-6,-427
1886,7,7,478,0,478,1886-7-7,-478
1886,7,8,381,0,381,1886-7-8,-381
1886,7,9,294,0,294,1886-7-9,-294
1886,7,10,0,0,0,1886-7-10,0
1886,7,11,0,0,0,1886-7-11,0
1886,7,12,0,0,0,1886-7-12,0
1886,7,13,8,0,8,1886-7-13,-8
1886,7,14,64,0,64,1886-7-14,-64
1886,7,15,42,0,42,1886-7-15,-42
1886,7,16,134,0,134,1886-7-16,-134
1886,7,17,210,0,210,1886-7-17,-210
1886,7,18,443,0,443,1886-7-18,-443
1886,7,19,386,0,386,1886-7-19,-386
1886,7,20,474,0,474,1886-7-20,-474
1886,7,21,594,0,594,1886-7-21,-594
1886,7,22,662,0,662,1886-7-22,-662
1886,7,23,525,0,525,1886-7-23,-525
1886,7,24,608,39,569,1886-7-24,-530
1886,7,25,580,12,568,1886-7-25,-556
1886,7,26,583,73,510,1886-7-26,-437
1886,7,27,542,234,308,1886-7-27,-74
1886,7,28,560,236,324,1886-7-28,-88
1886,7,29,547,268,279,1886-7-29,-11
1886,7,30,499,258,241,1886-7-30,17
1886,7,31,418,196,222,1886-7-31,-26
1886,8,1,302,189,113,1886-8-1,76
1886,8,2,365,221,144,1886-8-2,77
1886,8,3,210,105,105,1886-8-3,0
1886,8,4,258,74,184,1886-8-4,-110
1886,8,5,251,66,185,1886-8-5,-119
1886,8,6,146,0,146,1886-8-6,-146
1886,8,7,168,0,168,1886-8-7,-168
1886,8,8,96,0,96,1886-8-8,-96
1886,8,9,74,0,74,1886-8-9,-74
1886,8,10,81,0,81,1886-8-10,-81
1886,8,11,200,0,200,1886-8-11,-200
1886,8,12,236,0,236,1886-8-12,-236
1886,8,13,121,0,121,1886-8-13,-121
1886,8,14,111,0,111,1886-8-14,-111
1886,8,15,83,0,83,1886-8-15,-83
1886,8,16,89,10,79,1886-8-16,-69
1886,8,17,69,0,69,1886-8-17,-69
1886,8,18,55,0,55,1886-8-18,-55
1886,8,19,38,0,38,1886-8-19,-38
1886,8,20,23,0,23,1886-8-20,-23
1886,8,21,0,0,0,1886-8-21,0
1886,8,22,0,0,0,1886-8-22,0
1886,8,23,6,0,6,1886-8-23,-6
1886,8,24,6,0,6,1886-8-24,-6
1886,8,25,4,0,4,1886-8-25,-4
1886,8,26,165,0,165,1886-8-26,-165
1886,8,27,113,0,113,1886-8-27,-113
1886,8,28,52,0,52,1886-8-28,-52
1886,8,29,12,0,12,1886-8-29,-12
1886,8,30,93,93,0,1886-8-30,93
1886,8,31,150,150,0,1886-8-31,150
1886,9,1,304,304,0,1886-9-1,304
1886,9,2,245,245,0,1886-9-2,245
1886,9,3,253,234,19,1886-9-3,215
1886,9,4,252,239,13,1886-9-4,226
1886,9,5,194,194,0,1886-9-5,194
1886,9,6,192,192,0,1886-9-6,192
1886,9,7,246,229,17,1886-9-7,212
1886,9,8,222,188,34,1886-9-8,154
1886,9,9,183,175,8,1886-9-9,167
1886,9,10,435,400,35,1886-9-10,365
1886,9,11,282,239,43,1886-9-11,196
1886,9,12,297,228,69,1886-9-12,159
1886,9,13,358,184,174,1886-9-13,10
1886,9,14,330,172,158,1886-9-14,14
1886,9,15,345,231,114,1886-9-15,117
1886,9,16,222,168,54,1886-9-16,114
1886,9,17,332,142,190,1886-9-17,-48
1886,9,18,268,146,122,1886-9-18,24
1886,9,19,312,176,136,1886-9-19,40
1886,9,20,284,192,92,1886-9-20,100
1886,9,21,90,90,0,1886-9-21,90
1886,9,22,32,32,0,1886-9-22,32
1886,9,23,18,18,0,1886-9-23,18
1886,9,24,0,0,0,1886-9-24,0
1886,9,25,5,5,0,1886-9-25,5
1886,9,26,36,23,13,1886-9-26,10
1886,9,27,7,7,0,1886-9-27,7
1886,9,28,0,0,0,1886-9-28,0
1886,9,29,0,0,0,1886-9-29,0
1886,9,30,64,0,64,1886-9-30,-64
1886,10,1,37,0,37,1886-10-1,-37
1886,10,2,45,0,45,1886-10-2,-45
1886,10,3,91,0,91,1886-10-3,-91
1886,10,4,88,0,88,1886-10-4,-88
1886,10,5,97,0,97,1886-10-5,-97
1886,10,6,108,0,108,1886-10-6,-108
1886,10,7,124,0,124,1886-10-7,-124
1886,10,8,106,0,106,1886-10-8,-106
1886,10,9,74,0,74,1886-10-9,-74
1886,10,10,69,0,69,1886-10-10,-69
1886,10,11,27,0,27,1886-10-11,-27
1886,10,12,5,0,5,1886-10-12,-5
1886,10,13,0,0,0,1886-10-13,0
1886,10,14,0,0,0,1886-10-14,0
1886,10,15,42,0,42,1886-10-15,-42
1886,10,16,159,0,159,1886-10-16,-159
1886,10,17,154,0,154,1886-10-17,-154
1886,10,18,51,0,51,1886-10-18,-51
1886,10,19,15,0,15,1886-10-19,-15
1886,10,20,11,0,11,1886-10-20,-11
1886,10,21,0,0,0,1886-10-21,0
1886,10,22,19,0,19,1886-10-22,-19
1886,10,23,62,62,0,1886-10-23,62
1886,10,24,88,88,0,1886-10-24,88
1886,10,25,94,94,0,1886-10-25,94
1886,10,26,47,47,0,1886-10-26,47
1886,10,27,42,42,0,1886-10-27,42
1886,10,28,37,37,0,1886-10-28,37
1886,10,29,42,31,11,1886-10-29,20
1886,10,30,47,0,47,1886-10-30,-47
1886,10,31,0,0,0,1886-10-31,0
1886,11,1,0,0,0,1886-11-1,0
1886,11,2,0,0,0,1886-11-2,0
1886,11,3,0,0,0,1886-11-3,0
1886,11,4,0,0,0,1886-11-4,0
1886,11,5,0,0,0,1886-11-5,0
1886,11,6,0,0,0,1886-11-6,0
1886,11,7,0,0,0,1886-11-7,0
1886,11,8,0,0,0,1886-11-8,0
1886,11,9,0,0,0,1886-11-9,0
1886,11,10,0,0,0,1886-11-10,0
1886,11,11,0,0,0,1886-11-11,0
1886,11,12,7,0,7,1886-11-12,-7
1886,11,13,9,0,9,1886-11-13,-9
1886,11,14,8,0,8,1886-11-14,-8
1886,11,15,1,0,1,1886-11-15,-1
1886,11,16,5,0,5,1886-11-16,-5
1886,11,17,12,0,12,1886-11-17,-12
1886,11,18,0,0,0,1886-11-18,0
1886,11,19,0,0,0,1886-11-19,0
1886,11,20,0,0,0,1886-11-20,0
1886,11,21,0,0,0,1886-11-21,0
1886,11,22,0,0,0,1886-11-22,0
1886,11,23,0,0,0,1886-11-23,0
1886,11,24,0,0,0,1886-11-24,0
1886,11,25,0,0,0,1886-11-25,0
1886,11,26,6,0,6,1886-11-26,-6
1886,11,27,0,0,0,1886-11-27,0
1886,11,28,0,0,0,1886-11-28,0
1886,11,29,0,0,0,1886-11-29,0
1886,11,30,0,0,0,1886-11-30,0
1886,12,1,0,0,0,1886-12-1,0
1886,12,2,0,0,0,1886-12-2,0
1886,12,3,0,0,0,1886-12-3,0
1886,12,4,0,0,0,1886-12-4,0
1886,12,5,0,0,0,1886-12-5,0
1886,12,6,0,0,0,1886-12-6,0
1886,12,7,0,0,0,1886-12-7,0
1886,12,8,0,0,0,1886-12-8,0
1886,12,9,0,0,0,1886-12-9,0
1886,12,10,30,30,0,1886-12-10,30
1886,12,11,86,86,0,1886-12-11,86
1886,12,12,104,104,0,1886-12-12,104
1886,12,13,85,85,0,1886-12-13,85
1886,12,14,89,89,0,1886-12-14,89
1886,12,15,199,199,0,1886-12-15,199
1886,12,16,227,227,0,1886-12-16,227
1886,12,17,253,253,0,1886-12-17,253
1886,12,18,231,231,0,1886-12-18,231
1886,12,19,172,172,0,1886-12-19,172
1886,12,20,193,193,0,1886-12-20,193
1886,12,21,87,87,0,1886-12-21,87
1886,12,22,7,0,7,1886-12-22,-7
1886,12,23,452,0,452,1886-12-23,-452
1886,12,24,547,11,536,1886-12-24,-525
1886,12,25,538,14,524,1886-12-25,-510
1886,12,26,572,29,543,1886-12-26,-514
1886,12,27,577,0,577,1886-12-27,-577
1886,12,28,479,0,479,1886-12-28,-479
1886,12,29,400,0,400,1886-12-29,-400
1886,12,30,340,0,340,1886-12-30,-340
1886,12,31,213,0,213,1886-12-31,-213
1887,1,1,-1,-1,-1,1887-1-1,0
1887,1,2,174,0,174,1887-1-2,-174
1887,1,3,115,0,115,1887-1-3,-115
1887,1,4,49,0,49,1887-1-4,-49
1887,1,5,30,0,30,1887-1-5,-30
1887,1,6,38,0,38,1887-1-6,-38
1887,1,7,17,0,17,1887-1-7,-17
1887,1,8,16,0,16,1887-1-8,-16
1887,1,9,0,0,0,1887-1-9,0
1887,1,10,0,0,0,1887-1-10,0
1887,1,11,0,0,0,1887-1-11,0
1887,1,12,0,0,0,1887-1-12,0
1887,1,13,0,0,0,1887-1-13,0
1887,1,14,0,0,0,1887-1-14,0
1887,1,15,0,0,0,1887-1-15,0
1887,1,16,0,0,0,1887-1-16,0
1887,1,17,0,0,0,1887-1-17,0
1887,1,18,0,0,0,1887-1-18,0
1887,1,19,6,0,6,1887-1-19,-6
1887,1,20,34,0,34,1887-1-20,-34
1887,1,21,34,0,34,1887-1-21,-34
1887,1,22,34,0,34,1887-1-22,-34
1887,1,23,18,0,18,1887-1-23,-18
1887,1,24,169,0,169,1887-1-24,-169
1887,1,25,350,0,350,1887-1-25,-350
1887,1,26,218,0,218,1887-1-26,-218
1887,1,27,232,0,232,1887-1-27,-232
1887,1,28,151,0,151,1887-1-28,-151
1887,1,29,186,0,186,1887-1-29,-186
1887,1,30,229,0,229,1887-1-30,-229
1887,1,31,292,0,292,1887-1-31,-292
1887,2,1,192,0,192,1887-2-1,-192
1887,2,2,152,0,152,1887-2-2,-152
1887,2,3,159,41,118,1887-2-3,-77
1887,2,4,151,55,96,1887-2-4,-41
1887,2,5,23,23,0,1887-2-5,23
1887,2,6,19,19,0,1887-2-6,19
1887,2,7,0,0,0,1887-2-7,0
1887,2,8,0,0,0,1887-2-8,0
1887,2,9,0,0,0,1887-2-9,0
1887,2,10,0,0,0,1887-2-10,0
1887,2,11,0,0,0,1887-2-11,0
1887,2,12,0,0,0,1887-2-12,0
1887,2,13,0,0,0,1887-2-13,0
1887,2,14,0,0,0,1887-2-14,0
1887,2,15,0,0,0,1887-2-15,0
1887,2,16,0,0,0,1887-2-16,0
1887,2,17,13,0,13,1887-2-17,-13
1887,2,18,111,46,65,1887-2-18,-19
1887,2,19,237,145,92,1887-2-19,53
1887,2,20,159,87,72,1887-2-20,15
1887,2,21,169,90,79,1887-2-21,11
1887,2,22,160,79,81,1887-2-22,-2
1887,2,23,141,89,52,1887-2-23,37
1887,2,24,102,59,43,1887-2-24,16
1887,2,25,72,33,39,1887-2-25,-6
1887,2,26,25,25,0,1887-2-26,25
1887,2,27,38,38,0,1887-2-27,38
1887,2,28,193,193,0,1887-2-28,193
1887,3,1,170,170,0,1887-3-1,170
1887,3,2,134,134,0,1887-3-2,134
1887,3,3,0,0,0,1887-3-3,0
1887,3,4,0,0,0,1887-3-4,0
1887,3,5,0,0,0,1887-3-5,0
1887,3,6,0,0,0,1887-3-6,0
1887,3,7,0,0,0,1887-3-7,0
1887,3,8,0,0,0,1887-3-8,0
1887,3,9,0,0,0,1887-3-9,0
1887,3,10,15,0,15,1887-3-10,-15
1887,3,11,9,0,9,1887-3-11,-9
1887,3,12,0,0,0,1887-3-12,0
1887,3,13,0,0,0,1887-3-13,0
1887,3,14,0,0,0,1887-3-14,0
1887,3,15,0,0,0,1887-3-15,0
1887,3,16,0,0,0,1887-3-16,0
1887,3,17,72,72,0,1887-3-17,72
1887,3,18,59,59,0,1887-3-18,59
1887,3,19,94,94,0,1887-3-19,94
1887,3,20,103,103,0,1887-3-20,103
1887,3,21,77,77,0,1887-3-21,77
1887,3,22,89,89,0,1887-3-22,89
1887,3,23,10,10,0,1887-3-23,10
1887,3,24,5,5,0,1887-3-24,5
1887,3,25,18,0,18,1887-3-25,-18
1887,3,26,45,0,45,1887-3-26,-45
1887,3,27,15,0,15,1887-3-27,-15
1887,3,28,0,0,0,1887-3-28,0
1887,3,29,0,0,0,1887-3-29,0
1887,3,30,9,9,0,1887-3-30,9
1887,3,31,23,23,0,1887-3-31,23
1887,4,1,27,27,0,1887-4-1,27
1887,4,2,8,8,0,1887-4-2,8
1887,4,3,10,10,0,1887-4-3,10
1887,4,4,4,4,0,1887-4-4,4
1887,4,5,0,0,0,1887-4-5,0
1887,4,6,0,0,0,1887-4-6,0
1887,4,7,0,0,0,1887-4-7,0
1887,4,8,0,0,0,1887-4-8,0
1887,4,9,0,0,0,1887-4-9,0
1887,4,10,0,0,0,1887-4-10,0
1887,4,11,0,0,0,1887-4-11,0
1887,4,12,40,40,0,1887-4-12,40
1887,4,13,23,23,0,1887-4-13,23
1887,4,14,0,0,0,1887-4-14,0
1887,4,15,13,0,13,1887-4-15,-13
1887,4,16,34,0,34,1887-4-16,-34
1887,4,17,0,0,0,1887-4-17,0
1887,4,18,20,20,0,1887-4-18,20
1887,4,19,158,144,14,1887-4-19,130
1887,4,20,158,158,0,1887-4-20,158
1887,4,21,119,119,0,1887-4-21,119
1887,4,22,105,105,0,1887-4-22,105
1887,4,23,67,67,0,1887-4-23,67
1887,4,24,72,72,0,1887-4-24,72
1887,4,25,49,49,0,1887-4-25,49
1887,4,26,24,24,0,1887-4-26,24
1887,4,27,129,129,0,1887-4-27,129
1887,4,28,97,97,0,1887-4-28,97
1887,4,29,119,119,0,1887-4-29,119
1887,4,30,68,68,0,1887-4-30,68
1887,5,1,29,29,0,1887-5-1,29
1887,5,2,396,377,19,1887-5-2,358
1887,5,3,521,521,0,1887-5-3,521
1887,5,4,426,413,13,1887-5-4,400
1887,5,5,342,289,53,1887-5-5,236
1887,5,6,327,289,38,1887-5-6,251
1887,5,7,337,277,60,1887-5-7,217
1887,5,8,379,292,87,1887-5-8,205
1887,5,9,415,293,122,1887-5-9,171
1887,5,10,395,281,114,1887-5-10,167
1887,5,11,326,233,93,1887-5-11,140
1887,5,12,228,217,11,1887-5-12,206
1887,5,13,180,159,21,1887-5-13,138
1887,5,14,200,164,36,1887-5-14,128
1887,5,15,77,0,77,1887-5-15,-77
1887,5,16,266,0,266,1887-5-16,-266
1887,5,17,371,15,356,1887-5-17,-341
1887,5,18,490,0,490,1887-5-18,-490
1887,5,19,701,0,701,1887-5-19,-701
1887,5,20,588,0,588,1887-5-20,-588
1887,5,21,599,0,599,1887-5-21,-599
1887,5,22,0,0,0,1887-5-22,0
1887,5,23,0,0,0,1887-5-23,0
1887,5,24,0,0,0,1887-5-24,0
1887,5,25,0,0,0,1887-5-25,0
1887,5,26,11,11,0,1887-5-26,11
1887,5,27,0,0,0,1887-5-27,0
1887,5,28,44,44,0,1887-5-28,44
1887,5,29,93,93,0,1887-5-29,93
1887,5,30,63,63,0,1887-5-30,63
1887,5,31,29,19,10,1887-5-31,9
1887,6,1,55,0,55,1887-6-1,-55
1887,6,2,115,0,115,1887-6-2,-115
1887,6,3,219,0,219,1887-6-3,-219
1887,6,4,54,0,54,1887-6-4,-54
1887,6,5,20,0,20,1887-6-5,-20
1887,6,6,787,0,787,1887-6-6,-787
1887,6,7,614,0,614,1887-6-7,-614
1887,6,8,583,0,583,1887-6-8,-583
1887,6,9,680,91,589,1887-6-9,-498
1887,6,10,640,44,596,1887-6-10,-552
1887,6,11,596,48,548,1887-6-11,-500
1887,6,12,592,35,557,1887-6-12,-522
1887,6,13,526,13,513,1887-6-13,-500
1887,6,14,511,4,507,1887-6-14,-503
1887,6,15,483,0,483,1887-6-15,-483
1887,6,16,437,0,437,1887-6-16,-437
1887,6,17,327,31,296,1887-6-17,-265
1887,6,18,371,44,327,1887-6-18,-283
1887,6,19,195,183,12,1887-6-19,171
1887,6,20,146,82,64,1887-6-20,18
1887,6,21,97,40,57,1887-6-21,-17
1887,6,22,36,0,36,1887-6-22,-36
1887,6,23,35,0,35,1887-6-23,-35
1887,6,24,17,0,17,1887-6-24,-17
1887,6,25,4,0,4,1887-6-25,-4
1887,6,26,0,0,0,1887-6-26,0
1887,6,27,292,0,292,1887-6-27,-292
1887,6,28,240,0,240,1887-6-28,-240
1887,6,29,220,0,220,1887-6-29,-220
1887,6,30,171,0,171,1887-6-30,-171
1887,7,1,187,0,187,1887-7-1,-187
1887,7,2,411,0,411,1887-7-2,-411
1887,7,3,390,0,390,1887-7-3,-390
1887,7,4,400,0,400,1887-7-4,-400
1887,7,5,598,138,460,1887-7-5,-322
1887,7,6,930,338,592,1887-7-6,-254
1887,7,7,1026,415,611,1887-7-7,-196
1887,7,8,889,372,517,1887-7-8,-145
1887,7,9,676,329,347,1887-7-9,-18
1887,7,10,574,255,319,1887-7-10,-64
1887,7,11,529,280,249,1887-7-11,31
1887,7,12,437,249,188,1887-7-12,61
1887,7,13,431,255,176,1887-7-13,79
1887,7,14,427,241,186,1887-7-14,55
1887,7,15,215,215,0,1887-7-15,215
1887,7,16,193,193,0,1887-7-16,193
1887,7,17,120,120,0,1887-7-17,120
1887,7,18,50,50,0,1887-7-18,50
1887,7,19,0,0,0,1887-7-19,0
1887,7,20,0,0,0,1887-7-20,0
1887,7,21,0,0,0,1887-7-21,0
1887,7,22,0,0,0,1887-7-22,0
1887,7,23,50,0,50,1887-7-23,-50
1887,7,24,63,0,63,1887-7-24,-63
1887,7,25,94,0,94,1887-7-25,-94
1887,7,26,268,0,268,1887-7-26,-268
1887,7,27,542,0,542,1887-7-27,-542
1887,7,28,648,0,648,1887-7-28,-648
1887,7,29,813,0,813,1887-7-29,-813
1887,7,30,94,0,94,1887-7-30,-94
1887,7,31,431,70,361,1887-7-31,-291
1887,8,1,489,115,374,1887-8-1,-259
1887,8,2,449,61,388,1887-8-2,-327
1887,8,3,385,38,347,1887-8-3,-309
1887,8,4,304,12,292,1887-8-4,-280
1887,8,5,392,7,385,1887-8-5,-378
1887,8,6,413,0,413,1887-8-6,-413
1887,8,7,429,0,429,1887-8-7,-429
1887,8,8,323,0,323,1887-8-8,-323
1887,8,9,269,0,269,1887-8-9,-269
1887,8,10,167,0,167,1887-8-10,-167
1887,8,11,0,0,0,1887-8-11,0
1887,8,12,0,0,0,1887-8-12,0
1887,8,13,274,81,193,1887-8-13,-112
1887,8,14,192,69,123,1887-8-14,-54
1887,8,15,180,80,100,1887-8-15,-20
1887,8,16,182,87,95,1887-8-16,-8
1887,8,17,160,80,80,1887-8-17,0
1887,8,18,141,85,56,1887-8-18,29
1887,8,19,68,40,28,1887-8-19,12
1887,8,20,62,21,41,1887-8-20,-20
1887,8,21,45,13,32,1887-8-21,-19
1887,8,22,27,15,12,1887-8-22,3
1887,8,23,0,0,0,1887-8-23,0
1887,8,24,0,0,0,1887-8-24,0
1887,8,25,0,0,0,1887-8-25,0
1887,8,26,0,0,0,1887-8-26,0
1887,8,27,32,32,0,1887-8-27,32
1887,8,28,66,66,0,1887-8-28,66
1887,8,29,0,0,0,1887-8-29,0
1887,8,30,0,0,0,1887-8-30,0
1887,8,31,0,0,0,1887-8-31,0
1887,9,1,0,0,0,1887-9-1,0
1887,9,2,0,0,0,1887-9-2,0
1887,9,3,52,0,52,1887-9-3,-52
1887,9,4,22,0,22,1887-9-4,-22
1887,9,5,0,0,0,1887-9-5,0
1887,9,6,0,0,0,1887-9-6,0
1887,9,7,0,0,0,1887-9-7,0
1887,9,8,0,0,0,1887-9-8,0
1887,9,9,0,0,0,1887-9-9,0
1887,9,10,0,0,0,1887-9-10,0
1887,9,11,0,0,0,1887-9-11,0
1887,9,12,0,0,0,1887-9-12,0
1887,9,13,10,0,10,1887-9-13,-10
1887,9,14,46,31,15,1887-9-14,16
1887,9,15,256,250,6,1887-9-15,244
1887,9,16,316,316,0,1887-9-16,316
1887,9,17,425,425,0,1887-9-17,425
1887,9,18,508,508,0,1887-9-18,508
1887,9,19,437,437,0,1887-9-19,437
1887,9,20,397,397,0,1887-9-20,397
1887,9,21,360,360,0,1887-9-21,360
1887,9,22,296,296,0,1887-9-22,296
1887,9,23,341,341,0,1887-9-23,341
1887,9,24,187,173,14,1887-9-24,159
1887,9,25,0,0,0,1887-9-25,0
1887,9,26,0,0,0,1887-9-26,0
1887,9,27,0,0,0,1887-9-27,0
1887,9,28,0,0,0,1887-9-28,0
1887,9,29,0,0,0,1887-9-29,0
1887,9,30,0,0,0,1887-9-30,0
1887,10,1,0,0,0,1887-10-1,0
1887,10,2,54,0,54,1887-10-2,-54
1887,10,3,86,0,86,1887-10-3,-86
1887,10,4,89,0,89,1887-10-4,-89
1887,10,5,5,0,5,1887-10-5,-5
1887,10,6,13,0,13,1887-10-6,-13
1887,10,7,0,0,0,1887-10-7,0
1887,10,8,0,0,0,1887-10-8,0
1887,10,9,0,0,0,1887-10-9,0
1887,10,10,0,0,0,1887-10-10,0
1887,10,11,0,0,0,1887-10-11,0
1887,10,12,0,0,0,1887-10-12,0
1887,10,13,0,0,0,1887-10-13,0
1887,10,14,0,0,0,1887-10-14,0
1887,10,15,0,0,0,1887-10-15,0
1887,10,16,0,0,0,1887-10-16,0
1887,10,17,0,0,0,1887-10-17,0
1887,10,18,32,0,32,1887-10-18,-32
1887,10,19,158,0,158,1887-10-19,-158
1887,10,20,214,0,214,1887-10-20,-214
1887,10,21,318,0,318,1887-10-21,-318
1887,10,22,274,0,274,1887-10-22,-274
1887,10,23,140,0,140,1887-10-23,-140
1887,10,24,115,0,115,1887-10-24,-115
1887,10,25,61,0,61,1887-10-25,-61
1887,10,26,44,0,44,1887-10-26,-44
1887,10,27,34,0,34,1887-10-27,-34
1887,10,28,14,0,14,1887-10-28,-14
1887,10,29,2,0,2,1887-10-29,-2
1887,10,30,0,0,0,1887-10-30,0
1887,10,31,22,22,0,1887-10-31,22
1887,11,1,3,3,0,1887-11-1,3
1887,11,2,0,0,0,1887-11-2,0
1887,11,3,0,0,0,1887-11-3,0
1887,11,4,0,0,0,1887-11-4,0
1887,11,5,130,0,130,1887-11-5,-130
1887,11,6,143,0,143,1887-11-6,-143
1887,11,7,141,7,134,1887-11-7,-127
1887,11,8,118,2,116,1887-11-8,-114
1887,11,9,112,0,112,1887-11-9,-112
1887,11,10,96,0,96,1887-11-10,-96
1887,11,11,161,0,161,1887-11-11,-161
1887,11,12,171,0,171,1887-11-12,-171
1887,11,13,180,0,180,1887-11-13,-180
1887,11,14,140,0,140,1887-11-14,-140
1887,11,15,82,0,82,1887-11-15,-82
1887,11,16,38,0,38,1887-11-16,-38
1887,11,17,29,0,29,1887-11-17,-29
1887,11,18,11,0,11,1887-11-18,-11
1887,11,19,8,0,8,1887-11-19,-8
1887,11,20,5,0,5,1887-11-20,-5
1887,11,21,0,0,0,1887-11-21,0
1887,11,22,0,0,0,1887-11-22,0
1887,11,23,0,0,0,1887-11-23,0
1887,11,24,0,0,0,1887-11-24,0
1887,11,25,0,0,0,1887-11-25,0
1887,11,26,0,0,0,1887-11-26,0
1887,11,27,0,0,0,1887-11-27,0
1887,11,28,0,0,0,1887-11-28,0
1887,11,29,0,0,0,1887-11-29,0
1887,11,30,0,0,0,1887-11-30,0
1887,12,1,0,0,0,1887-12-1,0
1887,12,2,0,0,0,1887-12-2,0
1887,12,3,489,0,489,1887-12-3,-489
1887,12,4,850,0,850,1887-12-4,-850
1887,12,5,808,0,808,1887-12-5,-808
1887,12,6,833,0,833,1887-12-6,-833
1887,12,7,763,0,763,1887-12-7,-763
1887,12,8,670,0,670,1887-12-8,-670
1887,12,9,614,0,614,1887-12-9,-614
1887,12,10,710,0,710,1887-12-10,-710
1887,12,11,580,0,580,1887-12-11,-580
1887,12,12,507,0,507,1887-12-12,-507
1887,12,13,387,0,387,1887-12-13,-387
1887,12,14,631,0,631,1887-12-14,-631
1887,12,15,1325,0,1325,1887-12-15,-1325
1887,12,16,919,0,919,1887-12-16,-919
1887,12,17,876,0,876,1887-12-17,-876
1887,12,18,701,0,701,1887-12-18,-701
1887,12,19,773,0,773,1887-12-19,-773
1887,12,20,722,0,722,1887-12-20,-722
1887,12,21,844,0,844,1887-12-21,-844
1887,12,22,796,0,796,1887-12-22,-796
1887,12,23,785,0,785,1887-12-23,-785
1887,12,24,716,0,716,1887-12-24,-716
1887,12,25,695,0,695,1887-12-25,-695
1887,12,26,387,0,387,1887-12-26,-387
1887,12,27,24,0,24,1887-12-27,-24
1887,12,28,0,0,0,1887-12-28,0
1887,12,29,0,0,0,1887-12-29,0
1887,12,30,0,0,0,1887-12-30,0
1887,12,31,-1,-1,-1,1887-12-31,0
1888,1,1,183,0,183,1888-1-1,-183
1888,1,2,178,0,178,1888-1-2,-178
1888,1,3,176,0,176,1888-1-3,-176
1888,1,4,215,48,167,1888-1-4,-119
1888,1,5,131,8,123,1888-1-5,-115
1888,1,6,133,0,133,1888-1-6,-133
1888,1,7,110,0,110,1888-1-7,-110
1888,1,8,88,0,88,1888-1-8,-88
1888,1,9,70,0,70,1888-1-9,-70
1888,1,10,350,115,235,1888-1-10,-120
1888,1,11,222,88,134,1888-1-11,-46
1888,1,12,199,39,160,1888-1-12,-121
1888,1,13,156,0,156,1888-1-13,-156
1888,1,14,153,0,153,1888-1-14,-153
1888,1,15,174,0,174,1888-1-15,-174
1888,1,16,183,0,183,1888-1-16,-183
1888,1,17,148,0,148,1888-1-17,-148
1888,1,18,150,0,150,1888-1-18,-150
1888,1,19,203,0,203,1888-1-19,-203
1888,1,20,193,0,193,1888-1-20,-193
1888,1,21,129,0,129,1888-1-21,-129
1888,1,22,0,0,0,1888-1-22,0
1888,1,23,10,0,10,1888-1-23,-10
1888,1,24,16,0,16,1888-1-24,-16
1888,1,25,9,0,9,1888-1-25,-9
1888,1,26,0,0,0,1888-1-26,0
1888,1,27,0,0,0,1888-1-27,0
1888,1,28,0,0,0,1888-1-28,0
1888,1,29,0,0,0,1888-1-29,0
1888,1,30,4,0,4,1888-1-30,-4
1888,1,31,56,0,56,1888-1-31,-56
1888,2,1,80,0,80,1888-2-1,-80
1888,2,2,51,0,51,1888-2-2,-51
1888,2,3,14,0,14,1888-2-3,-14
1888,2,4,0,0,0,1888-2-4,0
1888,2,5,0,0,0,1888-2-5,0
1888,2,6,0,0,0,1888-2-6,0
1888,2,7,0,0,0,1888-2-7,0
1888,2,8,0,0,0,1888-2-8,0
1888,2,9,0,0,0,1888-2-9,0
1888,2,10,0,0,0,1888-2-10,0
1888,2,11,0,0,0,1888-2-11,0
1888,2,12,0,0,0,1888-2-12,0
1888,2,13,0,0,0,1888-2-13,0
1888,2,14,0,0,0,1888-2-14,0
1888,2,15,0,0,0,1888-2-15,0
1888,2,16,0,0,0,1888-2-16,0
1888,2,17,0,0,0,1888-2-17,0
1888,2,18,177,0,177,1888-2-18,-177
1888,2,19,-1,-1,-1,1888-2-19,0
1888,2,20,352,0,352,1888-2-20,-352
1888,2,21,340,0,340,1888-2-21,-340
1888,2,22,332,0,332,1888-2-22,-332
1888,2,23,257,0,257,1888-2-23,-257
1888,2,24,192,0,192,1888-2-24,-192
1888,2,25,145,0,145,1888-2-25,-145
1888,2,26,123,0,123,1888-2-26,-123
1888,2,27,225,0,225,1888-2-27,-225
1888,2,28,194,0,194,1888-2-28,-194
1888,2,29,78,0,78,1888-2-29,-78
1888,3,1,9,0,9,1888-3-1,-9
1888,3,2,0,0,0,1888-3-2,0
1888,3,3,0,0,0,1888-3-3,0
1888,3,4,0,0,0,1888-3-4,0
1888,3,5,0,0,0,1888-3-5,0
1888,3,6,0,0,0,1888-3-6,0
1888,3,7,0,0,0,1888-3-7,0
1888,3,8,0,0,0,1888-3-8,0
1888,3,9,50,50,0,1888-3-9,50
1888,3,10,246,246,0,1888-3-10,246
1888,3,11,341,341,0,1888-3-11,341
1888,3,12,-1,-1,-1,1888-3-12,0
1888,3,13,240,240,0,1888-3-13,240
1888,3,14,226,226,0,1888-3-14,226
1888,3,15,218,218,0,1888-3-15,218
1888,3,16,251,179,72,1888-3-16,107
1888,3,17,265,208,57,1888-3-17,151
1888,3,18,218,185,33,1888-3-18,152
1888,3,19,193,168,25,1888-3-19,143
1888,3,20,154,154,0,1888-3-20,154
1888,3,21,65,0,65,1888-3-21,-65
1888,3,22,82,0,82,1888-3-22,-82
1888,3,23,79,0,79,1888-3-23,-79
1888,3,24,0,0,0,1888-3-24,0
1888,3,25,3,0,3,1888-3-25,-3
1888,3,26,0,0,0,1888-3-26,0
1888,3,27,0,0,0,1888-3-27,0
1888,3,28,0,0,0,1888-3-28,0
1888,3,29,0,0,0,1888-3-29,0
1888,3,30,0,0,0,1888-3-30,0
1888,3,31,7,0,7,1888-3-31,-7
1888,4,1,23,23,0,1888-4-1,23
1888,4,2,17,17,0,1888-4-2,17
1888,4,3,48,48,0,1888-4-3,48
1888,4,4,18,18,0,1888-4-4,18
1888,4,5,8,8,0,1888-4-5,8
1888,4,6,0,0,0,1888-4-6,0
1888,4,7,0,0,0,1888-4-7,0
1888,4,8,0,0,0,1888-4-8,0
1888,4,9,0,0,0,1888-4-9,0
1888,4,10,0,0,0,1888-4-10,0
1888,4,11,0,0,0,1888-4-11,0
1888,4,12,0,0,0,1888-4-12,0
1888,4,13,0,0,0,1888-4-13,0
1888,4,14,0,0,0,1888-4-14,0
1888,4,15,0,0,0,1888-4-15,0
1888,4,16,20,0,20,1888-4-16,-20
1888,4,17,12,0,12,1888-4-17,-12
1888,4,18,15,0,15,1888-4-18,-15
1888,4,19,0,0,0,1888-4-19,0
1888,4,20,0,0,0,1888-4-20,0
1888,4,21,62,0,62,1888-4-21,-62
1888,4,22,72,0,72,1888-4-22,-72
1888,4,23,49,0,49,1888-4-23,-49
1888,4,24,161,0,161,1888-4-24,-161
1888,4,25,98,0,98,1888-4-25,-98
1888,4,26,69,0,69,1888-4-26,-69
1888,4,27,65,0,65,1888-4-27,-65
1888,4,28,26,0,26,1888-4-28,-26
1888,4,29,17,0,17,1888-4-29,-17
1888,4,30,0,0,0,1888-4-30,0
1888,5,1,0,0,0,1888-5-1,0
1888,5,2,0,0,0,1888-5-2,0
1888,5,3,0,0,0,1888-5-3,0
1888,5,4,0,0,0,1888-5-4,0
1888,5,5,0,0,0,1888-5-5,0
1888,5,6,0,0,0,1888-5-6,0
1888,5,7,0,0,0,1888-5-7,0
1888,5,8,0,0,0,1888-5-8,0
1888,5,9,0,0,0,1888-5-9,0
1888,5,10,0,0,0,1888-5-10,0
1888,5,11,380,0,380,1888-5-11,-380
1888,5,12,464,0,464,1888-5-12,-464
1888,5,13,752,0,752,1888-5-13,-752
1888,5,14,786,0,786,1888-5-14,-786
1888,5,15,635,0,635,1888-5-15,-635
1888,5,16,606,0,606,1888-5-16,-606
1888,5,17,440,0,440,1888-5-17,-440
1888,5,18,350,0,350,1888-5-18,-350
1888,5,19,364,0,364,1888-5-19,-364
1888,5,20,334,0,334,1888-5-20,-334
1888,5,21,270,0,270,1888-5-21,-270
1888,5,22,222,0,222,1888-5-22,-222
1888,5,23,151,0,151,1888-5-23,-151
1888,5,24,0,0,0,1888-5-24,0
1888,5,25,0,0,0,1888-5-25,0
1888,5,26,0,0,0,1888-5-26,0
1888,5,27,0,0,0,1888-5-27,0
1888,5,28,0,0,0,1888-5-28,0
1888,5,29,0,0,0,1888-5-29,0
1888,5,30,0,0,0,1888-5-30,0
1888,5,31,0,0,0,1888-5-31,0
1888,6,1,0,0,0,1888-6-1,0
1888,6,2,0,0,0,1888-6-2,0
1888,6,3,0,0,0,1888-6-3,0
1888,6,4,0,0,0,1888-6-4,0
1888,6,5,0,0,0,1888-6-5,0
1888,6,6,0,0,0,1888-6-6,0
1888,6,7,0,0,0,1888-6-7,0
1888,6,8,0,0,0,1888-6-8,0
1888,6,9,83,0,83,1888-6-9,-83
1888,6,10,78,0,78,1888-6-10,-78
1888,6,11,59,0,59,1888-6-11,-59
1888,6,12,79,0,79,1888-6-12,-79
1888,6,13,27,0,27,1888-6-13,-27
1888,6,14,51,0,51,1888-6-14,-51
1888,6,15,78,0,78,1888-6-15,-78
1888,6,16,54,0,54,1888-6-16,-54
1888,6,17,11,0,11,1888-6-17,-11
1888,6,18,20,0,20,1888-6-18,-20
1888,6,19,41,0,41,1888-6-19,-41
1888,6,20,0,0,0,1888-6-20,0
1888,6,21,0,0,0,1888-6-21,0
1888,6,22,0,0,0,1888-6-22,0
1888,6,23,0,0,0,1888-6-23,0
1888,6,24,26,26,0,1888-6-24,26
1888,6,25,73,73,0,1888-6-25,73
1888,6,26,76,76,0,1888-6-26,76
1888,6,27,70,70,0,1888-6-27,70
1888,6,28,109,109,0,1888-6-28,109
1888,6,29,40,40,0,1888-6-29,40
1888,6,30,0,0,0,1888-6-30,0
1888,7,1,0,0,0,1888-7-1,0
1888,7,2,0,0,0,1888-7-2,0
1888,7,3,0,0,0,1888-7-3,0
1888,7,4,0,0,0,1888-7-4,0
1888,7,5,0,0,0,1888-7-5,0
1888,7,6,41,0,41,1888-7-6,-41
1888,7,7,50,0,50,1888-7-7,-50
1888,7,8,0,0,0,1888-7-8,0
1888,7,9,0,0,0,1888-7-9,0
1888,7,10,11,0,11,1888-7-10,-11
1888,7,11,2,0,2,1888-7-11,-2
1888,7,12,0,0,0,1888-7-12,0
1888,7,13,52,0,52,1888-7-13,-52
1888,7,14,52,0,52,1888-7-14,-52
1888,7,15,172,17,155,1888-7-15,-138
1888,7,16,168,12,156,1888-7-16,-144
1888,7,17,110,15,95,1888-7-17,-80
1888,7,18,0,0,0,1888-7-18,0
1888,7,19,6,6,0,1888-7-19,6
1888,7,20,0,0,0,1888-7-20,0
1888,7,21,0,0,0,1888-7-21,0
1888,7,22,0,0,0,1888-7-22,0
1888,7,23,0,0,0,1888-7-23,0
1888,7,24,0,0,0,1888-7-24,0
1888,7,25,0,0,0,1888-7-25,0
1888,7,26,0,0,0,1888-7-26,0
1888,7,27,0,0,0,1888-7-27,0
1888,7,28,0,0,0,1888-7-28,0
1888,7,29,12,0,12,1888-7-29,-12
1888,7,30,12,0,12,1888-7-30,-12
1888,7,31,0,0,0,1888-7-31,0
1888,8,1,18,0,18,1888-8-1,-18
1888,8,2,16,0,16,1888-8-2,-16
1888,8,3,0,0,0,1888-8-3,0
1888,8,4,0,0,0,1888-8-4,0
1888,8,5,0,0,0,1888-8-5,0
1888,8,6,0,0,0,1888-8-6,0
1888,8,7,0,0,0,1888-8-7,0
1888,8,8,48,0,48,1888-8-8,-48
1888,8,9,34,0,34,1888-8-9,-34
1888,8,10,2,0,2,1888-8-10,-2
1888,8,11,0,0,0,1888-8-11,0
1888,8,12,58,0,58,1888-8-12,-58
1888,8,13,49,0,49,1888-8-13,-49
1888,8,14,22,0,22,1888-8-14,-22
1888,8,15,15,0,15,1888-8-15,-15
1888,8,16,21,0,21,1888-8-16,-21
1888,8,17,0,0,0,1888-8-17,0
1888,8,18,7,0,7,1888-8-18,-7
1888,8,19,0,0,0,1888-8-19,0
1888,8,20,0,0,0,1888-8-20,0
1888,8,21,87,0,87,1888-8-21,-87
1888,8,22,64,0,64,1888-8-22,-64
1888,8,23,0,0,0,1888-8-23,0
1888,8,24,0,0,0,1888-8-24,0
1888,8,25,12,12,0,1888-8-25,12
1888,8,26,37,37,0,1888-8-26,37
1888,8,27,48,48,0,1888-8-27,48
1888,8,28,260,31,229,1888-8-28,-198
1888,8,29,325,0,325,1888-8-29,-325
1888,8,30,475,0,475,1888-8-30,-475
1888,8,31,425,0,425,1888-8-31,-425
1888,9,1,373,0,373,1888-9-1,-373
1888,9,2,287,0,287,1888-9-2,-287
1888,9,3,274,0,274,1888-9-3,-274
1888,9,4,221,0,221,1888-9-4,-221
1888,9,5,180,0,180,1888-9-5,-180
1888,9,6,271,0,271,1888-9-6,-271
1888,9,7,223,0,223,1888-9-7,-223
1888,9,8,226,19,207,1888-9-8,-188
1888,9,9,192,0,192,1888-9-9,-192
1888,9,10,39,0,39,1888-9-10,-39
1888,9,11,38,0,38,1888-9-11,-38
1888,9,12,105,0,105,1888-9-12,-105
1888,9,13,67,0,67,1888-9-13,-67
1888,9,14,44,0,44,1888-9-14,-44
1888,9,15,11,0,11,1888-9-15,-11
1888,9,16,2,0,2,1888-9-16,-2
1888,9,17,0,0,0,1888-9-17,0
1888,9,18,0,0,0,1888-9-18,0
1888,9,19,0,0,0,1888-9-19,0
1888,9,20,0,0,0,1888-9-20,0
1888,9,21,30,0,30,1888-9-21,-30
1888,9,22,54,0,54,1888-9-22,-54
1888,9,23,71,0,71,1888-9-23,-71
1888,9,24,67,0,67,1888-9-24,-67
1888,9,25,65,0,65,1888-9-25,-65
1888,9,26,41,0,41,1888-9-26,-41
1888,9,27,37,0,37,1888-9-27,-37
1888,9,28,21,0,21,1888-9-28,-21
1888,9,29,22,0,22,1888-9-29,-22
1888,9,30,0,0,0,1888-9-30,0
1888,10,1,0,0,0,1888-10-1,0
1888,10,2,0,0,0,1888-10-2,0
1888,10,3,22,0,22,1888-10-3,-22
1888,10,4,0,0,0,1888-10-4,0
1888,10,5,0,0,0,1888-10-5,0
1888,10,6,0,0,0,1888-10-6,0
1888,10,7,0,0,0,1888-10-7,0
1888,10,8,0,0,0,1888-10-8,0
1888,10,9,0,0,0,1888-10-9,0
1888,10,10,0,0,0,1888-10-10,0
1888,10,11,0,0,0,1888-10-11,0
1888,10,12,0,0,0,1888-10-12,0
1888,10,13,0,0,0,1888-10-13,0
1888,10,14,0,0,0,1888-10-14,0
1888,10,15,0,0,0,1888-10-15,0
1888,10,16,0,0,0,1888-10-16,0
1888,10,17,0,0,0,1888-10-17,0
1888,10,18,0,0,0,1888-10-18,0
1888,10,19,0,0,0,1888-10-19,0
1888,10,20,0,0,0,1888-10-20,0
1888,10,21,0,0,0,1888-10-21,0
1888,10,22,0,0,0,1888-10-22,0
1888,10,23,0,0,0,1888-10-23,0
1888,10,24,0,0,0,1888-10-24,0
1888,10,25,64,0,64,1888-10-25,-64
1888,10,26,74,0,74,1888-10-26,-74
1888,10,27,166,0,166,1888-10-27,-166
1888,10,28,0,0,0,1888-10-28,0
1888,10,29,0,0,0,1888-10-29,0
1888,10,30,0,0,0,1888-10-30,0
1888,10,31,0,0,0,1888-10-31,0
1888,11,1,0,0,0,1888-11-1,0
1888,11,2,0,0,0,1888-11-2,0
1888,11,3,0,0,0,1888-11-3,0
1888,11,4,0,0,0,1888-11-4,0
1888,11,5,0,0,0,1888-11-5,0
1888,11,6,373,373,0,1888-11-6,373
1888,11,7,477,477,0,1888-11-7,477
1888,11,8,429,429,0,1888-11-8,429
1888,11,9,444,444,0,1888-11-9,444
1888,11,10,350,350,0,1888-11-10,350
1888,11,11,541,332,209,1888-11-11,123
1888,11,12,556,353,203,1888-11-12,150
1888,11,13,589,334,255,1888-11-13,79
1888,11,14,508,287,221,1888-11-14,66
1888,11,15,407,220,187,1888-11-15,33
1888,11,16,397,209,188,1888-11-16,21
1888,11,17,176,0,176,1888-11-17,-176
1888,11,18,201,0,201,1888-11-18,-201
1888,11,19,171,0,171,1888-11-19,-171
1888,11,20,183,0,183,1888-11-20,-183
1888,11,21,162,0,162,1888-11-21,-162
1888,11,22,167,0,167,1888-11-22,-167
1888,11,23,0,0,0,1888-11-23,0
1888,11,24,0,0,0,1888-11-24,0
1888,11,25,0,0,0,1888-11-25,0
1888,11,26,0,0,0,1888-11-26,0
1888,11,27,44,0,44,1888-11-27,-44
1888,11,28,249,0,249,1888-11-28,-249
1888,11,29,379,0,379,1888-11-29,-379
1888,11,30,405,0,405,1888-11-30,-405
1888,12,1,322,0,322,1888-12-1,-322
1888,12,2,314,0,314,1888-12-2,-314
1888,12,3,247,0,247,1888-12-3,-247
1888,12,4,260,0,260,1888-12-4,-260
1888,12,5,175,0,175,1888-12-5,-175
1888,12,6,161,0,161,1888-12-6,-161
1888,12,7,95,0,95,1888-12-7,-95
1888,12,8,120,0,120,1888-12-8,-120
1888,12,9,60,0,60,1888-12-9,-60
1888,12,10,0,0,0,1888-12-10,0
1888,12,11,0,0,0,1888-12-11,0
1888,12,12,0,0,0,1888-12-12,0
1888,12,13,0,0,0,1888-12-13,0
1888,12,14,0,0,0,1888-12-14,0
1888,12,15,13,0,13,1888-12-15,-13
1888,12,16,54,0,54,1888-12-16,-54
1888,12,17,70,0,70,1888-12-17,-70
1888,12,18,55,0,55,1888-12-18,-55
1888,12,19,124,0,124,1888-12-19,-124
1888,12,20,115,0,115,1888-12-20,-115
1888,12,21,151,0,151,1888-12-21,-151
1888,12,22,44,0,44,1888-12-22,-44
1888,12,23,0,0,0,1888-12-23,0
1888,12,24,0,0,0,1888-12-24,0
1888,12,25,0,0,0,1888-12-25,0
1888,12,26,0,0,0,1888-12-26,0
1888,12,27,0,0,0,1888-12-27,0
1888,12,28,0,0,0,1888-12-28,0
1888,12,29,0,0,0,1888-12-29,0
1888,12,30,7,0,7,1888-12-30,-7
1888,12,31,0,0,0,1888-12-31,0
1889,1,1,0,0,0,1889-1-1,0
1889,1,2,0,0,0,1889-1-2,0
1889,1,3,0,0,0,1889-1-3,0
1889,1,4,0,0,0,1889-1-4,0
1889,1,5,0,0,0,1889-1-5,0
1889,1,6,0,0,0,1889-1-6,0
1889,1,7,0,0,0,1889-1-7,0
1889,1,8,0,0,0,1889-1-8,0
1889,1,9,0,0,0,1889-1-9,0
1889,1,10,0,0,0,1889-1-10,0
1889,1,11,0,0,0,1889-1-11,0
1889,1,12,0,0,0,1889-1-12,0
1889,1,13,0,0,0,1889-1-13,0
1889,1,14,0,0,0,1889-1-14,0
1889,1,15,0,0,0,1889-1-15,0
1889,1,16,41,41,0,1889-1-16,41
1889,1,17,32,32,0,1889-1-17,32
1889,1,18,0,0,0,1889-1-18,0
1889,1,19,0,0,0,1889-1-19,0
1889,1,20,0,0,0,1889-1-20,0
1889,1,21,0,0,0,1889-1-21,0
1889,1,22,0,0,0,1889-1-22,0
1889,1,23,0,0,0,1889-1-23,0
1889,1,24,0,0,0,1889-1-24,0
1889,1,25,0,0,0,1889-1-25,0
1889,1,26,0,0,0,1889-1-26,0
1889,1,27,0,0,0,1889-1-27,0
1889,1,28,0,0,0,1889-1-28,0
1889,1,29,0,0,0,1889-1-29,0
1889,1,30,0,0,0,1889-1-30,0
1889,1,31,0,0,0,1889-1-31,0
1889,2,1,33,0,33,1889-2-1,-33
1889,2,2,111,0,111,1889-2-2,-111
1889,2,3,113,0,113,1889-2-3,-113
1889,2,4,73,0,73,1889-2-4,-73
1889,2,5,22,0,22,1889-2-5,-22
1889,2,6,6,0,6,1889-2-6,-6
1889,2,7,0,0,0,1889-2-7,0
1889,2,8,0,0,0,1889-2-8,0
1889,2,9,0,0,0,1889-2-9,0
1889,2,10,0,0,0,1889-2-10,0
1889,2,11,0,0,0,1889-2-11,0
1889,2,12,0,0,0,1889-2-12,0
1889,2,13,0,0,0,1889-2-13,0
1889,2,14,0,0,0,1889-2-14,0
1889,2,15,0,0,0,1889-2-15,0
1889,2,16,0,0,0,1889-2-16,0
1889,2,17,0,0,0,1889-2-17,0
1889,2,18,0,0,0,1889-2-18,0
1889,2,19,0,0,0,1889-2-19,0
1889,2,20,0,0,0,1889-2-20,0
1889,2,21,0,0,0,1889-2-21,0
1889,2,22,32,0,32,1889-2-22,-32
1889,2,23,47,0,47,1889-2-23,-47
1889,2,24,-1,-1,-1,1889-2-24,0
1889,2,25,33,0,33,1889-2-25,-33
1889,2,26,41,0,41,1889-2-26,-41
1889,2,27,147,0,147,1889-2-27,-147
1889,2,28,94,0,94,1889-2-28,-94
1889,3,1,61,0,61,1889-3-1,-61
1889,3,2,28,0,28,1889-3-2,-28
1889,3,3,0,0,0,1889-3-3,0
1889,3,4,0,0,0,1889-3-4,0
1889,3,5,9,0,9,1889-3-5,-9
1889,3,6,24,0,24,1889-3-6,-24
1889,3,7,23,0,23,1889-3-7,-23
1889,3,8,24,0,24,1889-3-8,-24
1889,3,9,28,0,28,1889-3-9,-28
1889,3,10,27,0,27,1889-3-10,-27
1889,3,11,18,0,18,1889-3-11,-18
1889,3,12,39,0,39,1889-3-12,-39
1889,3,13,69,56,13,1889-3-13,43
1889,3,14,121,110,11,1889-3-14,99
1889,3,15,152,145,7,1889-3-15,138
1889,3,16,203,203,0,1889-3-16,203
1889,3,17,36,36,0,1889-3-17,36
1889,3,18,0,0,0,1889-3-18,0
1889,3,19,0,0,0,1889-3-19,0
1889,3,20,0,0,0,1889-3-20,0
1889,3,21,0,0,0,1889-3-21,0
1889,3,22,0,0,0,1889-3-22,0
1889,3,23,0,0,0,1889-3-23,0
1889,3,24,0,0,0,1889-3-24,0
1889,3,25,0,0,0,1889-3-25,0
1889,3,26,0,0,0,1889-3-26,0
1889,3,27,0,0,0,1889-3-27,0
1889,3,28,0,0,0,1889-3-28,0
1889,3,29,0,0,0,1889-3-29,0
1889,3,30,0,0,0,1889-3-30,0
1889,3,31,0,0,0,1889-3-31,0
1889,4,1,89,89,0,1889-4-1,89
1889,4,2,101,101,0,1889-4-2,101
1889,4,3,114,114,0,1889-4-3,114
1889,4,4,97,97,0,1889-4-4,97
1889,4,5,91,91,0,1889-4-5,91
1889,4,6,83,83,0,1889-4-6,83
1889,4,7,82,82,0,1889-4-7,82
1889,4,8,53,53,0,1889-4-8,53
1889,4,9,39,39,0,1889-4-9,39
1889,4,10,22,22,0,1889-4-10,22
1889,4,11,30,7,23,1889-4-11,-16
1889,4,12,7,0,7,1889-4-12,-7
1889,4,13,0,0,0,1889-4-13,0
1889,4,14,0,0,0,1889-4-14,0
1889,4,15,0,0,0,1889-4-15,0
1889,4,16,0,0,0,1889-4-16,0
1889,4,17,0,0,0,1889-4-17,0
1889,4,18,0,0,0,1889-4-18,0
1889,4,19,0,0,0,1889-4-19,0
1889,4,20,0,0,0,1889-4-20,0
1889,4,21,0,0,0,1889-4-21,0
1889,4,22,0,0,0,1889-4-22,0
1889,4,23,0,0,0,1889-4-23,0
1889,4,24,0,0,0,1889-4-24,0
1889,4,25,0,0,0,1889-4-25,0
1889,4,26,0,0,0,1889-4-26,0
1889,4,27,0,0,0,1889-4-27,0
1889,4,28,0,0,0,1889-4-28,0
1889,4,29,0,0,0,1889-4-29,0
1889,4,30,0,0,0,1889-4-30,0
1889,5,1,0,0,0,1889-5-1,0
1889,5,2,0,0,0,1889-5-2,0
1889,5,3,0,0,0,1889-5-3,0
1889,5,4,0,0,0,1889-5-4,0
1889,5,5,126,0,126,1889-5-5,-126
1889,5,6,121,0,121,1889-5-6,-121
1889,5,7,100,0,100,1889-5-7,-100
1889,5,8,53,0,53,1889-5-8,-53
1889,5,9,18,0,18,1889-5-9,-18
1889,5,10,12,0,12,1889-5-10,-12
1889,5,11,0,0,0,1889-5-11,0
1889,5,12,0,0,0,1889-5-12,0
1889,5,13,0,0,0,1889-5-13,0
1889,5,14,0,0,0,1889-5-14,0
1889,5,15,0,0,0,1889-5-15,0
1889,5,16,0,0,0,1889-5-16,0
1889,5,17,0,0,0,1889-5-17,0
1889,5,18,0,0,0,1889-5-18,0
1889,5,19,0,0,0,1889-5-19,0
1889,5,20,0,0,0,1889-5-20,0
1889,5,21,0,0,0,1889-5-21,0
1889,5,22,0,0,0,1889-5-22,0
1889,5,23,0,0,0,1889-5-23,0
1889,5,24,0,0,0,1889-5-24,0
1889,5,25,0,0,0,1889-5-25,0
1889,5,26,0,0,0,1889-5-26,0
1889,5,27,17,0,17,1889-5-27,-17
1889,5,28,0,0,0,1889-5-28,0
1889,5,29,0,0,0,1889-5-29,0
1889,5,30,0,0,0,1889-5-30,0
1889,5,31,0,0,0,1889-5-31,0
1889,6,1,0,0,0,1889-6-1,0
1889,6,2,0,0,0,1889-6-2,0
1889,6,3,0,0,0,1889-6-3,0
1889,6,4,0,0,0,1889-6-4,0
1889,6,5,0,0,0,1889-6-5,0
1889,6,6,0,0,0,1889-6-6,0
1889,6,7,0,0,0,1889-6-7,0
1889,6,8,0,0,0,1889-6-8,0
1889,6,9,0,0,0,1889-6-9,0
1889,6,10,0,0,0,1889-6-10,0
1889,6,11,0,0,0,1889-6-11,0
1889,6,12,0,0,0,1889-6-12,0
1889,6,13,0,0,0,1889-6-13,0
1889,6,14,0,0,0,1889-6-14,0
1889,6,15,0,0,0,1889-6-15,0
1889,6,16,447,0,447,1889-6-16,-447
1889,6,17,545,0,545,1889-6-17,-545
1889,6,18,538,0,538,1889-6-18,-538
1889,6,19,539,0,539,1889-6-19,-539
1889,6,20,519,0,519,1889-6-20,-519
1889,6,21,552,0,552,1889-6-21,-552
1889,6,22,633,0,633,1889-6-22,-633
1889,6,23,547,0,547,1889-6-23,-547
1889,6,24,510,0,510,1889-6-24,-510
1889,6,25,487,0,487,1889-6-25,-487
1889,6,26,502,0,502,1889-6-26,-502
1889,6,27,400,0,400,1889-6-27,-400
1889,6,28,287,0,287,1889-6-28,-287
1889,6,29,1,0,1,1889-6-29,-1
1889,6,30,8,0,8,1889-6-30,-8
1889,7,1,0,0,0,1889-7-1,0
1889,7,2,0,0,0,1889-7-2,0
1889,7,3,0,0,0,1889-7-3,0
1889,7,4,0,0,0,1889-7-4,0
1889,7,5,0,0,0,1889-7-5,0
1889,7,6,0,0,0,1889-7-6,0
1889,7,7,0,0,0,1889-7-7,0
1889,7,8,0,0,0,1889-7-8,0
1889,7,9,0,0,0,1889-7-9,0
1889,7,10,0,0,0,1889-7-10,0
1889,7,11,0,0,0,1889-7-11,0
1889,7,12,280,0,280,1889-7-12,-280
1889,7,13,332,0,332,1889-7-13,-332
1889,7,14,322,0,322,1889-7-14,-322
1889,7,15,374,0,374,1889-7-15,-374
1889,7,16,384,0,384,1889-7-16,-384
1889,7,17,380,0,380,1889-7-17,-380
1889,7,18,368,0,368,1889-7-18,-368
1889,7,19,422,0,422,1889-7-19,-422
1889,7,20,407,0,407,1889-7-20,-407
1889,7,21,321,0,321,1889-7-21,-321
1889,7,22,257,0,257,1889-7-22,-257
1889,7,23,283,0,283,1889-7-23,-283
1889,7,24,235,0,235,1889-7-24,-235
1889,7,25,0,0,0,1889-7-25,0
1889,7,26,63,0,63,1889-7-26,-63
1889,7,27,69,0,69,1889-7-27,-69
1889,7,28,0,0,0,1889-7-28,0
1889,7,29,98,62,36,1889-7-29,26
1889,7,30,66,36,30,1889-7-30,6
1889,7,31,97,6,91,1889-7-31,-85
1889,8,1,140,0,140,1889-8-1,-140
1889,8,2,110,0,110,1889-8-2,-110
1889,8,3,77,0,77,1889-8-3,-77
1889,8,4,280,0,280,1889-8-4,-280
1889,8,5,414,0,414,1889-8-5,-414
1889,8,6,488,0,488,1889-8-6,-488
1889,8,7,473,0,473,1889-8-7,-473
1889,8,8,441,0,441,1889-8-8,-441
1889,8,9,581,0,581,1889-8-9,-581
1889,8,10,779,0,779,1889-8-10,-779
1889,8,11,730,0,730,1889-8-11,-730
1889,8,12,292,0,292,1889-8-12,-292
1889,8,13,346,0,346,1889-8-13,-346
1889,8,14,549,0,549,1889-8-14,-549
1889,8,15,718,0,718,1889-8-15,-718
1889,8,16,691,0,691,1889-8-16,-691
1889,8,17,351,0,351,1889-8-17,-351
1889,8,18,40,0,40,1889-8-18,-40
1889,8,19,27,0,27,1889-8-19,-27
1889,8,20,27,0,27,1889-8-20,-27
1889,8,21,0,0,0,1889-8-21,0
1889,8,22,0,0,0,1889-8-22,0
1889,8,23,0,0,0,1889-8-23,0
1889,8,24,0,0,0,1889-8-24,0
1889,8,25,0,0,0,1889-8-25,0
1889,8,26,0,0,0,1889-8-26,0
1889,8,27,250,0,250,1889-8-27,-250
1889,8,28,263,0,263,1889-8-28,-263
1889,8,29,266,0,266,1889-8-29,-266
1889,8,30,204,0,204,1889-8-30,-204
1889,8,31,213,0,213,1889-8-31,-213
1889,9,1,214,0,214,1889-9-1,-214
1889,9,2,213,0,213,1889-9-2,-213
1889,9,3,176,0,176,1889-9-3,-176
1889,9,4,178,0,178,1889-9-4,-178
1889,9,5,163,0,163,1889-9-5,-163
1889,9,6,137,0,137,1889-9-6,-137
1889,9,7,148,0,148,1889-9-7,-148
1889,9,8,195,0,195,1889-9-8,-195
1889,9,9,0,0,0,1889-9-9,0
1889,9,10,0,0,0,1889-9-10,0
1889,9,11,0,0,0,1889-9-11,0
1889,9,12,0,0,0,1889-9-12,0
1889,9,13,0,0,0,1889-9-13,0
1889,9,14,0,0,0,1889-9-14,0
1889,9,15,0,0,0,1889-9-15,0
1889,9,16,0,0,0,1889-9-16,0
1889,9,17,0,0,0,1889-9-17,0
1889,9,18,0,0,0,1889-9-18,0
1889,9,19,0,0,0,1889-9-19,0
1889,9,20,0,0,0,1889-9-20,0
1889,9,21,0,0,0,1889-9-21,0
1889,9,22,0,0,0,1889-9-22,0
1889,9,23,0,0,0,1889-9-23,0
1889,9,24,204,0,204,1889-9-24,-204
1889,9,25,186,0,186,1889-9-25,-186
1889,9,26,233,0,233,1889-9-26,-233
1889,9,27,157,0,157,1889-9-27,-157
1889,9,28,176,0,176,1889-9-28,-176
1889,9,29,175,0,175,1889-9-29,-175
1889,9,30,143,0,143,1889-9-30,-143
1889,10,1,136,0,136,1889-10-1,-136
1889,10,2,80,0,80,1889-10-2,-80
1889,10,3,42,0,42,1889-10-3,-42
1889,10,4,19,0,19,1889-10-4,-19
1889,10,5,0,0,0,1889-10-5,0
1889,10,6,0,0,0,1889-10-6,0
1889,10,7,0,0,0,1889-10-7,0
1889,10,8,12,0,12,1889-10-8,-12
1889,10,9,9,0,9,1889-10-9,-9
1889,10,10,10,0,10,1889-10-10,-10
1889,10,11,6,0,6,1889-10-11,-6
1889,10,12,0,0,0,1889-10-12,0
1889,10,13,0,0,0,1889-10-13,0
1889,10,14,0,0,0,1889-10-14,0
1889,10,15,0,0,0,1889-10-15,0
1889,10,16,16,16,0,1889-10-16,16
1889,10,17,26,26,0,1889-10-17,26
1889,10,18,2,2,0,1889-10-18,2
1889,10,19,0,0,0,1889-10-19,0
1889,10,20,0,0,0,1889-10-20,0
1889,10,21,0,0,0,1889-10-21,0
1889,10,22,0,0,0,1889-10-22,0
1889,10,23,2,0,2,1889-10-23,-2
1889,10,24,0,0,0,1889-10-24,0
1889,10,25,0,0,0,1889-10-25,0
1889,10,26,0,0,0,1889-10-26,0
1889,10,27,0,0,0,1889-10-27,0
1889,10,28,0,0,0,1889-10-28,0
1889,10,29,0,0,0,1889-10-29,0
1889,10,30,0,0,0,1889-10-30,0
1889,10,31,0,0,0,1889-10-31,0
1889,11,1,0,0,0,1889-11-1,0
1889,11,2,0,0,0,1889-11-2,0
1889,11,3,0,0,0,1889-11-3,0
1889,11,4,0,0,0,1889-11-4,0
1889,11,5,0,0,0,1889-11-5,0
1889,11,6,0,0,0,1889-11-6,0
1889,11,7,0,0,0,1889-11-7,0
1889,11,8,0,0,0,1889-11-8,0
1889,11,9,0,0,0,1889-11-9,0
1889,11,10,0,0,0,1889-11-10,0
1889,11,11,0,0,0,1889-11-11,0
1889,11,12,0,0,0,1889-11-12,0
1889,11,13,0,0,0,1889-11-13,0
1889,11,14,0,0,0,1889-11-14,0
1889,11,15,0,0,0,1889-11-15,0
1889,11,16,0,0,0,1889-11-16,0
1889,11,17,0,0,0,1889-11-17,0
1889,11,18,0,0,0,1889-11-18,0
1889,11,19,0,0,0,1889-11-19,0
1889,11,20,0,0,0,1889-11-20,0
1889,11,21,0,0,0,1889-11-21,0
1889,11,22,0,0,0,1889-11-22,0
1889,11,23,0,0,0,1889-11-23,0
1889,11,24,0,0,0,1889-11-24,0
1889,11,25,0,0,0,1889-11-25,0
1889,11,26,0,0,0,1889-11-26,0
1889,11,27,0,0,0,1889-11-27,0
1889,11,28,0,0,0,1889-11-28,0
1889,11,29,0,0,0,1889-11-29,0
1889,11,30,0,0,0,1889-11-30,0
1889,12,1,0,0,0,1889-12-1,0
1889,12,2,0,0,0,1889-12-2,0
1889,12,3,0,0,0,1889-12-3,0
1889,12,4,0,0,0,1889-12-4,0
1889,12,5,0,0,0,1889-12-5,0
1889,12,6,0,0,0,1889-12-6,0
1889,12,7,0,0,0,1889-12-7,0
1889,12,8,0,0,0,1889-12-8,0
1889,12,9,0,0,0,1889-12-9,0
1889,12,10,0,0,0,1889-12-10,0
1889,12,11,0,0,0,1889-12-11,0
1889,12,12,73,0,73,1889-12-12,-73
1889,12,13,71,0,71,1889-12-13,-71
1889,12,14,0,0,0,1889-12-14,0
1889,12,15,0,0,0,1889-12-15,0
1889,12,16,0,0,0,1889-12-16,0
1889,12,17,0,0,0,1889-12-17,0
1889,12,18,43,12,31,1889-12-18,-19
1889,12,19,46,28,18,1889-12-19,10
1889,12,20,64,45,19,1889-12-20,26
1889,12,21,49,46,3,1889-12-21,43
1889,12,22,51,37,14,1889-12-22,23
1889,12,23,7,0,7,1889-12-23,-7
1889,12,24,20,0,20,1889-12-24,-20
1889,12,25,48,0,48,1889-12-25,-48
1889,12,26,155,0,155,1889-12-26,-155
1889,12,27,377,0,377,1889-12-27,-377
1889,12,28,315,0,315,1889-12-28,-315
1889,12,29,303,0,303,1889-12-29,-303
1889,12,30,370,0,370,1889-12-30,-370
1889,12,31,67,0,67,1889-12-31,-67
1890,1,1,57,0,57,1890-1-1,-57
1890,1,2,67,0,67,1890-1-2,-67
1890,1,3,48,0,48,1890-1-3,-48
1890,1,4,41,0,41,1890-1-4,-41
1890,1,5,29,0,29,1890-1-5,-29
1890,1,6,49,23,26,1890-1-6,-3
1890,1,7,17,0,17,1890-1-7,-17
1890,1,8,0,0,0,1890-1-8,0
1890,1,9,19,0,19,1890-1-9,-19
1890,1,10,0,0,0,1890-1-10,0
1890,1,11,0,0,0,1890-1-11,0
1890,1,12,0,0,0,1890-1-12,0
1890,1,13,0,0,0,1890-1-13,0
1890,1,14,0,0,0,1890-1-14,0
1890,1,15,0,0,0,1890-1-15,0
1890,1,16,0,0,0,1890-1-16,0
1890,1,17,13,13,0,1890-1-17,13
1890,1,18,16,16,0,1890-1-18,16
1890,1,19,74,74,0,1890-1-19,74
1890,1,20,293,293,0,1890-1-20,293
1890,1,21,330,330,0,1890-1-21,330
1890,1,22,215,215,0,1890-1-22,215
1890,1,23,0,0,0,1890-1-23,0
1890,1,24,0,0,0,1890-1-24,0
1890,1,25,0,0,0,1890-1-25,0
1890,1,26,0,0,0,1890-1-26,0
1890,1,27,0,0,0,1890-1-27,0
1890,1,28,0,0,0,1890-1-28,0
1890,1,29,0,0,0,1890-1-29,0
1890,1,30,5,5,0,1890-1-30,5
1890,1,31,37,37,0,1890-1-31,37
1890,2,1,18,18,0,1890-2-1,18
1890,2,2,0,0,0,1890-2-2,0
1890,2,3,0,0,0,1890-2-3,0
1890,2,4,0,0,0,1890-2-4,0
1890,2,5,0,0,0,1890-2-5,0
1890,2,6,0,0,0,1890-2-6,0
1890,2,7,0,0,0,1890-2-7,0
1890,2,8,0,0,0,1890-2-8,0
1890,2,9,0,0,0,1890-2-9,0
1890,2,10,0,0,0,1890-2-10,0
1890,2,11,0,0,0,1890-2-11,0
1890,2,12,0,0,0,1890-2-12,0
1890,2,13,0,0,0,1890-2-13,0
1890,2,14,0,0,0,1890-2-14,0
1890,2,15,0,0,0,1890-2-15,0
1890,2,16,0,0,0,1890-2-16,0
1890,2,17,0,0,0,1890-2-17,0
1890,2,18,0,0,0,1890-2-18,0
1890,2,19,0,0,0,1890-2-19,0
1890,2,20,0,0,0,1890-2-20,0
1890,2,21,0,0,0,1890-2-21,0
1890,2,22,0,0,0,1890-2-22,0
1890,2,23,0,0,0,1890-2-23,0
1890,2,24,0,0,0,1890-2-24,0
1890,2,25,0,0,0,1890-2-25,0
1890,2,26,0,0,0,1890-2-26,0
1890,2,27,0,0,0,1890-2-27,0
1890,2,28,21,0,21,1890-2-28,-21
1890,3,1,0,0,0,1890-3-1,0
1890,3,2,0,0,0,1890-3-2,0
1890,3,3,0,0,0,1890-3-3,0
1890,3,4,322,322,0,1890-3-4,322
1890,3,5,317,317,0,1890-3-5,317
1890,3,6,321,321,0,1890-3-6,321
1890,3,7,270,270,0,1890-3-7,270
1890,3,8,246,246,0,1890-3-8,246
1890,3,9,191,191,0,1890-3-9,191
1890,3,10,199,199,0,1890-3-10,199
1890,3,11,124,124,0,1890-3-11,124
1890,3,12,111,111,0,1890-3-12,111
1890,3,13,32,32,0,1890-3-13,32
1890,3,14,10,10,0,1890-3-14,10
1890,3,15,0,0,0,1890-3-15,0
1890,3,16,0,0,0,1890-3-16,0
1890,3,17,0,0,0,1890-3-17,0
1890,3,18,0,0,0,1890-3-18,0
1890,3,19,0,0,0,1890-3-19,0
1890,3,20,0,0,0,1890-3-20,0
1890,3,21,0,0,0,1890-3-21,0
1890,3,22,6,6,0,1890-3-22,6
1890,3,23,6,6,0,1890-3-23,6
1890,3,24,0,0,0,1890-3-24,0
1890,3,25,0,0,0,1890-3-25,0
1890,3,26,0,0,0,1890-3-26,0
1890,3,27,0,0,0,1890-3-27,0
1890,3,28,0,0,0,1890-3-28,0
1890,3,29,0,0,0,1890-3-29,0
1890,3,30,0,0,0,1890-3-30,0
1890,3,31,0,0,0,1890-3-31,0
1890,4,1,0,0,0,1890-4-1,0
1890,4,2,0,0,0,1890-4-2,0
1890,4,3,0,0,0,1890-4-3,0
1890,4,4,0,0,0,1890-4-4,0
1890,4,5,0,0,0,1890-4-5,0
1890,4,6,0,0,0,1890-4-6,0
1890,4,7,0,0,0,1890-4-7,0
1890,4,8,0,0,0,1890-4-8,0
1890,4,9,0,0,0,1890-4-9,0
1890,4,10,6,6,0,1890-4-10,6
1890,4,11,11,0,11,1890-4-11,-11
1890,4,12,83,55,28,1890-4-12,27
1890,4,13,22,11,11,1890-4-13,0
1890,4,14,0,0,0,1890-4-14,0
1890,4,15,17,0,17,1890-4-15,-17
1890,4,16,14,0,14,1890-4-16,-14
1890,4,17,2,0,2,1890-4-17,-2
1890,4,18,0,0,0,1890-4-18,0
1890,4,19,0,0,0,1890-4-19,0
1890,4,20,0,0,0,1890-4-20,0
1890,4,21,0,0,0,1890-4-21,0
1890,4,22,0,0,0,1890-4-22,0
1890,4,23,0,0,0,1890-4-23,0
1890,4,24,0,0,0,1890-4-24,0
1890,4,25,0,0,0,1890-4-25,0
1890,4,26,0,0,0,1890-4-26,0
1890,4,27,0,0,0,1890-4-27,0
1890,4,28,7,7,0,1890-4-28,7
1890,4,29,50,50,0,1890-4-29,50
1890,4,30,56,56,0,1890-4-30,56
1890,5,1,32,32,0,1890-5-1,32
1890,5,2,0,0,0,1890-5-2,0
1890,5,3,0,0,0,1890-5-3,0
1890,5,4,0,0,0,1890-5-4,0
1890,5,5,0,0,0,1890-5-5,0
1890,5,6,0,0,0,1890-5-6,0
1890,5,7,0,0,0,1890-5-7,0
1890,5,8,6,0,6,1890-5-8,-6
1890,5,9,32,0,32,1890-5-9,-32
1890,5,10,110,0,110,1890-5-10,-110
1890,5,11,154,34,120,1890-5-11,-86
1890,5,12,70,0,70,1890-5-12,-70
1890,5,13,24,0,24,1890-5-13,-24
1890,5,14,0,0,0,1890-5-14,0
1890,5,15,0,0,0,1890-5-15,0
1890,5,16,0,0,0,1890-5-16,0
1890,5,17,64,30,34,1890-5-17,-4
1890,5,18,69,11,58,1890-5-18,-47
1890,5,19,37,12,25,1890-5-19,-13
1890,5,20,36,7,29,1890-5-20,-22
1890,5,21,21,7,14,1890-5-21,-7
1890,5,22,10,6,4,1890-5-22,2
1890,5,23,4,4,0,1890-5-23,4
1890,5,24,3,3,0,1890-5-24,3
1890,5,25,0,0,0,1890-5-25,0
1890,5,26,0,0,0,1890-5-26,0
1890,5,27,0,0,0,1890-5-27,0
1890,5,28,0,0,0,1890-5-28,0
1890,5,29,0,0,0,1890-5-29,0
1890,5,30,3,3,0,1890-5-30,3
1890,5,31,0,0,0,1890-5-31,0
1890,6,1,0,0,0,1890-6-1,0
1890,6,2,0,0,0,1890-6-2,0
1890,6,3,0,0,0,1890-6-3,0
1890,6,4,0,0,0,1890-6-4,0
1890,6,5,14,0,14,1890-6-5,-14
1890,6,6,29,0,29,1890-6-6,-29
1890,6,7,105,0,105,1890-6-7,-105
1890,6,8,94,0,94,1890-6-8,-94
1890,6,9,21,0,21,1890-6-9,-21
1890,6,10,15,0,15,1890-6-10,-15
1890,6,11,0,0,0,1890-6-11,0
1890,6,12,0,0,0,1890-6-12,0
1890,6,13,0,0,0,1890-6-13,0
1890,6,14,0,0,0,1890-6-14,0
1890,6,15,0,0,0,1890-6-15,0
1890,6,16,0,0,0,1890-6-16,0
1890,6,17,0,0,0,1890-6-17,0
1890,6,18,0,0,0,1890-6-18,0
1890,6,19,0,0,0,1890-6-19,0
1890,6,20,0,0,0,1890-6-20,0
1890,6,21,0,0,0,1890-6-21,0
1890,6,22,0,0,0,1890-6-22,0
1890,6,23,0,0,0,1890-6-23,0
1890,6,24,0,0,0,1890-6-24,0
1890,6,25,0,0,0,1890-6-25,0
1890,6,26,0,0,0,1890-6-26,0
1890,6,27,0,0,0,1890-6-27,0
1890,6,28,0,0,0,1890-6-28,0
1890,6,29,0,0,0,1890-6-29,0
1890,6,30,0,0,0,1890-6-30,0
1890,7,1,0,0,0,1890-7-1,0
1890,7,2,0,0,0,1890-7-2,0
1890,7,3,0,0,0,1890-7-3,0
1890,7,4,111,0,111,1890-7-4,-111
1890,7,5,360,0,360,1890-7-5,-360
1890,7,6,330,0,330,1890-7-6,-330
1890,7,7,323,0,323,1890-7-7,-323
1890,7,8,301,0,301,1890-7-8,-301
1890,7,9,236,0,236,1890-7-9,-236
1890,7,10,185,0,185,1890-7-10,-185
1890,7,11,131,0,131,1890-7-11,-131
1890,7,12,58,0,58,1890-7-12,-58
1890,7,13,96,0,96,1890-7-13,-96
1890,7,14,115,0,115,1890-7-14,-115
1890,7,15,0,0,0,1890-7-15,0
1890,7,16,0,0,0,1890-7-16,0
1890,7,17,0,0,0,1890-7-17,0
1890,7,18,0,0,0,1890-7-18,0
1890,7,19,0,0,0,1890-7-19,0
1890,7,20,0,0,0,1890-7-20,0
1890,7,21,0,0,0,1890-7-21,0
1890,7,22,229,0,229,1890-7-22,-229
1890,7,23,228,0,228,1890-7-23,-228
1890,7,24,207,0,207,1890-7-24,-207
1890,7,25,176,0,176,1890-7-25,-176
1890,7,26,173,0,173,1890-7-26,-173
1890,7,27,160,0,160,1890-7-27,-160
1890,7,28,274,149,125,1890-7-28,24
1890,7,29,323,163,160,1890-7-29,3
1890,7,30,-1,-1,-1,1890-7-30,0
1890,7,31,179,162,17,1890-7-31,145
1890,8,1,163,134,29,1890-8-1,105
1890,8,2,161,137,24,1890-8-2,113
1890,8,3,123,123,0,1890-8-3,123
1890,8,4,70,70,0,1890-8-4,70
1890,8,5,63,40,23,1890-8-5,17
1890,8,6,60,16,44,1890-8-6,-28
1890,8,7,33,0,33,1890-8-7,-33
1890,8,8,0,0,0,1890-8-8,0
1890,8,9,0,0,0,1890-8-9,0
1890,8,10,0,0,0,1890-8-10,0
1890,8,11,10,10,0,1890-8-11,10
1890,8,12,0,0,0,1890-8-12,0
1890,8,13,0,0,0,1890-8-13,0
1890,8,14,0,0,0,1890-8-14,0
1890,8,15,0,0,0,1890-8-15,0
1890,8,16,0,0,0,1890-8-16,0
1890,8,17,0,0,0,1890-8-17,0
1890,8,18,0,0,0,1890-8-18,0
1890,8,19,0,0,0,1890-8-19,0
1890,8,20,0,0,0,1890-8-20,0
1890,8,21,0,0,0,1890-8-21,0
1890,8,22,0,0,0,1890-8-22,0
1890,8,23,0,0,0,1890-8-23,0
1890,8,24,22,0,22,1890-8-24,-22
1890,8,25,91,66,25,1890-8-25,41
1890,8,26,171,171,0,1890-8-26,171
1890,8,27,548,535,13,1890-8-27,522
1890,8,28,758,724,34,1890-8-28,690
1890,8,29,845,845,0,1890-8-29,845
1890,8,30,867,867,0,1890-8-30,867
1890,8,31,901,901,0,1890-8-31,901
1890,9,1,909,881,28,1890-9-1,853
1890,9,2,905,837,68,1890-9-2,769
1890,9,3,674,638,36,1890-9-3,602
1890,9,4,546,516,30,1890-9-4,486
1890,9,5,452,417,35,1890-9-5,382
1890,9,6,511,422,89,1890-9-6,333
1890,9,7,377,23,354,1890-9-7,-331
1890,9,8,261,3,258,1890-9-8,-255
1890,9,9,248,58,190,1890-9-9,-132
1890,9,10,56,56,0,1890-9-10,56
1890,9,11,49,41,8,1890-9-11,33
1890,9,12,44,30,14,1890-9-12,16
1890,9,13,12,12,0,1890-9-13,12
1890,9,14,6,6,0,1890-9-14,6
1890,9,15,128,0,128,1890-9-15,-128
1890,9,16,92,0,92,1890-9-16,-92
1890,9,17,228,0,228,1890-9-17,-228
1890,9,18,244,0,244,1890-9-18,-244
1890,9,19,126,0,126,1890-9-19,-126
1890,9,20,47,0,47,1890-9-20,-47
1890,9,21,0,0,0,1890-9-21,0
1890,9,22,0,0,0,1890-9-22,0
1890,9,23,0,0,0,1890-9-23,0
1890,9,24,32,32,0,1890-9-24,32
1890,9,25,227,227,0,1890-9-25,227
1890,9,26,-1,-1,-1,1890-9-26,0
1890,9,27,143,143,0,1890-9-27,143
1890,9,28,94,94,0,1890-9-28,94
1890,9,29,55,55,0,1890-9-29,55
1890,9,30,175,175,0,1890-9-30,175
1890,10,1,75,74,1,1890-10-1,73
1890,10,2,34,34,0,1890-10-2,34
1890,10,3,0,0,0,1890-10-3,0
1890,10,4,0,0,0,1890-10-4,0
1890,10,5,12,0,12,1890-10-5,-12
1890,10,6,25,0,25,1890-10-6,-25
1890,10,7,22,0,22,1890-10-7,-22
1890,10,8,3,0,3,1890-10-8,-3
1890,10,9,0,0,0,1890-10-9,0
1890,10,10,0,0,0,1890-10-10,0
1890,10,11,0,0,0,1890-10-11,0
1890,10,12,0,0,0,1890-10-12,0
1890,10,13,0,0,0,1890-10-13,0
1890,10,14,0,0,0,1890-10-14,0
1890,10,15,0,0,0,1890-10-15,0
1890,10,16,0,0,0,1890-10-16,0
1890,10,17,0,0,0,1890-10-17,0
1890,10,18,0,0,0,1890-10-18,0
1890,10,19,250,0,250,1890-10-19,-250
1890,10,20,629,0,629,1890-10-20,-629
1890,10,21,1153,0,1153,1890-10-21,-1153
1890,10,22,1106,0,1106,1890-10-22,-1106
1890,10,23,1003,0,1003,1890-10-23,-1003
1890,10,24,775,0,775,1890-10-24,-775
1890,10,25,653,0,653,1890-10-25,-653
1890,10,26,569,0,569,1890-10-26,-569
1890,10,27,373,0,373,1890-10-27,-373
1890,10,28,297,0,297,1890-10-28,-297
1890,10,29,279,0,279,1890-10-29,-279
1890,10,30,214,0,214,1890-10-30,-214
1890,10,31,142,0,142,1890-10-31,-142
1890,11,1,99,0,99,1890-11-1,-99
1890,11,2,0,0,0,1890-11-2,0
1890,11,3,0,0,0,1890-11-3,0
1890,11,4,0,0,0,1890-11-4,0
1890,11,5,0,0,0,1890-11-5,0
1890,11,6,0,0,0,1890-11-6,0
1890,11,7,125,0,125,1890-11-7,-125
1890,11,8,254,0,254,1890-11-8,-254
1890,11,9,204,0,204,1890-11-9,-204
1890,11,10,138,0,138,1890-11-10,-138
1890,11,11,84,0,84,1890-11-11,-84
1890,11,12,53,0,53,1890-11-12,-53
1890,11,13,45,0,45,1890-11-13,-45
1890,11,14,11,0,11,1890-11-14,-11
1890,11,15,0,0,0,1890-11-15,0
1890,11,16,0,0,0,1890-11-16,0
1890,11,17,0,0,0,1890-11-17,0
1890,11,18,0,0,0,1890-11-18,0
1890,11,19,0,0,0,1890-11-19,0
1890,11,20,0,0,0,1890-11-20,0
1890,11,21,0,0,0,1890-11-21,0
1890,11,22,113,113,0,1890-11-22,113
1890,11,23,277,277,0,1890-11-23,277
1890,11,24,376,376,0,1890-11-24,376
1890,11,25,480,480,0,1890-11-25,480
1890,11,26,707,707,0,1890-11-26,707
1890,11,27,817,817,0,1890-11-27,817
1890,11,28,698,698,0,1890-11-28,698
1890,11,29,548,548,0,1890-11-29,548
1890,11,30,415,415,0,1890-11-30,415
1890,12,1,322,322,0,1890-12-1,322
1890,12,2,273,273,0,1890-12-2,273
1890,12,3,226,226,0,1890-12-3,226
1890,12,4,221,221,0,1890-12-4,221
1890,12,5,0,0,0,1890-12-5,0
1890,12,6,0,0,0,1890-12-6,0
1890,12,7,9,0,9,1890-12-7,-9
1890,12,8,16,0,16,1890-12-8,-16
1890,12,9,23,0,23,1890-12-9,-23
1890,12,10,0,0,0,1890-12-10,0
1890,12,11,4,4,0,1890-12-11,4
1890,12,12,0,0,0,1890-12-12,0
1890,12,13,85,0,85,1890-12-13,-85
1890,12,14,140,34,106,1890-12-14,-72
1890,12,15,123,13,110,1890-12-15,-97
1890,12,16,-1,-1,-1,1890-12-16,0
1890,12,17,140,0,140,1890-12-17,-140
1890,12,18,202,27,175,1890-12-18,-148
1890,12,19,229,42,187,1890-12-19,-145
1890,12,20,108,81,27,1890-12-20,54
1890,12,21,38,38,0,1890-12-21,38
1890,12,22,11,11,0,1890-12-22,11
1890,12,23,19,19,0,1890-12-23,19
1890,12,24,9,9,0,1890-12-24,9
1890,12,25,8,8,0,1890-12-25,8
1890,12,26,46,46,0,1890-12-26,46
1890,12,27,38,38,0,1890-12-27,38
1890,12,28,7,7,0,1890-12-28,7
1890,12,29,31,31,0,1890-12-29,31
1890,12,30,10,10,0,1890-12-30,10
1890,12,31,17,17,0,1890-12-31,17
1891,1,1,14,14,0,1891-1-1,14
1891,1,2,18,18,0,1891-1-2,18
1891,1,3,0,0,0,1891-1-3,0
1891,1,4,0,0,0,1891-1-4,0
1891,1,5,0,0,0,1891-1-5,0
1891,1,6,20,20,0,1891-1-6,20
1891,1,7,0,0,0,1891-1-7,0
1891,1,8,0,0,0,1891-1-8,0
1891,1,9,0,0,0,1891-1-9,0
1891,1,10,0,0,0,1891-1-10,0
1891,1,11,0,0,0,1891-1-11,0
1891,1,12,0,0,0,1891-1-12,0
1891,1,13,0,0,0,1891-1-13,0
1891,1,14,0,0,0,1891-1-14,0
1891,1,15,594,0,594,1891-1-15,-594
1891,1,16,390,0,390,1891-1-16,-390
1891,1,17,342,13,329,1891-1-17,-316
1891,1,18,437,0,437,1891-1-18,-437
1891,1,19,416,48,368,1891-1-19,-320
1891,1,20,451,30,421,1891-1-20,-391
1891,1,21,362,21,341,1891-1-21,-320
1891,1,22,385,0,385,1891-1-22,-385
1891,1,23,316,0,316,1891-1-23,-316
1891,1,24,-1,-1,-1,1891-1-24,0
1891,1,25,567,258,309,1891-1-25,-51
1891,1,26,522,268,254,1891-1-26,14
1891,1,27,-1,-1,-1,1891-1-27,0
1891,1,28,701,407,294,1891-1-28,113
1891,1,29,415,359,56,1891-1-29,303
1891,1,30,139,139,0,1891-1-30,139
1891,1,31,51,51,0,1891-1-31,51
1891,2,1,58,58,0,1891-2-1,58
1891,2,2,28,28,0,1891-2-2,28
1891,2,3,29,29,0,1891-2-3,29
1891,2,4,0,0,0,1891-2-4,0
1891,2,5,0,0,0,1891-2-5,0
1891,2,6,24,0,24,1891-2-6,-24
1891,2,7,0,0,0,1891-2-7,0
1891,2,8,0,0,0,1891-2-8,0
1891,2,9,20,0,20,1891-2-9,-20
1891,2,10,190,170,20,1891-2-10,150
1891,2,11,260,202,58,1891-2-11,144
1891,2,12,276,223,53,1891-2-12,170
1891,2,13,299,237,62,1891-2-13,175
1891,2,14,298,213,85,1891-2-14,128
1891,2,15,515,236,279,1891-2-15,-43
1891,2,16,407,290,117,1891-2-16,173
1891,2,17,575,520,55,1891-2-17,465
1891,2,18,603,603,0,1891-2-18,603
1891,2,19,610,604,6,1891-2-19,598
1891,2,20,588,578,10,1891-2-20,568
1891,2,21,605,587,18,1891-2-21,569
1891,2,22,486,470,16,1891-2-22,454
1891,2,23,386,313,73,1891-2-23,240
1891,2,24,391,338,53,1891-2-24,285
1891,2,25,612,612,0,1891-2-25,612
1891,2,26,131,131,0,1891-2-26,131
1891,2,27,48,48,0,1891-2-27,48
1891,2,28,29,29,0,1891-2-28,29
1891,3,1,118,118,0,1891-3-1,118
1891,3,2,51,51,0,1891-3-2,51
1891,3,3,0,0,0,1891-3-3,0
1891,3,4,25,0,25,1891-3-4,-25
1891,3,5,159,123,36,1891-3-5,87
1891,3,6,157,131,26,1891-3-6,105
1891,3,7,136,129,7,1891-3-7,122
1891,3,8,100,100,0,1891-3-8,100
1891,3,9,125,125,0,1891-3-9,125
1891,3,10,79,79,0,1891-3-10,79
1891,3,11,42,42,0,1891-3-11,42
1891,3,12,48,14,34,1891-3-12,-20
1891,3,13,239,239,0,1891-3-13,239
1891,3,14,269,269,0,1891-3-14,269
1891,3,15,212,212,0,1891-3-15,212
1891,3,16,258,258,0,1891-3-16,258
1891,3,17,230,230,0,1891-3-17,230
1891,3,18,306,306,0,1891-3-18,306
1891,3,19,422,422,0,1891-3-19,422
1891,3,20,357,357,0,1891-3-20,357
1891,3,21,201,201,0,1891-3-21,201
1891,3,22,176,176,0,1891-3-22,176
1891,3,23,159,159,0,1891-3-23,159
1891,3,24,152,152,0,1891-3-24,152
1891,3,25,144,144,0,1891-3-25,144
1891,3,26,0,0,0,1891-3-26,0
1891,3,27,0,0,0,1891-3-27,0
1891,3,28,0,0,0,1891-3-28,0
1891,3,29,222,222,0,1891-3-29,222
1891,3,30,228,228,0,1891-3-30,228
1891,3,31,304,274,30,1891-3-31,244
1891,4,1,305,274,31,1891-4-1,243
1891,4,2,313,289,24,1891-4-2,265
1891,4,3,320,314,6,1891-4-3,308
1891,4,4,300,297,3,1891-4-4,294
1891,4,5,267,267,0,1891-4-5,267
1891,4,6,232,232,0,1891-4-6,232
1891,4,7,226,226,0,1891-4-7,226
1891,4,8,230,230,0,1891-4-8,230
1891,4,9,229,229,0,1891-4-9,229
1891,4,10,289,202,87,1891-4-10,115
1891,4,11,76,0,76,1891-4-11,-76
1891,4,12,42,0,42,1891-4-12,-42
1891,4,13,27,0,27,1891-4-13,-27
1891,4,14,107,69,38,1891-4-14,31
1891,4,15,125,118,7,1891-4-15,111
1891,4,16,253,229,24,1891-4-16,205
1891,4,17,257,227,30,1891-4-17,197
1891,4,18,128,78,50,1891-4-18,28
1891,4,19,283,228,55,1891-4-19,173
1891,4,20,83,33,50,1891-4-20,-17
1891,4,21,267,17,250,1891-4-21,-233
1891,4,22,622,30,592,1891-4-22,-562
1891,4,23,781,118,663,1891-4-23,-545
1891,4,24,742,201,541,1891-4-24,-340
1891,4,25,806,289,517,1891-4-25,-228
1891,4,26,819,403,416,1891-4-26,-13
1891,4,27,528,140,388,1891-4-27,-248
1891,4,28,759,398,361,1891-4-28,37
1891,4,29,684,376,308,1891-4-29,68
1891,4,30,531,234,297,1891-4-30,-63
1891,5,1,539,235,304,1891-5-1,-69
1891,5,2,225,5,220,1891-5-2,-215
1891,5,3,28,17,11,1891-5-3,6
1891,5,4,248,58,190,1891-5-4,-132
1891,5,5,391,201,190,1891-5-5,11
1891,5,6,363,124,239,1891-5-6,-115
1891,5,7,455,143,312,1891-5-7,-169
1891,5,8,395,140,255,1891-5-8,-115
1891,5,9,505,154,351,1891-5-9,-197
1891,5,10,517,232,285,1891-5-10,-53
1891,5,11,457,192,265,1891-5-11,-73
1891,5,12,1075,453,622,1891-5-12,-169
1891,5,13,782,283,499,1891-5-13,-216
1891,5,14,568,152,416,1891-5-14,-264
1891,5,15,566,203,363,1891-5-15,-160
1891,5,16,462,183,279,1891-5-16,-96
1891,5,17,307,146,161,1891-5-17,-15
1891,5,18,418,263,155,1891-5-18,108
1891,5,19,754,553,201,1891-5-19,352
1891,5,20,701,568,133,1891-5-20,435
1891,5,21,848,711,137,1891-5-21,574
1891,5,22,958,837,121,1891-5-22,716
1891,5,23,776,705,71,1891-5-23,634
1891,5,24,781,594,187,1891-5-24,407
1891,5,25,979,533,446,1891-5-25,87
1891,5,26,683,288,395,1891-5-26,-107
1891,5,27,667,171,496,1891-5-27,-325
1891,5,28,585,177,408,1891-5-28,-231
1891,5,29,409,92,317,1891-5-29,-225
1891,5,30,356,154,202,1891-5-30,-48
1891,5,31,357,160,197,1891-5-31,-37
1891,6,1,330,180,150,1891-6-1,30
1891,6,2,412,278,134,1891-6-2,144
1891,6,3,263,201,62,1891-6-3,139
1891,6,4,193,171,22,1891-6-4,149
1891,6,5,118,118,0,1891-6-5,118
1891,6,6,147,147,0,1891-6-6,147
1891,6,7,100,100,0,1891-6-7,100
1891,6,8,162,162,0,1891-6-8,162
1891,6,9,210,210,0,1891-6-9,210
1891,6,10,354,354,0,1891-6-10,354
1891,6,11,424,424,0,1891-6-11,424
1891,6,12,322,322,0,1891-6-12,322
1891,6,13,331,331,0,1891-6-13,331
1891,6,14,686,686,0,1891-6-14,686
1891,6,15,843,843,0,1891-6-15,843
1891,6,16,1453,1453,0,1891-6-16,1453
1891,6,17,700,700,0,1891-6-17,700
1891,6,18,577,577,0,1891-6-18,577
1891,6,19,458,458,0,1891-6-19,458
1891,6,20,517,484,33,1891-6-20,451
1891,6,21,801,772,29,1891-6-21,743
1891,6,22,1006,971,35,1891-6-22,936
1891,6,23,921,905,16,1891-6-23,889
1891,6,24,682,637,45,1891-6-24,592
1891,6,25,818,694,124,1891-6-25,570
1891,6,26,1029,596,433,1891-6-26,163
1891,6,27,1088,388,700,1891-6-27,-312
1891,6,28,1098,384,714,1891-6-28,-330
1891,6,29,953,350,603,1891-6-29,-253
1891,6,30,838,322,516,1891-6-30,-194
1891,7,1,1070,535,535,1891-7-1,0
1891,7,2,1006,642,364,1891-7-2,278
1891,7,3,958,631,327,1891-7-3,304
1891,7,4,387,387,0,1891-7-4,387
1891,7,5,305,305,0,1891-7-5,305
1891,7,6,533,533,0,1891-7-6,533
1891,7,7,701,701,0,1891-7-7,701
1891,7,8,869,869,0,1891-7-8,869
1891,7,9,1023,1023,0,1891-7-9,1023
1891,7,10,1068,1068,0,1891-7-10,1068
1891,7,11,1322,1318,4,1891-7-11,1314
1891,7,12,2005,2005,0,1891-7-12,2005
1891,7,13,2102,2070,32,1891-7-13,2038
1891,7,14,2002,1951,51,1891-7-14,1900
1891,7,15,1855,1832,23,1891-7-15,1809
1891,7,16,1730,1730,0,1891-7-16,1730
1891,7,17,1650,1650,0,1891-7-17,1650
1891,7,18,1186,1186,0,1891-7-18,1186
1891,7,19,1436,1427,9,1891-7-19,1418
1891,7,20,2073,1930,143,1891-7-20,1787
1891,7,21,1220,1147,73,1891-7-21,1074
1891,7,22,1435,1312,123,1891-7-22,1189
1891,7,23,1154,1033,121,1891-7-23,912
1891,7,24,861,666,195,1891-7-24,471
1891,7,25,274,111,163,1891-7-25,-52
1891,7,26,67,67,0,1891-7-26,67
1891,7,27,300,185,115,1891-7-27,70
1891,7,28,445,376,69,1891-7-28,307
1891,7,29,316,267,49,1891-7-29,218
1891,7,30,187,154,33,1891-7-30,121
1891,7,31,138,124,14,1891-7-31,110
1891,8,1,192,178,14,1891-8-1,164
1891,8,2,133,86,47,1891-8-2,39
1891,8,3,318,98,220,1891-8-3,-122
1891,8,4,1221,752,469,1891-8-4,283
1891,8,5,1251,625,626,1891-8-5,-1
1891,8,6,1303,505,798,1891-8-6,-293
1891,8,7,1446,488,958,1891-8-7,-470
1891,8,8,1392,492,900,1891-8-8,-408
1891,8,9,1561,437,1124,1891-8-9,-687
1891,8,10,757,509,248,1891-8-10,261
1891,8,11,703,481,222,1891-8-11,259
1891,8,12,660,446,214,1891-8-12,232
1891,8,13,615,417,198,1891-8-13,219
1891,8,14,581,407,174,1891-8-14,233
1891,8,15,564,450,114,1891-8-15,336
1891,8,16,490,490,0,1891-8-16,490
1891,8,17,434,434,0,1891-8-17,434
1891,8,18,539,539,0,1891-8-18,539
1891,8,19,152,152,0,1891-8-19,152
1891,8,20,2,2,0,1891-8-20,2
1891,8,21,16,16,0,1891-8-21,16
1891,8,22,65,65,0,1891-8-22,65
1891,8,23,120,120,0,1891-8-23,120
1891,8,24,139,109,30,1891-8-24,79
1891,8,25,147,95,52,1891-8-25,43
1891,8,26,254,237,17,1891-8-26,220
1891,8,27,52,49,3,1891-8-27,46
1891,8,28,16,2,14,1891-8-28,-12
1891,8,29,240,234,6,1891-8-29,228
1891,8,30,475,475,0,1891-8-30,475
1891,8,31,1233,1233,0,1891-8-31,1233
1891,9,1,1679,1679,0,1891-9-1,1679
1891,9,2,1961,1961,0,1891-9-2,1961
1891,9,3,2172,2172,0,1891-9-3,2172
1891,9,4,2227,2227,0,1891-9-4,2227
1891,9,5,2448,2448,0,1891-9-5,2448
1891,9,6,2388,2388,0,1891-9-6,2388
1891,9,7,2512,2512,0,1891-9-7,2512
1891,9,8,2627,2627,0,1891-9-8,2627
1891,9,9,2340,2340,0,1891-9-9,2340
1891,9,10,2212,2212,0,1891-9-10,2212
1891,9,11,904,904,0,1891-9-11,904
1891,9,12,691,691,0,1891-9-12,691
1891,9,13,687,687,0,1891-9-13,687
1891,9,14,512,512,0,1891-9-14,512
1891,9,15,533,533,0,1891-9-15,533
1891,9,16,697,638,59,1891-9-16,579
1891,9,17,1113,1012,101,1891-9-17,911
1891,9,18,1113,1005,108,1891-9-18,897
1891,9,19,1171,1050,121,1891-9-19,929
1891,9,20,1247,855,392,1891-9-20,463
1891,9,21,1055,533,522,1891-9-21,11
1891,9,22,931,251,680,1891-9-22,-429
1891,9,23,683,8,675,1891-9-23,-667
1891,9,24,1050,410,640,1891-9-24,-230
1891,9,25,1193,644,549,1891-9-25,95
1891,9,26,670,604,66,1891-9-26,538
1891,9,27,555,525,30,1891-9-27,495
1891,9,28,765,492,273,1891-9-28,219
1891,9,29,474,336,138,1891-9-29,198
1891,9,30,433,297,136,1891-9-30,161
1891,10,1,507,350,157,1891-10-1,193
1891,10,2,715,509,206,1891-10-2,303
1891,10,3,673,438,235,1891-10-3,203
1891,10,4,776,470,306,1891-10-4,164
1891,10,5,878,456,422,1891-10-5,34
1891,10,6,939,379,560,1891-10-6,-181
1891,10,7,1257,495,762,1891-10-7,-267
1891,10,8,1514,665,849,1891-10-8,-184
1891,10,9,1477,560,917,1891-10-9,-357
1891,10,10,1379,410,969,1891-10-10,-559
1891,10,11,1157,326,831,1891-10-11,-505
1891,10,12,905,169,736,1891-10-12,-567
1891,10,13,879,241,638,1891-10-13,-397
1891,10,14,426,296,130,1891-10-14,166
1891,10,15,265,265,0,1891-10-15,265
1891,10,16,320,320,0,1891-10-16,320
1891,10,17,330,330,0,1891-10-17,330
1891,10,18,404,404,0,1891-10-18,404
1891,10,19,394,342,52,1891-10-19,290
1891,10,20,351,325,26,1891-10-20,299
1891,10,21,320,307,13,1891-10-21,294
1891,10,22,320,320,0,1891-10-22,320
1891,10,23,433,433,0,1891-10-23,433
1891,10,24,356,356,0,1891-10-24,356
1891,10,25,262,253,9,1891-10-25,244
1891,10,26,237,237,0,1891-10-26,237
1891,10,27,259,259,0,1891-10-27,259
1891,10,28,213,213,0,1891-10-28,213
1891,10,29,270,270,0,1891-10-29,270
1891,10,30,346,346,0,1891-10-30,346
1891,10,31,203,203,0,1891-10-31,203
1891,11,1,299,299,0,1891-11-1,299
1891,11,2,396,396,0,1891-11-2,396
1891,11,3,189,189,0,1891-11-3,189
1891,11,4,419,419,0,1891-11-4,419
1891,11,5,297,297,0,1891-11-5,297
1891,11,6,324,324,0,1891-11-6,324
1891,11,7,318,318,0,1891-11-7,318
1891,11,8,235,231,4,1891-11-8,227
1891,11,9,165,165,0,1891-11-9,165
1891,11,10,183,183,0,1891-11-10,183
1891,11,11,280,280,0,1891-11-11,280
1891,11,12,180,180,0,1891-11-12,180
1891,11,13,126,126,0,1891-11-13,126
1891,11,14,143,117,26,1891-11-14,91
1891,11,15,527,117,410,1891-11-15,-293
1891,11,16,351,84,267,1891-11-16,-183
1891,11,17,392,80,312,1891-11-17,-232
1891,11,18,746,378,368,1891-11-18,10
1891,11,19,839,312,527,1891-11-19,-215
1891,11,20,1284,384,900,1891-11-20,-516
1891,11,21,1514,409,1105,1891-11-21,-696
1891,11,22,1666,405,1261,1891-11-22,-856
1891,11,23,1504,451,1053,1891-11-23,-602
1891,11,24,1449,366,1083,1891-11-24,-717
1891,11,25,1584,501,1083,1891-11-25,-582
1891,11,26,1192,384,808,1891-11-26,-424
1891,11,27,1326,365,961,1891-11-27,-596
1891,11,28,502,502,0,1891-11-28,502
1891,11,29,525,525,0,1891-11-29,525
1891,11,30,167,167,0,1891-11-30,167
1891,12,1,113,113,0,1891-12-1,113
1891,12,2,50,50,0,1891-12-2,50
1891,12,3,39,39,0,1891-12-3,39
1891,12,4,28,28,0,1891-12-4,28
1891,12,5,50,50,0,1891-12-5,50
1891,12,6,102,83,19,1891-12-6,64
1891,12,7,147,69,78,1891-12-7,-9
1891,12,8,159,74,85,1891-12-8,-11
1891,12,9,109,52,57,1891-12-9,-5
1891,12,10,55,19,36,1891-12-10,-17
1891,12,11,43,0,43,1891-12-11,-43
1891,12,12,159,0,159,1891-12-12,-159
1891,12,13,172,0,172,1891-12-13,-172
1891,12,14,129,0,129,1891-12-14,-129
1891,12,15,186,0,186,1891-12-15,-186
1891,12,16,328,100,228,1891-12-16,-128
1891,12,17,606,82,524,1891-12-17,-442
1891,12,18,556,18,538,1891-12-18,-520
1891,12,19,687,36,651,1891-12-19,-615
1891,12,20,554,52,502,1891-12-20,-450
1891,12,21,685,176,509,1891-12-21,-333
1891,12,22,944,328,616,1891-12-22,-288
1891,12,23,1206,682,524,1891-12-23,158
1891,12,24,1338,1089,249,1891-12-24,840
1891,12,25,1270,1161,109,1891-12-25,1052
1891,12,26,1215,1126,89,1891-12-26,1037
1891,12,27,969,928,41,1891-12-27,887
1891,12,28,1220,880,340,1891-12-28,540
1891,12,29,1371,916,455,1891-12-29,461
1891,12,30,1299,618,681,1891-12-30,-63
1891,12,31,988,833,155,1891-12-31,678
1892,1,1,1256,1065,191,1892-1-1,874
1892,1,2,1485,1254,231,1892-1-2,1023
1892,1,3,1187,976,211,1892-1-3,765
1892,1,4,1040,847,193,1892-1-4,654
1892,1,5,1075,878,197,1892-1-5,681
1892,1,6,846,720,126,1892-1-6,594
1892,1,7,644,568,76,1892-1-7,492
1892,1,8,831,469,362,1892-1-8,107
1892,1,9,917,493,424,1892-1-9,69
1892,1,10,624,309,315,1892-1-10,-6
1892,1,11,291,4,287,1892-1-11,-283
1892,1,12,312,0,312,1892-1-12,-312
1892,1,13,523,33,490,1892-1-13,-457
1892,1,14,910,141,769,1892-1-14,-628
1892,1,15,1852,941,911,1892-1-15,30
1892,1,16,1510,851,659,1892-1-16,192
1892,1,17,1553,923,630,1892-1-17,293
1892,1,18,2116,1171,945,1892-1-18,226
1892,1,19,2790,1238,1552,1892-1-19,-314
1892,1,20,2875,1121,1754,1892-1-20,-633
1892,1,21,2240,1229,1011,1892-1-21,218
1892,1,22,1524,1241,283,1892-1-22,958
1892,1,23,1868,1408,460,1892-1-23,948
1892,1,24,1429,1084,345,1892-1-24,739
1892,1,25,1507,1084,423,1892-1-25,661
1892,1,26,1769,1359,410,1892-1-26,949
1892,1,27,1025,682,343,1892-1-27,339
1892,1,28,829,265,564,1892-1-28,-299
1892,1,29,855,266,589,1892-1-29,-323
1892,1,30,546,79,467,1892-1-30,-388
1892,1,31,604,89,515,1892-1-31,-426
1892,2,1,723,269,454,1892-2-1,-185
1892,2,2,471,172,299,1892-2-2,-127
1892,2,3,541,263,278,1892-2-3,-15
1892,2,4,279,181,98,1892-2-4,83
1892,2,5,1860,284,1576,1892-2-5,-1292
1892,2,6,2820,248,2572,1892-2-6,-2324
1892,2,7,2485,51,2434,1892-2-7,-2383
1892,2,8,3185,106,3079,1892-2-8,-2973
1892,2,9,3434,44,3390,1892-2-9,-3346
1892,2,10,3734,38,3696,1892-2-10,-3658
1892,2,11,3800,126,3674,1892-2-11,-3548
1892,2,12,-1,-1,-1,1892-2-12,0
1892,2,13,4905,1377,3528,1892-2-13,-2151
1892,2,14,-1,-1,-1,1892-2-14,0
1892,2,15,4241,1159,3082,1892-2-15,-1923
1892,2,16,3991,1256,2735,1892-2-16,-1479
1892,2,17,2454,713,1741,1892-2-17,-1028
1892,2,18,2664,876,1788,1892-2-18,-912
1892,2,19,1542,1178,364,1892-2-19,814
1892,2,20,1252,1119,133,1892-2-20,986
1892,2,21,995,922,73,1892-2-21,849
1892,2,22,726,726,0,1892-2-22,726
1892,2,23,501,501,0,1892-2-23,501
1892,2,24,599,599,0,1892-2-24,599
1892,2,25,452,452,0,1892-2-25,452
1892,2,26,243,243,0,1892-2-26,243
1892,2,27,99,99,0,1892-2-27,99
1892,2,28,153,34,119,1892-2-28,-85
1892,2,29,129,0,129,1892-2-29,-129
1892,3,1,0,0,0,1892-3-1,0
1892,3,2,46,0,46,1892-3-2,-46
1892,3,3,0,0,0,1892-3-3,0
1892,3,4,450,275,175,1892-3-4,100
1892,3,5,362,118,244,1892-3-5,-126
1892,3,6,435,0,435,1892-3-6,-435
1892,3,7,527,0,527,1892-3-7,-527
1892,3,8,521,0,521,1892-3-8,-521
1892,3,9,940,0,940,1892-3-9,-940
1892,3,10,784,0,784,1892-3-10,-784
1892,3,11,793,0,793,1892-3-11,-793
1892,3,12,604,21,583,1892-3-12,-562
1892,3,13,502,10,492,1892-3-13,-482
1892,3,14,467,80,387,1892-3-14,-307
1892,3,15,419,44,375,1892-3-15,-331
1892,3,16,519,274,245,1892-3-16,29
1892,3,17,1043,360,683,1892-3-17,-323
1892,3,18,777,312,465,1892-3-18,-153
1892,3,19,809,365,444,1892-3-19,-79
1892,3,20,979,587,392,1892-3-20,195
1892,3,21,1305,934,371,1892-3-21,563
1892,3,22,1705,1330,375,1892-3-22,955
1892,3,23,1730,1392,338,1892-3-23,1054
1892,3,24,1872,1384,488,1892-3-24,896
1892,3,25,1398,1008,390,1892-3-25,618
1892,3,26,1258,815,443,1892-3-26,372
1892,3,27,1206,904,302,1892-3-27,602
1892,3,28,734,360,374,1892-3-28,-14
1892,3,29,570,244,326,1892-3-29,-82
1892,3,30,293,213,80,1892-3-30,133
1892,3,31,443,162,281,1892-3-31,-119
1892,4,1,322,118,204,1892-4-1,-86
1892,4,2,342,93,249,1892-4-2,-156
1892,4,3,224,42,182,1892-4-3,-140
1892,4,4,206,40,166,1892-4-4,-126
1892,4,5,218,108,110,1892-4-5,-2
1892,4,6,410,263,147,1892-4-6,116
1892,4,7,359,236,123,1892-4-7,113
1892,4,8,328,233,95,1892-4-8,138
1892,4,9,239,147,92,1892-4-9,55
1892,4,10,299,127,172,1892-4-10,-45
1892,4,11,541,367,174,1892-4-11,193
1892,4,12,579,403,176,1892-4-12,227
1892,4,13,508,414,94,1892-4-13,320
1892,4,14,464,388,76,1892-4-14,312
1892,4,15,433,404,29,1892-4-15,375
1892,4,16,358,280,78,1892-4-16,202
1892,4,17,430,336,94,1892-4-17,242
1892,4,18,647,445,202,1892-4-18,243
1892,4,19,783,519,264,1892-4-19,255
1892,4,20,1083,738,345,1892-4-20,393
1892,4,21,1412,700,712,1892-4-21,-12
1892,4,22,1820,661,1159,1892-4-22,-498
1892,4,23,2674,888,1786,1892-4-23,-898
1892,4,24,2915,946,1969,1892-4-24,-1023
1892,4,25,3258,1364,1894,1892-4-25,-530
1892,4,26,2328,1373,955,1892-4-26,418
1892,4,27,1896,1240,656,1892-4-27,584
1892,4,28,1868,1024,844,1892-4-28,180
1892,4,29,1652,842,810,1892-4-29,32
1892,4,30,1232,445,787,1892-4-30,-342
1892,5,1,1242,143,1099,1892-5-1,-956
1892,5,2,1466,131,1335,1892-5-2,-1204
1892,5,3,1217,178,1039,1892-5-3,-861
1892,5,4,1167,213,954,1892-5-4,-741
1892,5,5,1319,452,867,1892-5-5,-415
1892,5,6,1005,504,501,1892-5-6,3
1892,5,7,1078,484,594,1892-5-7,-110
1892,5,8,765,359,406,1892-5-8,-47
1892,5,9,622,259,363,1892-5-9,-104
1892,5,10,1758,199,1559,1892-5-10,-1360
1892,5,11,1432,194,1238,1892-5-11,-1044
1892,5,12,1389,234,1155,1892-5-12,-921
1892,5,13,1108,231,877,1892-5-13,-646
1892,5,14,1304,571,733,1892-5-14,-162
1892,5,15,1662,643,1019,1892-5-15,-376
1892,5,16,1257,497,760,1892-5-16,-263
1892,5,17,1053,307,746,1892-5-17,-439
1892,5,18,1195,602,593,1892-5-18,9
1892,5,19,1241,710,531,1892-5-19,179
1892,5,20,1250,610,640,1892-5-20,-30
1892,5,21,1400,721,679,1892-5-21,42
1892,5,22,1843,1146,697,1892-5-22,449
1892,5,23,1726,1369,357,1892-5-23,1012
1892,5,24,2463,1255,1208,1892-5-24,47
1892,5,25,2545,1166,1379,1892-5-25,-213
1892,5,26,2144,780,1364,1892-5-26,-584
1892,5,27,2338,628,1710,1892-5-27,-1082
1892,5,28,2273,565,1708,1892-5-28,-1143
1892,5,29,2054,597,1457,1892-5-29,-860
1892,5,30,2274,844,1430,1892-5-30,-586
1892,5,31,2205,702,1503,1892-5-31,-801
1892,6,1,1721,513,1208,1892-6-1,-695
1892,6,2,1636,463,1173,1892-6-2,-710
1892,6,3,1309,372,937,1892-6-3,-565
1892,6,4,942,233,709,1892-6-4,-476
1892,6,5,502,329,173,1892-6-5,156
1892,6,6,368,314,54,1892-6-6,260
1892,6,7,418,412,6,1892-6-7,406
1892,6,8,378,368,10,1892-6-8,358
1892,6,9,339,329,10,1892-6-9,319
1892,6,10,453,453,0,1892-6-10,453
1892,6,11,517,510,7,1892-6-11,503
1892,6,12,214,214,0,1892-6-12,214
1892,6,13,908,819,89,1892-6-13,730
1892,6,14,894,776,118,1892-6-14,658
1892,6,15,595,545,50,1892-6-15,495
1892,6,16,789,739,50,1892-6-16,689
1892,6,17,1611,1164,447,1892-6-17,717
1892,6,18,1959,1268,691,1892-6-18,577
1892,6,19,3169,2317,852,1892-6-19,1465
1892,6,20,3407,2380,1027,1892-6-20,1353
1892,6,21,3243,2016,1227,1892-6-21,789
1892,6,22,2062,1934,128,1892-6-22,1806
1892,6,23,1756,1642,114,1892-6-23,1528
1892,6,24,1111,1004,107,1892-6-24,897
1892,6,25,1188,1100,88,1892-6-25,1012
1892,6,26,979,884,95,1892-6-26,789
1892,6,27,495,445,50,1892-6-27,395
1892,6,28,258,182,76,1892-6-28,106
1892,6,29,244,125,119,1892-6-29,6
1892,6,30,65,38,27,1892-6-30,11
1892,7,1,144,107,37,1892-7-1,70
1892,7,2,116,76,40,1892-7-2,36
1892,7,3,423,63,360,1892-7-3,-297
1892,7,4,1946,1400,546,1892-7-4,854
1892,7,5,2225,1704,521,1892-7-5,1183
1892,7,6,2530,1888,642,1892-7-6,1246
1892,7,7,4000,2532,1468,1892-7-7,1064
1892,7,8,4105,2587,1518,1892-7-8,1069
1892,7,9,4302,2653,1649,1892-7-9,1004
1892,7,10,4275,2746,1529,1892-7-10,1217
1892,7,11,3123,1813,1310,1892-7-11,503
1892,7,12,2763,1595,1168,1892-7-12,427
1892,7,13,2841,1625,1216,1892-7-13,409
1892,7,14,2447,1214,1233,1892-7-14,-19
1892,7,15,2405,1392,1013,1892-7-15,379
1892,7,16,1546,501,1045,1892-7-16,-544
1892,7,17,1362,216,1146,1892-7-17,-930
1892,7,18,1491,349,1142,1892-7-18,-793
1892,7,19,1114,303,811,1892-7-19,-508
1892,7,20,612,261,351,1892-7-20,-90
1892,7,21,374,59,315,1892-7-21,-256
1892,7,22,305,46,259,1892-7-22,-213
1892,7,23,316,19,297,1892-7-23,-278
1892,7,24,375,0,375,1892-7-24,-375
1892,7,25,915,612,303,1892-7-25,309
1892,7,26,1924,1383,541,1892-7-26,842
1892,7,27,2161,1807,354,1892-7-27,1453
1892,7,28,1917,1692,225,1892-7-28,1467
1892,7,29,1959,1703,256,1892-7-29,1447
1892,7,30,2159,1846,313,1892-7-30,1533
1892,7,31,3368,2731,637,1892-7-31,2094
1892,8,1,2889,2392,497,1892-8-1,1895
1892,8,2,2739,2038,701,1892-8-2,1337
1892,8,3,2707,1990,717,1892-8-3,1273
1892,8,4,2738,1889,849,1892-8-4,1040
1892,8,5,2396,1469,927,1892-8-5,542
1892,8,6,1824,941,883,1892-8-6,58
1892,8,7,1434,557,877,1892-8-7,-320
1892,8,8,1445,470,975,1892-8-8,-505
1892,8,9,1464,625,839,1892-8-9,-214
1892,8,10,1594,777,817,1892-8-10,-40
1892,8,11,1749,841,908,1892-8-11,-67
1892,8,12,942,484,458,1892-8-12,26
1892,8,13,1059,636,423,1892-8-13,213
1892,8,14,1440,861,579,1892-8-14,282
1892,8,15,1921,1224,697,1892-8-15,527
1892,8,16,1758,1129,629,1892-8-16,500
1892,8,17,1671,1120,551,1892-8-17,569
1892,8,18,1562,1015,547,1892-8-18,468
1892,8,19,1053,753,300,1892-8-19,453
1892,8,20,1284,915,369,1892-8-20,546
1892,8,21,818,683,135,1892-8-21,548
1892,8,22,985,797,188,1892-8-22,609
1892,8,23,786,608,178,1892-8-23,430
1892,8,24,507,426,81,1892-8-24,345
1892,8,25,422,369,53,1892-8-25,316
1892,8,26,549,483,66,1892-8-26,417
1892,8,27,743,500,243,1892-8-27,257
1892,8,28,786,503,283,1892-8-28,220
1892,8,29,848,602,246,1892-8-29,356
1892,8,30,917,742,175,1892-8-30,567
1892,8,31,1283,1104,179,1892-8-31,925
1892,9,1,1497,1177,320,1892-9-1,857
1892,9,2,1442,1057,385,1892-9-2,672
1892,9,3,1293,876,417,1892-9-3,459
1892,9,4,707,256,451,1892-9-4,-195
1892,9,5,586,249,337,1892-9-5,-88
1892,9,6,470,169,301,1892-9-6,-132
1892,9,7,648,375,273,1892-9-7,102
1892,9,8,601,309,292,1892-9-8,17
1892,9,9,459,286,173,1892-9-9,113
1892,9,10,719,426,293,1892-9-10,133
1892,9,11,1095,466,629,1892-9-11,-163
1892,9,12,1000,460,540,1892-9-12,-80
1892,9,13,887,489,398,1892-9-13,91
1892,9,14,1039,687,352,1892-9-14,335
1892,9,15,791,532,259,1892-9-15,273
1892,9,16,591,513,78,1892-9-16,435
1892,9,17,853,553,300,1892-9-17,253
1892,9,18,1586,1360,226,1892-9-18,1134
1892,9,19,980,769,211,1892-9-19,558
1892,9,20,1039,823,216,1892-9-20,607
1892,9,21,921,793,128,1892-9-21,665
1892,9,22,857,722,135,1892-9-22,587
1892,9,23,783,663,120,1892-9-23,543
1892,9,24,725,609,116,1892-9-24,493
1892,9,25,636,435,201,1892-9-25,234
1892,9,26,985,338,647,1892-9-26,-309
1892,9,27,1841,724,1117,1892-9-27,-393
1892,9,28,1906,539,1367,1892-9-28,-828
1892,9,29,1627,447,1180,1892-9-29,-733
1892,9,30,1518,458,1060,1892-9-30,-602
1892,10,1,1474,375,1099,1892-10-1,-724
1892,10,2,1265,414,851,1892-10-2,-437
1892,10,3,1480,785,695,1892-10-3,90
1892,10,4,1791,1111,680,1892-10-4,431
1892,10,5,1630,994,636,1892-10-5,358
1892,10,6,1748,934,814,1892-10-6,120
1892,10,7,1488,1206,282,1892-10-7,924
1892,10,8,1511,1226,285,1892-10-8,941
1892,10,9,1454,1160,294,1892-10-9,866
1892,10,10,1395,908,487,1892-10-10,421
1892,10,11,818,593,225,1892-10-11,368
1892,10,12,260,65,195,1892-10-12,-130
1892,10,13,160,31,129,1892-10-13,-98
1892,10,14,729,410,319,1892-10-14,91
1892,10,15,613,384,229,1892-10-15,155
1892,10,16,457,229,228,1892-10-16,1
1892,10,17,465,242,223,1892-10-17,19
1892,10,18,312,140,172,1892-10-18,-32
1892,10,19,428,191,237,1892-10-19,-46
1892,10,20,484,135,349,1892-10-20,-214
1892,10,21,573,128,445,1892-10-21,-317
1892,10,22,653,136,517,1892-10-22,-381
1892,10,23,351,114,237,1892-10-23,-123
1892,10,24,148,45,103,1892-10-24,-58
1892,10,25,92,45,47,1892-10-25,-2
1892,10,26,335,319,16,1892-10-26,303
1892,10,27,782,436,346,1892-10-27,90
1892,10,28,1084,260,824,1892-10-28,-564
1892,10,29,1485,221,1264,1892-10-29,-1043
1892,10,30,1339,210,1129,1892-10-30,-919
1892,10,31,1434,221,1213,1892-10-31,-992
1892,11,1,1276,219,1057,1892-11-1,-838
1892,11,2,1000,119,881,1892-11-2,-762
1892,11,3,1334,377,957,1892-11-3,-580
1892,11,4,1561,560,1001,1892-11-4,-441
1892,11,5,1226,505,721,1892-11-5,-216
1892,11,6,988,452,536,1892-11-6,-84
1892,11,7,571,538,33,1892-11-7,505
1892,11,8,801,782,19,1892-11-8,763
1892,11,9,889,870,19,1892-11-9,851
1892,11,10,644,615,29,1892-11-10,586
1892,11,11,635,566,69,1892-11-11,497
1892,11,12,544,532,12,1892-11-12,520
1892,11,13,549,431,118,1892-11-13,313
1892,11,14,349,112,237,1892-11-14,-125
1892,11,15,395,63,332,1892-11-15,-269
1892,11,16,500,175,325,1892-11-16,-150
1892,11,17,641,242,399,1892-11-17,-157
1892,11,18,621,157,464,1892-11-18,-307
1892,11,19,790,109,681,1892-11-19,-572
1892,11,20,800,69,731,1892-11-20,-662
1892,11,21,1112,65,1047,1892-11-21,-982
1892,11,22,1358,10,1348,1892-11-22,-1338
1892,11,23,1220,6,1214,1892-11-23,-1208
1892,11,24,1617,152,1465,1892-11-24,-1313
1892,11,25,1270,0,1270,1892-11-25,-1270
1892,11,26,896,5,891,1892-11-26,-886
1892,11,27,1003,225,778,1892-11-27,-553
1892,11,28,1269,609,660,1892-11-28,-51
1892,11,29,1372,778,594,1892-11-29,184
1892,11,30,1377,971,406,1892-11-30,565
1892,12,1,1213,850,363,1892-12-1,487
1892,12,2,1376,837,539,1892-12-2,298
1892,12,3,1264,679,585,1892-12-3,94
1892,12,4,1206,529,677,1892-12-4,-148
1892,12,5,1541,433,1108,1892-12-5,-675
1892,12,6,1156,354,802,1892-12-6,-448
1892,12,7,813,245,568,1892-12-7,-323
1892,12,8,1147,453,694,1892-12-8,-241
1892,12,9,1397,717,680,1892-12-9,37
1892,12,10,1215,524,691,1892-12-10,-167
1892,12,11,1082,388,694,1892-12-11,-306
1892,12,12,901,417,484,1892-12-12,-67
1892,12,13,640,469,171,1892-12-13,298
1892,12,14,422,336,86,1892-12-14,250
1892,12,15,323,256,67,1892-12-15,189
1892,12,16,229,179,50,1892-12-16,129
1892,12,17,168,88,80,1892-12-17,8
1892,12,18,168,45,123,1892-12-18,-78
1892,12,19,67,0,67,1892-12-19,-67
1892,12,20,39,0,39,1892-12-20,-39
1892,12,21,322,116,206,1892-12-21,-90
1892,12,22,393,104,289,1892-12-22,-185
1892,12,23,346,119,227,1892-12-23,-108
1892,12,24,1187,230,957,1892-12-24,-727
1892,12,25,1518,279,1239,1892-12-25,-960
1892,12,26,1371,138,1233,1892-12-26,-1095
1892,12,27,1200,104,1096,1892-12-27,-992
1892,12,28,1399,64,1335,1892-12-28,-1271
1892,12,29,938,13,925,1892-12-29,-912
1892,12,30,943,0,943,1892-12-30,-943
1892,12,31,845,41,804,1892-12-31,-763
1893,1,1,837,70,767,1893-1-1,-697
1893,1,2,741,159,582,1893-1-2,-423
1893,1,3,624,161,463,1893-1-3,-302
1893,1,4,811,205,606,1893-1-4,-401
1893,1,5,1092,332,760,1893-1-5,-428
1893,1,6,379,307,72,1893-1-6,235
1893,1,7,475,381,94,1893-1-7,287
1893,1,8,298,261,37,1893-1-8,224
1893,1,9,321,321,0,1893-1-9,321
1893,1,10,1028,784,244,1893-1-10,540
1893,1,11,430,194,236,1893-1-11,-42
1893,1,12,402,155,247,1893-1-12,-92
1893,1,13,353,136,217,1893-1-13,-81
1893,1,14,286,130,156,1893-1-14,-26
1893,1,15,242,125,117,1893-1-15,8
1893,1,16,646,90,556,1893-1-16,-466
1893,1,17,706,108,598,1893-1-17,-490
1893,1,18,1350,133,1217,1893-1-18,-1084
1893,1,19,1555,105,1450,1893-1-19,-1345
1893,1,20,1593,102,1491,1893-1-20,-1389
1893,1,21,1672,179,1493,1893-1-21,-1314
1893,1,22,1710,280,1430,1893-1-22,-1150
1893,1,23,1096,171,925,1893-1-23,-754
1893,1,24,1313,238,1075,1893-1-24,-837
1893,1,25,2208,291,1917,1893-1-25,-1626
1893,1,26,2803,718,2085,1893-1-26,-1367
1893,1,27,2771,880,1891,1893-1-27,-1011
1893,1,28,2270,910,1360,1893-1-28,-450
1893,1,29,2127,799,1328,1893-1-29,-529
1893,1,30,2007,751,1256,1893-1-30,-505
1893,1,31,1755,606,1149,1893-1-31,-543
1893,2,1,1989,524,1465,1893-2-1,-941
1893,2,2,1705,402,1303,1893-2-2,-901
1893,2,3,1328,347,981,1893-2-3,-634
1893,2,4,1298,280,1018,1893-2-4,-738
1893,2,5,1410,96,1314,1893-2-5,-1218
1893,2,6,960,46,914,1893-2-6,-868
1893,2,7,707,0,707,1893-2-7,-707
1893,2,8,761,96,665,1893-2-8,-569
1893,2,9,1380,196,1184,1893-2-9,-988
1893,2,10,1117,223,894,1893-2-10,-671
1893,2,11,1089,218,871,1893-2-11,-653
1893,2,12,1557,20,1537,1893-2-12,-1517
1893,2,13,1451,28,1423,1893-2-13,-1395
1893,2,14,1842,12,1830,1893-2-14,-1818
1893,2,15,1928,0,1928,1893-2-15,-1928
1893,2,16,1392,0,1392,1893-2-16,-1392
1893,2,17,1345,0,1345,1893-2-17,-1345
1893,2,18,776,185,591,1893-2-18,-406
1893,2,19,1128,710,418,1893-2-19,292
1893,2,20,1129,757,372,1893-2-20,385
1893,2,21,779,599,180,1893-2-21,419
1893,2,22,970,644,326,1893-2-22,318
1893,2,23,1251,803,448,1893-2-23,355
1893,2,24,1106,850,256,1893-2-24,594
1893,2,25,1199,766,433,1893-2-25,333
1893,2,26,1413,862,551,1893-2-26,311
1893,2,27,1363,937,426,1893-2-27,511
1893,2,28,1572,994,578,1893-2-28,416
1893,3,1,1463,946,517,1893-3-1,429
1893,3,2,1399,752,647,1893-3-2,105
1893,3,3,1141,569,572,1893-3-3,-3
1893,3,4,727,152,575,1893-3-4,-423
1893,3,5,481,67,414,1893-3-5,-347
1893,3,6,-1,-1,-1,1893-3-6,0
1893,3,7,354,84,270,1893-3-7,-186
1893,3,8,455,105,350,1893-3-8,-245
1893,3,9,387,71,316,1893-3-9,-245
1893,3,10,952,38,914,1893-3-10,-876
1893,3,11,752,12,740,1893-3-11,-728
1893,3,12,629,8,621,1893-3-12,-613
1893,3,13,763,14,749,1893-3-13,-735
1893,3,14,687,43,644,1893-3-14,-601
1893,3,15,644,13,631,1893-3-15,-618
1893,3,16,521,0,521,1893-3-16,-521
1893,3,17,682,246,436,1893-3-17,-190
1893,3,18,738,308,430,1893-3-18,-122
1893,3,19,797,354,443,1893-3-19,-89
1893,3,20,1308,816,492,1893-3-20,324
1893,3,21,1333,956,377,1893-3-21,579
1893,3,22,1086,1086,0,1893-3-22,1086
1893,3,23,1152,1099,53,1893-3-23,1046
1893,3,24,1182,1134,48,1893-3-24,1086
1893,3,25,1380,1249,131,1893-3-25,1118
1893,3,26,1562,1300,262,1893-3-26,1038
1893,3,27,1592,932,660,1893-3-27,272
1893,3,28,1137,682,455,1893-3-28,227
1893,3,29,1222,665,557,1893-3-29,108
1893,3,30,1130,697,433,1893-3-30,264
1893,3,31,1232,491,741,1893-3-31,-250
1893,4,1,1018,158,860,1893-4-1,-702
1893,4,2,1077,118,959,1893-4-2,-841
1893,4,3,1009,101,908,1893-4-3,-807
1893,4,4,717,62,655,1893-4-4,-593
1893,4,5,825,22,803,1893-4-5,-781
1893,4,6,869,52,817,1893-4-6,-765
1893,4,7,944,4,940,1893-4-7,-936
1893,4,8,643,5,638,1893-4-8,-633
1893,4,9,680,83,597,1893-4-9,-514
1893,4,10,842,129,713,1893-4-10,-584
1893,4,11,867,131,736,1893-4-11,-605
1893,4,12,1410,168,1242,1893-4-12,-1074
1893,4,13,1450,195,1255,1893-4-13,-1060
1893,4,14,1385,307,1078,1893-4-14,-771
1893,4,15,1330,377,953,1893-4-15,-576
1893,4,16,1312,412,900,1893-4-16,-488
1893,4,17,1194,523,671,1893-4-17,-148
1893,4,18,980,423,557,1893-4-18,-134
1893,4,19,1179,601,578,1893-4-19,23
1893,4,20,1150,482,668,1893-4-20,-186
1893,4,21,1001,459,542,1893-4-21,-83
1893,4,22,1180,676,504,1893-4-22,172
1893,4,23,1886,1196,690,1893-4-23,506
1893,4,24,2021,1688,333,1893-4-24,1355
1893,4,25,2026,1695,331,1893-4-25,1364
1893,4,26,1515,1243,272,1893-4-26,971
1893,4,27,1317,1088,229,1893-4-27,859
1893,4,28,1357,1134,223,1893-4-28,911
1893,4,29,1016,639,377,1893-4-29,262
1893,4,30,1153,627,526,1893-4-30,101
1893,5,1,1690,460,1230,1893-5-1,-770
1893,5,2,1893,502,1391,1893-5-2,-889
1893,5,3,2045,437,1608,1893-5-3,-1171
1893,5,4,2017,377,1640,1893-5-4,-1263
1893,5,5,1812,290,1522,1893-5-5,-1232
1893,5,6,1575,282,1293,1893-5-6,-1011
1893,5,7,1047,67,980,1893-5-7,-913
1893,5,8,1089,160,929,1893-5-8,-769
1893,5,9,933,140,793,1893-5-9,-653
1893,5,10,728,0,728,1893-5-10,-728
1893,5,11,532,7,525,1893-5-11,-518
1893,5,12,561,33,528,1893-5-12,-495
1893,5,13,678,138,540,1893-5-13,-402
1893,5,14,495,75,420,1893-5-14,-345
1893,5,15,534,168,366,1893-5-15,-198
1893,5,16,390,75,315,1893-5-16,-240
1893,5,17,439,64,375,1893-5-17,-311
1893,5,18,602,50,552,1893-5-18,-502
1893,5,19,644,23,621,1893-5-19,-598
1893,5,20,738,164,574,1893-5-20,-410
1893,5,21,768,193,575,1893-5-21,-382
1893,5,22,395,250,145,1893-5-22,105
1893,5,23,566,398,168,1893-5-23,230
1893,5,24,729,536,193,1893-5-24,343
1893,5,25,1492,869,623,1893-5-25,246
1893,5,26,1660,997,663,1893-5-26,334
1893,5,27,1889,999,890,1893-5-27,109
1893,5,28,1927,774,1153,1893-5-28,-379
1893,5,29,2144,823,1321,1893-5-29,-498
1893,5,30,2217,869,1348,1893-5-30,-479
1893,5,31,1788,605,1183,1893-5-31,-578
1893,6,1,1775,431,1344,1893-6-1,-913
1893,6,2,1936,289,1647,1893-6-2,-1358
1893,6,3,2207,342,1865,1893-6-3,-1523
1893,6,4,2130,482,1648,1893-6-4,-1166
1893,6,5,3012,707,2305,1893-6-5,-1598
1893,6,6,2621,590,2031,1893-6-6,-1441
1893,6,7,2701,697,2004,1893-6-7,-1307
1893,6,8,2326,630,1696,1893-6-8,-1066
1893,6,9,2111,482,1629,1893-6-9,-1147
1893,6,10,1136,548,588,1893-6-10,-40
1893,6,11,907,371,536,1893-6-11,-165
1893,6,12,650,199,451,1893-6-12,-252
1893,6,13,665,283,382,1893-6-13,-99
1893,6,14,771,316,455,1893-6-14,-139
1893,6,15,1012,262,750,1893-6-15,-488
1893,6,16,1268,164,1104,1893-6-16,-940
1893,6,17,1445,129,1316,1893-6-17,-1187
1893,6,18,930,123,807,1893-6-18,-684
1893,6,19,814,234,580,1893-6-19,-346
1893,6,20,523,141,382,1893-6-20,-241
1893,6,21,422,392,30,1893-6-21,362
1893,6,22,720,679,41,1893-6-22,638
1893,6,23,1080,942,138,1893-6-23,804
1893,6,24,-1,-1,-1,1893-6-24,0
1893,6,25,1534,665,869,1893-6-25,-204
1893,6,26,1164,0,1164,1893-6-26,-1164
1893,6,27,870,78,792,1893-6-27,-714
1893,6,28,996,143,853,1893-6-28,-710
1893,6,29,1100,58,1042,1893-6-29,-984
1893,6,30,1165,138,1027,1893-6-30,-889
1893,7,1,1071,122,949,1893-7-1,-827
1893,7,2,754,142,612,1893-7-2,-470
1893,7,3,1382,102,1280,1893-7-3,-1178
1893,7,4,1672,48,1624,1893-7-4,-1576
1893,7,5,2009,41,1968,1893-7-5,-1927
1893,7,6,1647,10,1637,1893-7-6,-1627
1893,7,7,2032,268,1764,1893-7-7,-1496
1893,7,8,2896,445,2451,1893-7-8,-2006
1893,7,9,3564,989,2575,1893-7-9,-1586
1893,7,10,3333,917,2416,1893-7-10,-1499
1893,7,11,3610,1369,2241,1893-7-11,-872
1893,7,12,3832,1564,2268,1893-7-12,-704
1893,7,13,3158,1272,1886,1893-7-13,-614
1893,7,14,2717,1229,1488,1893-7-14,-259
1893,7,15,2078,1246,832,1893-7-15,414
1893,7,16,1206,807,399,1893-7-16,408
1893,7,17,1463,1076,387,1893-7-17,689
1893,7,18,1155,1092,63,1893-7-18,1029
1893,7,19,1103,823,280,1893-7-19,543
1893,7,20,1533,937,596,1893-7-20,341
1893,7,21,1046,616,430,1893-7-21,186
1893,7,22,962,551,411,1893-7-22,140
1893,7,23,604,137,467,1893-7-23,-330
1893,7,24,550,204,346,1893-7-24,-142
1893,7,25,503,153,350,1893-7-25,-197
1893,7,26,392,116,276,1893-7-26,-160
1893,7,27,367,84,283,1893-7-27,-199
1893,7,28,303,36,267,1893-7-28,-231
1893,7,29,242,0,242,1893-7-29,-242
1893,7,30,672,111,561,1893-7-30,-450
1893,7,31,931,164,767,1893-7-31,-603
1893,8,1,591,162,429,1893-8-1,-267
1893,8,2,715,147,568,1893-8-2,-421
1893,8,3,1013,127,886,1893-8-3,-759
1893,8,4,2017,455,1562,1893-8-4,-1107
1893,8,5,2955,595,2360,1893-8-5,-1765
1893,8,6,4064,925,3139,1893-8-6,-2214
1893,8,7,5128,1409,3719,1893-8-7,-2310
1893,8,8,4882,1444,3438,1893-8-8,-1994
1893,8,9,4656,1344,3312,1893-8-9,-1968
1893,8,10,4419,1224,3195,1893-8-10,-1971
1893,8,11,4152,1259,2893,1893-8-11,-1634
1893,8,12,3655,1091,2564,1893-8-12,-1473
1893,8,13,2184,252,1932,1893-8-13,-1680
1893,8,14,1304,203,1101,1893-8-14,-898
1893,8,15,1252,154,1098,1893-8-15,-944
1893,8,16,1452,94,1358,1893-8-16,-1264
1893,8,17,1678,84,1594,1893-8-17,-1510
1893,8,18,1971,227,1744,1893-8-18,-1517
1893,8,19,2230,561,1669,1893-8-19,-1108
1893,8,20,2460,591,1869,1893-8-20,-1278
1893,8,21,2174,580,1594,1893-8-21,-1014
1893,8,22,1541,478,1063,1893-8-22,-585
1893,8,23,1509,611,898,1893-8-23,-287
1893,8,24,1396,560,836,1893-8-24,-276
1893,8,25,1351,670,681,1893-8-25,-11
1893,8,26,830,319,511,1893-8-26,-192
1893,8,27,795,387,408,1893-8-27,-21
1893,8,28,2572,991,1581,1893-8-28,-590
1893,8,29,2383,906,1477,1893-8-29,-571
1893,8,30,2553,837,1716,1893-8-30,-879
1893,8,31,2684,852,1832,1893-8-31,-980
1893,9,1,2433,657,1776,1893-9-1,-1119
1893,9,2,2679,666,2013,1893-9-2,-1347
1893,9,3,2677,614,2063,1893-9-3,-1449
1893,9,4,2569,577,1992,1893-9-4,-1415
1893,9,5,2841,630,2211,1893-9-5,-1581
1893,9,6,2706,600,2106,1893-9-6,-1506
1893,9,7,3145,532,2613,1893-9-7,-2081
1893,9,8,3079,515,2564,1893-9-8,-2049
1893,9,9,2376,384,1992,1893-9-9,-1608
1893,9,10,1702,57,1645,1893-9-10,-1588
1893,9,11,1823,74,1749,1893-9-11,-1675
1893,9,12,1467,78,1389,1893-9-12,-1311
1893,9,13,1178,96,1082,1893-9-13,-986
1893,9,14,943,58,885,1893-9-14,-827
1893,9,15,1228,672,556,1893-9-15,116
1893,9,16,1012,520,492,1893-9-16,28
1893,9,17,1074,609,465,1893-9-17,144
1893,9,18,1167,618,549,1893-9-18,69
1893,9,19,1198,648,550,1893-9-19,98
1893,9,20,760,485,275,1893-9-20,210
1893,9,21,686,406,280,1893-9-21,126
1893,9,22,787,468,319,1893-9-22,149
1893,9,23,722,476,246,1893-9-23,230
1893,9,24,1571,1192,379,1893-9-24,813
1893,9,25,1601,1214,387,1893-9-25,827
1893,9,26,1288,984,304,1893-9-26,680
1893,9,27,994,746,248,1893-9-27,498
1893,9,28,744,594,150,1893-9-28,444
1893,9,29,1198,1094,104,1893-9-29,990
1893,9,30,1686,1538,148,1893-9-30,1390
1893,10,1,1622,1508,114,1893-10-1,1394
1893,10,2,1542,1394,148,1893-10-2,1246
1893,10,3,1442,1304,138,1893-10-3,1166
1893,10,4,1683,1352,331,1893-10-4,1021
1893,10,5,1035,674,361,1893-10-5,313
1893,10,6,930,627,303,1893-10-6,324
1893,10,7,805,275,530,1893-10-7,-255
1893,10,8,790,207,583,1893-10-8,-376
1893,10,9,717,152,565,1893-10-9,-413
1893,10,10,729,290,439,1893-10-10,-149
1893,10,11,660,269,391,1893-10-11,-122
1893,10,12,901,502,399,1893-10-12,103
1893,10,13,1075,717,358,1893-10-13,359
1893,10,14,2050,1258,792,1893-10-14,466
1893,10,15,1649,1029,620,1893-10-15,409
1893,10,16,1500,1103,397,1893-10-16,706
1893,10,17,1170,848,322,1893-10-17,526
1893,10,18,1886,871,1015,1893-10-18,-144
1893,10,19,2461,891,1570,1893-10-19,-679
1893,10,20,2785,809,1976,1893-10-20,-1167
1893,10,21,2352,826,1526,1893-10-21,-700
1893,10,22,2413,812,1601,1893-10-22,-789
1893,10,23,2200,608,1592,1893-10-23,-984
1893,10,24,2213,520,1693,1893-10-24,-1173
1893,10,25,2003,415,1588,1893-10-25,-1173
1893,10,26,1913,653,1260,1893-10-26,-607
1893,10,27,1505,569,936,1893-10-27,-367
1893,10,28,1489,623,866,1893-10-28,-243
1893,10,29,1404,547,857,1893-10-29,-310
1893,10,30,1102,368,734,1893-10-30,-366
1893,10,31,597,162,435,1893-10-31,-273
1893,11,1,475,162,313,1893-11-1,-151
1893,11,2,423,167,256,1893-11-2,-89
1893,11,3,174,30,144,1893-11-3,-114
1893,11,4,118,15,103,1893-11-4,-88
1893,11,5,141,11,130,1893-11-5,-119
1893,11,6,121,18,103,1893-11-6,-85
1893,11,7,149,102,47,1893-11-7,55
1893,11,8,261,105,156,1893-11-8,-51
1893,11,9,1312,81,1231,1893-11-9,-1150
1893,11,10,1628,270,1358,1893-11-10,-1088
1893,11,11,1665,516,1149,1893-11-11,-633
1893,11,12,1778,715,1063,1893-11-12,-348
1893,11,13,1261,626,635,1893-11-13,-9
1893,11,14,1601,837,764,1893-11-14,73
1893,11,15,1523,780,743,1893-11-15,37
1893,11,16,1627,627,1000,1893-11-16,-373
1893,11,17,1775,521,1254,1893-11-17,-733
1893,11,18,1849,455,1394,1893-11-18,-939
1893,11,19,2399,610,1789,1893-11-19,-1179
1893,11,20,2421,564,1857,1893-11-20,-1293
1893,11,21,2124,524,1600,1893-11-21,-1076
1893,11,22,2132,589,1543,1893-11-22,-954
1893,11,23,1837,409,1428,1893-11-23,-1019
1893,11,24,2070,571,1499,1893-11-24,-928
1893,11,25,1684,340,1344,1893-11-25,-1004
1893,11,26,1797,470,1327,1893-11-26,-857
1893,11,27,1559,589,970,1893-11-27,-381
1893,11,28,1401,433,968,1893-11-28,-535
1893,11,29,796,796,0,1893-11-29,796
1893,11,30,1281,1281,0,1893-11-30,1281
1893,12,1,2084,2084,0,1893-12-1,2084
1893,12,2,1819,1819,0,1893-12-2,1819
1893,12,3,1869,1869,0,1893-12-3,1869
1893,12,4,1963,1829,134,1893-12-4,1695
1893,12,5,1353,1279,74,1893-12-5,1205
1893,12,6,731,702,29,1893-12-6,673
1893,12,7,647,639,8,1893-12-7,631
1893,12,8,669,667,2,1893-12-8,665
1893,12,9,678,671,7,1893-12-9,664
1893,12,10,962,938,24,1893-12-10,914
1893,12,11,997,700,297,1893-12-11,403
1893,12,12,494,161,333,1893-12-12,-172
1893,12,13,934,128,806,1893-12-13,-678
1893,12,14,1473,383,1090,1893-12-14,-707
1893,12,15,2163,430,1733,1893-12-15,-1303
1893,12,16,2047,392,1655,1893-12-16,-1263
1893,12,17,1922,333,1589,1893-12-17,-1256
1893,12,18,1847,415,1432,1893-12-18,-1017
1893,12,19,2527,806,1721,1893-12-19,-915
1893,12,20,2513,969,1544,1893-12-20,-575
1893,12,21,2389,847,1542,1893-12-21,-695
1893,12,22,3058,1010,2048,1893-12-22,-1038
1893,12,23,3404,1216,2188,1893-12-23,-972
1893,12,24,3637,1185,2452,1893-12-24,-1267
1893,12,25,3582,951,2631,1893-12-25,-1680
1893,12,26,3725,1166,2559,1893-12-26,-1393
1893,12,27,3635,1195,2440,1893-12-27,-1245
1893,12,28,2639,525,2114,1893-12-28,-1589
1893,12,29,2219,427,1792,1893-12-29,-1365
1893,12,30,2850,567,2283,1893-12-30,-1716
1893,12,31,-1,-1,-1,1893-12-31,0
1894,1,1,-1,-1,-1,1894-1-1,0
1894,1,2,1478,41,1437,1894-1-2,-1396
1894,1,3,1999,62,1937,1894-1-3,-1875
1894,1,4,1779,97,1682,1894-1-4,-1585
1894,1,5,1424,310,1114,1894-1-5,-804
1894,1,6,1119,271,848,1894-1-6,-577
1894,1,7,734,321,413,1894-1-7,-92
1894,1,8,543,325,218,1894-1-8,107
1894,1,9,703,300,403,1894-1-9,-103
1894,1,10,526,51,475,1894-1-10,-424
1894,1,11,1075,285,790,1894-1-11,-505
1894,1,12,1303,435,868,1894-1-12,-433
1894,1,13,1233,454,779,1894-1-13,-325
1894,1,14,2001,662,1339,1894-1-14,-677
1894,1,15,2814,985,1829,1894-1-15,-844
1894,1,16,2947,877,2070,1894-1-16,-1193
1894,1,17,3090,835,2255,1894-1-17,-1420
1894,1,18,2976,857,2119,1894-1-18,-1262
1894,1,19,2499,552,1947,1894-1-19,-1395
1894,1,20,2423,590,1833,1894-1-20,-1243
1894,1,21,2350,647,1703,1894-1-21,-1056
1894,1,22,2464,698,1766,1894-1-22,-1068
1894,1,23,1686,723,963,1894-1-23,-240
1894,1,24,1730,779,951,1894-1-24,-172
1894,1,25,1929,989,940,1894-1-25,49
1894,1,26,1534,579,955,1894-1-26,-376
1894,1,27,798,314,484,1894-1-27,-170
1894,1,28,675,246,429,1894-1-28,-183
1894,1,29,497,167,330,1894-1-29,-163
1894,1,30,271,52,219,1894-1-30,-167
1894,1,31,342,50,292,1894-1-31,-242
1894,2,1,261,55,206,1894-2-1,-151
1894,2,2,659,250,409,1894-2-2,-159
1894,2,3,748,317,431,1894-2-3,-114
1894,2,4,880,383,497,1894-2-4,-114
1894,2,5,1217,618,599,1894-2-5,19
1894,2,6,1309,344,965,1894-2-6,-621
1894,2,7,1434,421,1013,1894-2-7,-592
1894,2,8,1154,307,847,1894-2-8,-540
1894,2,9,750,248,502,1894-2-9,-254
1894,2,10,1115,341,774,1894-2-10,-433
1894,2,11,812,443,369,1894-2-11,74
1894,2,12,816,436,380,1894-2-12,56
1894,2,13,872,522,350,1894-2-13,172
1894,2,14,673,427,246,1894-2-14,181
1894,2,15,1089,410,679,1894-2-15,-269
1894,2,16,1819,402,1417,1894-2-16,-1015
1894,2,17,2261,368,1893,1894-2-17,-1525
1894,2,18,2423,316,2107,1894-2-18,-1791
1894,2,19,2861,392,2469,1894-2-19,-2077
1894,2,20,2711,310,2401,1894-2-20,-2091
1894,2,21,2844,255,2589,1894-2-21,-2334
1894,2,22,2707,324,2383,1894-2-22,-2059
1894,2,23,1941,90,1851,1894-2-23,-1761
1894,2,24,2143,96,2047,1894-2-24,-1951
1894,2,25,1920,75,1845,1894-2-25,-1770
1894,2,26,1697,80,1617,1894-2-26,-1537
1894,2,27,1360,21,1339,1894-2-27,-1318
1894,2,28,1138,3,1135,1894-2-28,-1132
1894,3,1,1236,0,1236,1894-3-1,-1236
1894,3,2,343,0,343,1894-3-2,-343
1894,3,3,205,0,205,1894-3-3,-205
1894,3,4,65,35,30,1894-3-4,5
1894,3,5,172,76,96,1894-3-5,-20
1894,3,6,312,214,98,1894-3-6,116
1894,3,7,479,363,116,1894-3-7,247
1894,3,8,451,352,99,1894-3-8,253
1894,3,9,471,366,105,1894-3-9,261
1894,3,10,824,491,333,1894-3-10,158
1894,3,11,1054,665,389,1894-3-11,276
1894,3,12,772,499,273,1894-3-12,226
1894,3,13,732,485,247,1894-3-13,238
1894,3,14,918,570,348,1894-3-14,222
1894,3,15,673,452,221,1894-3-15,231
1894,3,16,494,318,176,1894-3-16,142
1894,3,17,348,266,82,1894-3-17,184
1894,3,18,256,213,43,1894-3-18,170
1894,3,19,116,32,84,1894-3-19,-52
1894,3,20,389,319,70,1894-3-20,249
1894,3,21,671,616,55,1894-3-21,561
1894,3,22,654,649,5,1894-3-22,644
1894,3,23,635,580,55,1894-3-23,525
1894,3,24,517,512,5,1894-3-24,507
1894,3,25,507,507,0,1894-3-25,507
1894,3,26,400,400,0,1894-3-26,400
1894,3,27,522,447,75,1894-3-27,372
1894,3,28,812,698,114,1894-3-28,584
1894,3,29,994,864,130,1894-3-29,734
1894,3,30,1449,1312,137,1894-3-30,1175
1894,3,31,1859,1662,197,1894-3-31,1465
1894,4,1,2142,2001,141,1894-4-1,1860
1894,4,2,2211,2011,200,1894-4-2,1811
1894,4,3,2415,2193,222,1894-4-3,1971
1894,4,4,2352,2215,137,1894-4-4,2078
1894,4,5,2094,2002,92,1894-4-5,1910
1894,4,6,2144,1957,187,1894-4-6,1770
1894,4,7,1872,1510,362,1894-4-7,1148
1894,4,8,1513,946,567,1894-4-8,379
1894,4,9,1497,1026,471,1894-4-9,555
1894,4,10,1501,970,531,1894-4-10,439
1894,4,11,1399,1004,395,1894-4-11,609
1894,4,12,1163,932,231,1894-4-12,701
1894,4,13,934,750,184,1894-4-13,566
1894,4,14,1201,759,442,1894-4-14,317
1894,4,15,1146,676,470,1894-4-15,206
1894,4,16,1465,969,496,1894-4-16,473
1894,4,17,537,0,537,1894-4-17,-537
1894,4,18,455,0,455,1894-4-18,-455
1894,4,19,720,0,720,1894-4-19,-720
1894,4,20,655,0,655,1894-4-20,-655
1894,4,21,866,0,866,1894-4-21,-866
1894,4,22,1402,549,853,1894-4-22,-304
1894,4,23,1815,551,1264,1894-4-23,-713
1894,4,24,2047,475,1572,1894-4-24,-1097
1894,4,25,2026,529,1497,1894-4-25,-968
1894,4,26,2392,470,1922,1894-4-26,-1452
1894,4,27,2225,468,1757,1894-4-27,-1289
1894,4,28,2022,454,1568,1894-4-28,-1114
1894,4,29,2005,434,1571,1894-4-29,-1137
1894,4,30,1893,420,1473,1894-4-30,-1053
1894,5,1,1989,642,1347,1894-5-1,-705
1894,5,2,1805,936,869,1894-5-2,67
1894,5,3,1938,1150,788,1894-5-3,362
1894,5,4,1529,785,744,1894-5-4,41
1894,5,5,1057,430,627,1894-5-5,-197
1894,5,6,825,322,503,1894-5-6,-181
1894,5,7,779,288,491,1894-5-7,-203
1894,5,8,774,268,506,1894-5-8,-238
1894,5,9,573,325,248,1894-5-9,77
1894,5,10,618,396,222,1894-5-10,174
1894,5,11,512,420,92,1894-5-11,328
1894,5,12,505,331,174,1894-5-12,157
1894,5,13,1811,829,982,1894-5-13,-153
1894,5,14,1313,25,1288,1894-5-14,-1263
1894,5,15,1780,54,1726,1894-5-15,-1672
1894,5,16,2234,119,2115,1894-5-16,-1996
1894,5,17,2005,82,1923,1894-5-17,-1841
1894,5,18,2594,50,2544,1894-5-18,-2494
1894,5,19,3395,53,3342,1894-5-19,-3289
1894,5,20,4047,15,4032,1894-5-20,-4017
1894,5,21,4341,0,4341,1894-5-21,-4341
1894,5,22,4376,0,4376,1894-5-22,-4376
1894,5,23,2058,0,2058,1894-5-23,-2058
1894,5,24,1736,17,1719,1894-5-24,-1702
1894,5,25,1831,697,1134,1894-5-25,-437
1894,5,26,1088,655,433,1894-5-26,222
1894,5,27,1923,1486,437,1894-5-27,1049
1894,5,28,1530,1154,376,1894-5-28,778
1894,5,29,1443,1084,359,1894-5-29,725
1894,5,30,1412,1123,289,1894-5-30,834
1894,5,31,1330,1061,269,1894-5-31,792
1894,6,1,1223,1079,144,1894-6-1,935
1894,6,2,1257,1085,172,1894-6-2,913
1894,6,3,1344,1208,136,1894-6-3,1072
1894,6,4,1575,1183,392,1894-6-4,791
1894,6,5,1020,701,319,1894-6-5,382
1894,6,6,1531,746,785,1894-6-6,-39
1894,6,7,1449,734,715,1894-6-7,19
1894,6,8,1056,202,854,1894-6-8,-652
1894,6,9,1122,172,950,1894-6-9,-778
1894,6,10,1357,149,1208,1894-6-10,-1059
1894,6,11,2444,1449,995,1894-6-11,454
1894,6,12,1222,400,822,1894-6-12,-422
1894,6,13,1555,875,680,1894-6-13,195
1894,6,14,2317,836,1481,1894-6-14,-645
1894,6,15,2690,723,1967,1894-6-15,-1244
1894,6,16,2522,638,1884,1894-6-16,-1246
1894,6,17,2977,733,2244,1894-6-17,-1511
1894,6,18,3922,1465,2457,1894-6-18,-992
1894,6,19,4132,2079,2053,1894-6-19,26
1894,6,20,3877,2050,1827,1894-6-20,223
1894,6,21,3858,1977,1881,1894-6-21,96
1894,6,22,3814,2042,1772,1894-6-22,270
1894,6,23,2165,629,1536,1894-6-23,-907
1894,6,24,1630,584,1046,1894-6-24,-462
1894,6,25,1573,648,925,1894-6-25,-277
1894,6,26,608,513,95,1894-6-26,418
1894,6,27,574,511,63,1894-6-27,448
1894,6,28,685,472,213,1894-6-28,259
1894,6,29,802,434,368,1894-6-29,66
1894,6,30,650,387,263,1894-6-30,124
1894,7,1,643,484,159,1894-7-1,325
1894,7,2,537,440,97,1894-7-2,343
1894,7,3,886,480,406,1894-7-3,74
1894,7,4,1174,476,698,1894-7-4,-222
1894,7,5,1196,581,615,1894-7-5,-34
1894,7,6,1507,958,549,1894-7-6,409
1894,7,7,1813,1185,628,1894-7-7,557
1894,7,8,1996,1367,629,1894-7-8,738
1894,7,9,1740,1188,552,1894-7-9,636
1894,7,10,1656,1085,571,1894-7-10,514
1894,7,11,2131,929,1202,1894-7-11,-273
1894,7,12,2738,921,1817,1894-7-12,-896
1894,7,13,2878,914,1964,1894-7-13,-1050
1894,7,14,2798,1107,1691,1894-7-14,-584
1894,7,15,2386,808,1578,1894-7-15,-770
1894,7,16,2294,865,1429,1894-7-16,-564
1894,7,17,2852,1610,1242,1894-7-17,368
1894,7,18,2706,1560,1146,1894-7-18,414
1894,7,19,2305,1264,1041,1894-7-19,223
1894,7,20,1793,976,817,1894-7-20,159
1894,7,21,2186,1189,997,1894-7-21,192
1894,7,22,2255,1217,1038,1894-7-22,179
1894,7,23,1830,1053,777,1894-7-23,276
1894,7,24,1586,1025,561,1894-7-24,464
1894,7,25,1422,861,561,1894-7-25,300
1894,7,26,1236,722,514,1894-7-26,208
1894,7,27,1090,539,551,1894-7-27,-12
1894,7,28,876,461,415,1894-7-28,46
1894,7,29,1032,586,446,1894-7-29,140
1894,7,30,1178,780,398,1894-7-30,382
1894,7,31,1239,1013,226,1894-7-31,787
1894,8,1,1503,1207,296,1894-8-1,911
1894,8,2,1577,1250,327,1894-8-2,923
1894,8,3,1459,1013,446,1894-8-3,567
1894,8,4,1064,946,118,1894-8-4,828
1894,8,5,838,764,74,1894-8-5,690
1894,8,6,658,619,39,1894-8-6,580
1894,8,7,1033,744,289,1894-8-7,455
1894,8,8,1278,824,454,1894-8-8,370
1894,8,9,1559,856,703,1894-8-9,153
1894,8,10,1474,701,773,1894-8-10,-72
1894,8,11,2161,1464,697,1894-8-11,767
1894,8,12,1646,1013,633,1894-8-12,380
1894,8,13,1786,1237,549,1894-8-13,688
1894,8,14,1934,1582,352,1894-8-14,1230
1894,8,15,1938,1665,273,1894-8-15,1392
1894,8,16,2293,1910,383,1894-8-16,1527
1894,8,17,2288,1924,364,1894-8-17,1560
1894,8,18,1909,1653,256,1894-8-18,1397
1894,8,19,1623,1426,197,1894-8-19,1229
1894,8,20,1466,1328,138,1894-8-20,1190
1894,8,21,1408,1303,105,1894-8-21,1198
1894,8,22,1029,963,66,1894-8-22,897
1894,8,23,203,185,18,1894-8-23,167
1894,8,24,27,9,18,1894-8-24,-9
1894,8,25,10,10,0,1894-8-25,10
1894,8,26,163,97,66,1894-8-26,31
1894,8,27,279,147,132,1894-8-27,15
1894,8,28,401,249,152,1894-8-28,97
1894,8,29,277,196,81,1894-8-29,115
1894,8,30,411,341,70,1894-8-30,271
1894,8,31,406,348,58,1894-8-31,290
1894,9,1,448,380,68,1894-9-1,312
1894,9,2,415,365,50,1894-9-2,315
1894,9,3,374,310,64,1894-9-3,246
1894,9,4,307,179,128,1894-9-4,51
1894,9,5,303,79,224,1894-9-5,-145
1894,9,6,966,510,456,1894-9-6,54
1894,9,7,1091,589,502,1894-9-7,87
1894,9,8,1244,615,629,1894-9-8,-14
1894,9,9,1222,580,642,1894-9-9,-62
1894,9,10,1170,530,640,1894-9-10,-110
1894,9,11,1133,520,613,1894-9-11,-93
1894,9,12,1172,435,737,1894-9-12,-302
1894,9,13,1017,411,606,1894-9-13,-195
1894,9,14,856,424,432,1894-9-14,-8
1894,9,15,1175,485,690,1894-9-15,-205
1894,9,16,891,329,562,1894-9-16,-233
1894,9,17,796,352,444,1894-9-17,-92
1894,9,18,715,418,297,1894-9-18,121
1894,9,19,470,184,286,1894-9-19,-102
1894,9,20,409,182,227,1894-9-20,-45
1894,9,21,287,134,153,1894-9-21,-19
1894,9,22,305,152,153,1894-9-22,-1
1894,9,23,331,226,105,1894-9-23,121
1894,9,24,259,197,62,1894-9-24,135
1894,9,25,202,191,11,1894-9-25,180
1894,9,26,111,111,0,1894-9-26,111
1894,9,27,271,271,0,1894-9-27,271
1894,9,28,384,231,153,1894-9-28,78
1894,9,29,920,228,692,1894-9-29,-464
1894,9,30,742,261,481,1894-9-30,-220
1894,10,1,610,163,447,1894-10-1,-284
1894,10,2,1536,209,1327,1894-10-2,-1118
1894,10,3,2381,474,1907,1894-10-3,-1433
1894,10,4,2641,579,2062,1894-10-4,-1483
1894,10,5,3177,506,2671,1894-10-5,-2165
1894,10,6,3277,740,2537,1894-10-6,-1797
1894,10,7,2955,853,2102,1894-10-7,-1249
1894,10,8,2587,823,1764,1894-10-8,-941
1894,10,9,2323,789,1534,1894-10-9,-745
1894,10,10,2062,720,1342,1894-10-10,-622
1894,10,11,1824,745,1079,1894-10-11,-334
1894,10,12,1728,859,869,1894-10-12,-10
1894,10,13,1787,933,854,1894-10-13,79
1894,10,14,1471,816,655,1894-10-14,161
1894,10,15,906,518,388,1894-10-15,130
1894,10,16,674,337,337,1894-10-16,0
1894,10,17,241,16,225,1894-10-17,-209
1894,10,18,196,92,104,1894-10-18,-12
1894,10,19,387,164,223,1894-10-19,-59
1894,10,20,473,237,236,1894-10-20,1
1894,10,21,466,246,220,1894-10-21,26
1894,10,22,405,218,187,1894-10-22,31
1894,10,23,366,177,189,1894-10-23,-12
1894,10,24,207,74,133,1894-10-24,-59
1894,10,25,268,52,216,1894-10-25,-164
1894,10,26,230,14,216,1894-10-26,-202
1894,10,27,222,58,164,1894-10-27,-106
1894,10,28,665,544,121,1894-10-28,423
1894,10,29,633,473,160,1894-10-29,313
1894,10,30,685,561,124,1894-10-30,437
1894,10,31,680,631,49,1894-10-31,582
1894,11,1,459,454,5,1894-11-1,449
1894,11,2,504,443,61,1894-11-2,382
1894,11,3,895,459,436,1894-11-3,23
1894,11,4,767,385,382,1894-11-4,3
1894,11,5,696,328,368,1894-11-5,-40
1894,11,6,697,411,286,1894-11-6,125
1894,11,7,716,334,382,1894-11-7,-48
1894,11,8,966,303,663,1894-11-8,-360
1894,11,9,857,274,583,1894-11-9,-309
1894,11,10,706,143,563,1894-11-10,-420
1894,11,11,512,90,422,1894-11-11,-332
1894,11,12,581,158,423,1894-11-12,-265
1894,11,13,469,176,293,1894-11-13,-117
1894,11,14,558,287,271,1894-11-14,16
1894,11,15,392,249,143,1894-11-15,106
1894,11,16,227,191,36,1894-11-16,155
1894,11,17,177,171,6,1894-11-17,165
1894,11,18,246,137,109,1894-11-18,28
1894,11,19,304,102,202,1894-11-19,-100
1894,11,20,346,238,108,1894-11-20,130
1894,11,21,424,279,145,1894-11-21,134
1894,11,22,697,227,470,1894-11-22,-243
1894,11,23,741,128,613,1894-11-23,-485
1894,11,24,738,139,599,1894-11-24,-460
1894,11,25,706,110,596,1894-11-25,-486
1894,11,26,661,163,498,1894-11-26,-335
1894,11,27,759,199,560,1894-11-27,-361
1894,11,28,373,203,170,1894-11-28,33
1894,11,29,402,135,267,1894-11-29,-132
1894,11,30,986,120,866,1894-11-30,-746
1894,12,1,1026,268,758,1894-12-1,-490
1894,12,2,1310,341,969,1894-12-2,-628
1894,12,3,1429,370,1059,1894-12-3,-689
1894,12,4,1696,733,963,1894-12-4,-230
1894,12,5,2220,1172,1048,1894-12-5,124
1894,12,6,2110,1316,794,1894-12-6,522
1894,12,7,657,192,465,1894-12-7,-273
1894,12,8,829,258,571,1894-12-8,-313
1894,12,9,714,164,550,1894-12-9,-386
1894,12,10,513,67,446,1894-12-10,-379
1894,12,11,564,24,540,1894-12-11,-516
1894,12,12,662,14,648,1894-12-12,-634
1894,12,13,1082,11,1071,1894-12-13,-1060
1894,12,14,1025,10,1015,1894-12-14,-1005
1894,12,15,1351,23,1328,1894-12-15,-1305
1894,12,16,1758,0,1758,1894-12-16,-1758
1894,12,17,1217,0,1217,1894-12-17,-1217
1894,12,18,1281,67,1214,1894-12-18,-1147
1894,12,19,1217,39,1178,1894-12-19,-1139
1894,12,20,1265,35,1230,1894-12-20,-1195
1894,12,21,1270,88,1182,1894-12-21,-1094
1894,12,22,925,112,813,1894-12-22,-701
1894,12,23,875,158,717,1894-12-23,-559
1894,12,24,731,189,542,1894-12-24,-353
1894,12,25,721,183,538,1894-12-25,-355
1894,12,26,828,166,662,1894-12-26,-496
1894,12,27,247,216,31,1894-12-27,185
1894,12,28,645,573,72,1894-12-28,501
1894,12,29,594,558,36,1894-12-29,522
1894,12,30,518,496,22,1894-12-30,474
1894,12,31,914,392,522,1894-12-31,-130
1895,1,1,894,380,514,1895-1-1,-134
1895,1,2,1066,530,536,1895-1-2,-6
1895,1,3,963,444,519,1895-1-3,-75
1895,1,4,825,334,491,1895-1-4,-157
1895,1,5,916,476,440,1895-1-5,36
1895,1,6,754,398,356,1895-1-6,42
1895,1,7,-1,-1,-1,1895-1-7,0
1895,1,8,605,284,321,1895-1-8,-37
1895,1,9,574,118,456,1895-1-9,-338
1895,1,10,685,265,420,1895-1-10,-155
1895,1,11,722,288,434,1895-1-11,-146
1895,1,12,727,248,479,1895-1-12,-231
1895,1,13,339,178,161,1895-1-13,17
1895,1,14,140,0,140,1895-1-14,-140
1895,1,15,192,14,178,1895-1-15,-164
1895,1,16,145,0,145,1895-1-16,-145
1895,1,17,361,280,81,1895-1-17,199
1895,1,18,638,633,5,1895-1-18,628
1895,1,19,895,832,63,1895-1-19,769
1895,1,20,841,776,65,1895-1-20,711
1895,1,21,747,486,261,1895-1-21,225
1895,1,22,952,510,442,1895-1-22,68
1895,1,23,1087,500,587,1895-1-23,-87
1895,1,24,945,398,547,1895-1-24,-149
1895,1,25,1064,452,612,1895-1-25,-160
1895,1,26,1266,424,842,1895-1-26,-418
1895,1,27,1456,377,1079,1895-1-27,-702
1895,1,28,1984,576,1408,1895-1-28,-832
1895,1,29,2354,912,1442,1895-1-29,-530
1895,1,30,2140,553,1587,1895-1-30,-1034
1895,1,31,1982,540,1442,1895-1-31,-902
1895,2,1,1886,566,1320,1895-2-1,-754
1895,2,2,1204,560,644,1895-2-2,-84
1895,2,3,1740,1208,532,1895-2-3,676
1895,2,4,1593,1324,269,1895-2-4,1055
1895,2,5,1198,1055,143,1895-2-5,912
1895,2,6,972,972,0,1895-2-6,972
1895,2,7,901,888,13,1895-2-7,875
1895,2,8,917,911,6,1895-2-8,905
1895,2,9,1131,848,283,1895-2-9,565
1895,2,10,823,586,237,1895-2-10,349
1895,2,11,720,435,285,1895-2-11,150
1895,2,12,962,596,366,1895-2-12,230
1895,2,13,833,560,273,1895-2-13,287
1895,2,14,678,435,243,1895-2-14,192
1895,2,15,579,18,561,1895-2-15,-543
1895,2,16,629,122,507,1895-2-16,-385
1895,2,17,582,114,468,1895-2-17,-354
1895,2,18,703,148,555,1895-2-18,-407
1895,2,19,642,87,555,1895-2-19,-468
1895,2,20,631,76,555,1895-2-20,-479
1895,2,21,640,131,509,1895-2-21,-378
1895,2,22,527,150,377,1895-2-22,-227
1895,2,23,488,215,273,1895-2-23,-58
1895,2,24,742,334,408,1895-2-24,-74
1895,2,25,851,360,491,1895-2-25,-131
1895,2,26,1041,488,553,1895-2-26,-65
1895,2,27,1193,812,381,1895-2-27,431
1895,2,28,1432,1080,352,1895-2-28,728
1895,3,1,1524,1014,510,1895-3-1,504
1895,3,2,1317,923,394,1895-3-2,529
1895,3,3,1132,793,339,1895-3-3,454
1895,3,4,1017,622,395,1895-3-4,227
1895,3,5,991,604,387,1895-3-5,217
1895,3,6,1322,1083,239,1895-3-6,844
1895,3,7,1073,859,214,1895-3-7,645
1895,3,8,1005,847,158,1895-3-8,689
1895,3,9,1000,885,115,1895-3-9,770
1895,3,10,1000,958,42,1895-3-10,916
1895,3,11,1056,900,156,1895-3-11,744
1895,3,12,928,688,240,1895-3-12,448
1895,3,13,881,625,256,1895-3-13,369
1895,3,14,878,587,291,1895-3-14,296
1895,3,15,919,557,362,1895-3-15,195
1895,3,16,867,511,356,1895-3-16,155
1895,3,17,846,615,231,1895-3-17,384
1895,3,18,983,699,284,1895-3-18,415
1895,3,19,1179,700,479,1895-3-19,221
1895,3,20,877,149,728,1895-3-20,-579
1895,3,21,1264,174,1090,1895-3-21,-916
1895,3,22,1592,222,1370,1895-3-22,-1148
1895,3,23,1421,43,1378,1895-3-23,-1335
1895,3,24,1274,44,1230,1895-3-24,-1186
1895,3,25,1109,35,1074,1895-3-25,-1039
1895,3,26,837,68,769,1895-3-26,-701
1895,3,27,560,102,458,1895-3-27,-356
1895,3,28,503,277,226,1895-3-28,51
1895,3,29,756,494,262,1895-3-29,232
1895,3,30,632,490,142,1895-3-30,348
1895,3,31,815,646,169,1895-3-31,477
1895,4,1,791,643,148,1895-4-1,495
1895,4,2,796,655,141,1895-4-2,514
1895,4,3,549,455,94,1895-4-3,361
1895,4,4,611,508,103,1895-4-4,405
1895,4,5,837,543,294,1895-4-5,249
1895,4,6,425,87,338,1895-4-6,-251
1895,4,7,373,87,286,1895-4-7,-199
1895,4,8,444,192,252,1895-4-8,-60
1895,4,9,559,396,163,1895-4-9,233
1895,4,10,858,479,379,1895-4-10,100
1895,4,11,1234,911,323,1895-4-11,588
1895,4,12,1193,834,359,1895-4-12,475
1895,4,13,1082,709,373,1895-4-13,336
1895,4,14,783,572,211,1895-4-14,361
1895,4,15,708,563,145,1895-4-15,418
1895,4,16,792,518,274,1895-4-16,244
1895,4,17,887,513,374,1895-4-17,139
1895,4,18,705,446,259,1895-4-18,187
1895,4,19,804,598,206,1895-4-19,392
1895,4,20,1411,1244,167,1895-4-20,1077
1895,4,21,1976,1841,135,1895-4-21,1706
1895,4,22,1976,1830,146,1895-4-22,1684
1895,4,23,1350,1334,16,1895-4-23,1318
1895,4,24,1597,1350,247,1895-4-24,1103
1895,4,25,1559,1322,237,1895-4-25,1085
1895,4,26,1645,1420,225,1895-4-26,1195
1895,4,27,1646,1449,197,1895-4-27,1252
1895,4,28,1611,1389,222,1895-4-28,1167
1895,4,29,1563,1258,305,1895-4-29,953
1895,4,30,1470,1145,325,1895-4-30,820
1895,5,1,809,596,213,1895-5-1,383
1895,5,2,941,467,474,1895-5-2,-7
1895,5,3,457,116,341,1895-5-3,-225
1895,5,4,368,31,337,1895-5-4,-306
1895,5,5,482,19,463,1895-5-5,-444
1895,5,6,358,0,358,1895-5-6,-358
1895,5,7,429,91,338,1895-5-7,-247
1895,5,8,369,19,350,1895-5-8,-331
1895,5,9,280,34,246,1895-5-9,-212
1895,5,10,261,52,209,1895-5-10,-157
1895,5,11,240,22,218,1895-5-11,-196
1895,5,12,454,17,437,1895-5-12,-420
1895,5,13,513,196,317,1895-5-13,-121
1895,5,14,367,178,189,1895-5-14,-11
1895,5,15,469,401,68,1895-5-15,333
1895,5,16,572,467,105,1895-5-16,362
1895,5,17,438,387,51,1895-5-17,336
1895,5,18,803,723,80,1895-5-18,643
1895,5,19,968,864,104,1895-5-19,760
1895,5,20,952,896,56,1895-5-20,840
1895,5,21,1265,937,328,1895-5-21,609
1895,5,22,1623,1185,438,1895-5-22,747
1895,5,23,1487,1104,383,1895-5-23,721
1895,5,24,1694,1201,493,1895-5-24,708
1895,5,25,2114,1625,489,1895-5-25,1136
1895,5,26,2091,1662,429,1895-5-26,1233
1895,5,27,2136,1697,439,1895-5-27,1258
1895,5,28,1913,1610,303,1895-5-28,1307
1895,5,29,1790,1514,276,1895-5-29,1238
1895,5,30,702,434,268,1895-5-30,166
1895,5,31,611,355,256,1895-5-31,99
1895,6,1,365,294,71,1895-6-1,223
1895,6,2,632,199,433,1895-6-2,-234
1895,6,3,624,136,488,1895-6-3,-352
1895,6,4,575,126,449,1895-6-4,-323
1895,6,5,777,85,692,1895-6-5,-607
1895,6,6,1035,45,990,1895-6-6,-945
1895,6,7,1036,19,1017,1895-6-7,-998
1895,6,8,1237,21,1216,1895-6-8,-1195
1895,6,9,1237,62,1175,1895-6-9,-1113
1895,6,10,1688,275,1413,1895-6-10,-1138
1895,6,11,1319,255,1064,1895-6-11,-809
1895,6,12,1264,314,950,1895-6-12,-636
1895,6,13,1752,777,975,1895-6-13,-198
1895,6,14,1684,837,847,1895-6-14,-10
1895,6,15,1843,1023,820,1895-6-15,203
1895,6,16,2066,1377,689,1895-6-16,688
1895,6,17,1939,1430,509,1895-6-17,921
1895,6,18,1416,1320,96,1895-6-18,1224
1895,6,19,1764,1655,109,1895-6-19,1546
1895,6,20,1580,1495,85,1895-6-20,1410
1895,6,21,1641,1573,68,1895-6-21,1505
1895,6,22,1674,1636,38,1895-6-22,1598
1895,6,23,949,887,62,1895-6-23,825
1895,6,24,739,661,78,1895-6-24,583
1895,6,25,639,498,141,1895-6-25,357
1895,6,26,675,521,154,1895-6-26,367
1895,6,27,441,331,110,1895-6-27,221
1895,6,28,454,346,108,1895-6-28,238
1895,6,29,801,570,231,1895-6-29,339
1895,6,30,458,250,208,1895-6-30,42
1895,7,1,365,103,262,1895-7-1,-159
1895,7,2,536,80,456,1895-7-2,-376
1895,7,3,464,113,351,1895-7-3,-238
1895,7,4,309,78,231,1895-7-4,-153
1895,7,5,269,59,210,1895-7-5,-151
1895,7,6,184,29,155,1895-7-6,-126
1895,7,7,496,205,291,1895-7-7,-86
1895,7,8,600,187,413,1895-7-8,-226
1895,7,9,1048,240,808,1895-7-9,-568
1895,7,10,1126,150,976,1895-7-10,-826
1895,7,11,1173,182,991,1895-7-11,-809
1895,7,12,1305,221,1084,1895-7-12,-863
1895,7,13,1235,96,1139,1895-7-13,-1043
1895,7,14,1257,101,1156,1895-7-14,-1055
1895,7,15,546,68,478,1895-7-15,-410
1895,7,16,334,41,293,1895-7-16,-252
1895,7,17,296,8,288,1895-7-17,-280
1895,7,18,274,9,265,1895-7-18,-256
1895,7,19,130,0,130,1895-7-19,-130
1895,7,20,192,55,137,1895-7-20,-82
1895,7,21,202,111,91,1895-7-21,20
1895,7,22,286,213,73,1895-7-22,140
1895,7,23,116,57,59,1895-7-23,-2
1895,7,24,73,37,36,1895-7-24,1
1895,7,25,18,0,18,1895-7-25,-18
1895,7,26,52,13,39,1895-7-26,-26
1895,7,27,170,31,139,1895-7-27,-108
1895,7,28,142,27,115,1895-7-28,-88
1895,7,29,388,21,367,1895-7-29,-346
1895,7,30,242,0,242,1895-7-30,-242
1895,7,31,592,38,554,1895-7-31,-516
1895,8,1,1028,271,757,1895-8-1,-486
1895,8,2,1339,283,1056,1895-8-2,-773
1895,8,3,1595,341,1254,1895-8-3,-913
1895,8,4,2017,792,1225,1895-8-4,-433
1895,8,5,1999,842,1157,1895-8-5,-315
1895,8,6,2774,1417,1357,1895-8-6,60
1895,8,7,2564,1536,1028,1895-8-7,508
1895,8,8,2618,1733,885,1895-8-8,848
1895,8,9,2245,1709,536,1895-8-9,1173
1895,8,10,1867,1664,203,1895-8-10,1461
1895,8,11,1725,1653,72,1895-8-11,1581
1895,8,12,1730,1673,57,1895-8-12,1616
1895,8,13,1065,1025,40,1895-8-13,985
1895,8,14,1068,1051,17,1895-8-14,1034
1895,8,15,1092,1092,0,1895-8-15,1092
1895,8,16,1016,1008,8,1895-8-16,1000
1895,8,17,1355,1292,63,1895-8-17,1229
1895,8,18,1245,1237,8,1895-8-18,1229
1895,8,19,1420,1420,0,1895-8-19,1420
1895,8,20,1070,1070,0,1895-8-20,1070
1895,8,21,1037,1037,0,1895-8-21,1037
1895,8,22,646,646,0,1895-8-22,646
1895,8,23,668,634,34,1895-8-23,600
1895,8,24,925,618,307,1895-8-24,311
1895,8,25,840,461,379,1895-8-25,82
1895,8,26,561,353,208,1895-8-26,145
1895,8,27,901,701,200,1895-8-27,501
1895,8,28,977,718,259,1895-8-28,459
1895,8,29,1172,802,370,1895-8-29,432
1895,8,30,1104,730,374,1895-8-30,356
1895,8,31,994,735,259,1895-8-31,476
1895,9,1,1037,706,331,1895-9-1,375
1895,9,2,1062,834,228,1895-9-2,606
1895,9,3,976,751,225,1895-9-3,526
1895,9,4,836,721,115,1895-9-4,606
1895,9,5,798,702,96,1895-9-5,606
1895,9,6,966,857,109,1895-9-6,748
1895,9,7,989,958,31,1895-9-7,927
1895,9,8,905,845,60,1895-9-8,785
1895,9,9,764,704,60,1895-9-9,644
1895,9,10,320,213,107,1895-9-10,106
1895,9,11,177,125,52,1895-9-11,73
1895,9,12,60,39,21,1895-9-12,18
1895,9,13,279,258,21,1895-9-13,237
1895,9,14,583,574,9,1895-9-14,565
1895,9,15,595,595,0,1895-9-15,595
1895,9,16,667,342,325,1895-9-16,17
1895,9,17,525,217,308,1895-9-17,-91
1895,9,18,467,183,284,1895-9-18,-101
1895,9,19,350,62,288,1895-9-19,-226
1895,9,20,435,31,404,1895-9-20,-373
1895,9,21,421,27,394,1895-9-21,-367
1895,9,22,569,33,536,1895-9-22,-503
1895,9,23,670,47,623,1895-9-23,-576
1895,9,24,704,409,295,1895-9-24,114
1895,9,25,799,547,252,1895-9-25,295
1895,9,26,1151,936,215,1895-9-26,721
1895,9,27,1467,1033,434,1895-9-27,599
1895,9,28,1955,990,965,1895-9-28,25
1895,9,29,2274,1017,1257,1895-9-29,-240
1895,9,30,2150,1035,1115,1895-9-30,-80
1895,10,1,2390,1285,1105,1895-10-1,180
1895,10,2,3436,1701,1735,1895-10-2,-34
1895,10,3,2606,1109,1497,1895-10-3,-388
1895,10,4,2470,1124,1346,1895-10-4,-222
1895,10,5,2506,1231,1275,1895-10-5,-44
1895,10,6,2375,1073,1302,1895-10-6,-229
1895,10,7,871,592,279,1895-10-7,313
1895,10,8,648,473,175,1895-10-8,298
1895,10,9,493,344,149,1895-10-9,195
1895,10,10,422,318,104,1895-10-10,214
1895,10,11,215,176,39,1895-10-11,137
1895,10,12,152,103,49,1895-10-12,54
1895,10,13,105,55,50,1895-10-13,5
1895,10,14,154,141,13,1895-10-14,128
1895,10,15,165,112,53,1895-10-15,59
1895,10,16,119,100,19,1895-10-16,81
1895,10,17,107,97,10,1895-10-17,87
1895,10,18,71,71,0,1895-10-18,71
1895,10,19,78,78,0,1895-10-19,78
1895,10,20,292,292,0,1895-10-20,292
1895,10,21,729,707,22,1895-10-21,685
1895,10,22,1819,1364,455,1895-10-22,909
1895,10,23,1551,1184,367,1895-10-23,817
1895,10,24,2244,1866,378,1895-10-24,1488
1895,10,25,1980,1606,374,1895-10-25,1232
1895,10,26,2059,1678,381,1895-10-26,1297
1895,10,27,1858,1509,349,1895-10-27,1160
1895,10,28,1672,1359,313,1895-10-28,1046
1895,10,29,1696,1441,255,1895-10-29,1186
1895,10,30,1460,1206,254,1895-10-30,952
1895,10,31,1444,1192,252,1895-10-31,940
1895,11,1,1564,1300,264,1895-11-1,1036
1895,11,2,1819,1488,331,1895-11-2,1157
1895,11,3,1586,1515,71,1895-11-3,1444
1895,11,4,2081,2011,70,1895-11-4,1941
1895,11,5,1860,1769,91,1895-11-5,1678
1895,11,6,1271,1198,73,1895-11-6,1125
1895,11,7,1131,1030,101,1895-11-7,929
1895,11,8,673,615,58,1895-11-8,557
1895,11,9,454,454,0,1895-11-9,454
1895,11,10,6,6,0,1895-11-10,6
1895,11,11,23,23,0,1895-11-11,23
1895,11,12,29,10,19,1895-11-12,-9
1895,11,13,271,56,215,1895-11-13,-159
1895,11,14,725,98,627,1895-11-14,-529
1895,11,15,717,72,645,1895-11-15,-573
1895,11,16,597,55,542,1895-11-16,-487
1895,11,17,638,69,569,1895-11-17,-500
1895,11,18,575,10,565,1895-11-18,-555
1895,11,19,560,27,533,1895-11-19,-506
1895,11,20,618,115,503,1895-11-20,-388
1895,11,21,564,70,494,1895-11-21,-424
1895,11,22,667,212,455,1895-11-22,-243
1895,11,23,577,155,422,1895-11-23,-267
1895,11,24,480,94,386,1895-11-24,-292
1895,11,25,580,291,289,1895-11-25,2
1895,11,26,573,244,329,1895-11-26,-85
1895,11,27,316,220,96,1895-11-27,124
1895,11,28,266,193,73,1895-11-28,120
1895,11,29,271,203,68,1895-11-29,135
1895,11,30,182,154,28,1895-11-30,126
1895,12,1,143,128,15,1895-12-1,113
1895,12,2,274,123,151,1895-12-2,-28
1895,12,3,485,164,321,1895-12-3,-157
1895,12,4,413,174,239,1895-12-4,-65
1895,12,5,439,140,299,1895-12-5,-159
1895,12,6,485,112,373,1895-12-6,-261
1895,12,7,816,297,519,1895-12-7,-222
1895,12,8,856,327,529,1895-12-8,-202
1895,12,9,1051,391,660,1895-12-9,-269
1895,12,10,1113,494,619,1895-12-10,-125
1895,12,11,1078,492,586,1895-12-11,-94
1895,12,12,941,518,423,1895-12-12,95
1895,12,13,1006,662,344,1895-12-13,318
1895,12,14,928,582,346,1895-12-14,236
1895,12,15,636,455,181,1895-12-15,274
1895,12,16,921,692,229,1895-12-16,463
1895,12,17,889,638,251,1895-12-17,387
1895,12,18,859,622,237,1895-12-18,385
1895,12,19,973,508,465,1895-12-19,43
1895,12,20,1137,217,920,1895-12-20,-703
1895,12,21,2026,239,1787,1895-12-21,-1548
1895,12,22,2178,196,1982,1895-12-22,-1786
1895,12,23,1932,198,1734,1895-12-23,-1536
1895,12,24,1893,212,1681,1895-12-24,-1469
1895,12,25,1890,201,1689,1895-12-25,-1488
1895,12,26,1581,230,1351,1895-12-26,-1121
1895,12,27,1535,434,1101,1895-12-27,-667
1895,12,28,1002,307,695,1895-12-28,-388
1895,12,29,914,306,608,1895-12-29,-302
1895,12,30,896,304,592,1895-12-30,-288
1895,12,31,861,288,573,1895-12-31,-285
1896,1,1,902,257,645,1896-1-1,-388
1896,1,2,415,242,173,1896-1-2,69
1896,1,3,255,247,8,1896-1-3,239
1896,1,4,318,295,23,1896-1-4,272
1896,1,5,317,310,7,1896-1-5,303
1896,1,6,458,366,92,1896-1-6,274
1896,1,7,241,178,63,1896-1-7,115
1896,1,8,381,118,263,1896-1-8,-145
1896,1,9,424,122,302,1896-1-9,-180
1896,1,10,562,93,469,1896-1-10,-376
1896,1,11,62,62,0,1896-1-11,62
1896,1,12,30,0,30,1896-1-12,-30
1896,1,13,83,12,71,1896-1-13,-59
1896,1,14,45,16,29,1896-1-14,-13
1896,1,15,16,0,16,1896-1-15,-16
1896,1,16,115,0,115,1896-1-16,-115
1896,1,17,123,0,123,1896-1-17,-123
1896,1,18,208,0,208,1896-1-18,-208
1896,1,19,209,0,209,1896-1-19,-209
1896,1,20,207,0,207,1896-1-20,-207
1896,1,21,210,0,210,1896-1-21,-210
1896,1,22,194,0,194,1896-1-22,-194
1896,1,23,181,0,181,1896-1-23,-181
1896,1,24,301,0,301,1896-1-24,-301
1896,1,25,388,0,388,1896-1-25,-388
1896,1,26,342,4,338,1896-1-26,-334
1896,1,27,356,17,339,1896-1-27,-322
1896,1,28,476,7,469,1896-1-28,-462
1896,1,29,423,44,379,1896-1-29,-335
1896,1,30,266,20,246,1896-1-30,-226
1896,1,31,328,112,216,1896-1-31,-104
1896,2,1,426,221,205,1896-2-1,16
1896,2,2,512,265,247,1896-2-2,18
1896,2,3,848,144,704,1896-2-3,-560
1896,2,4,1564,183,1381,1896-2-4,-1198
1896,2,5,924,208,716,1896-2-5,-508
1896,2,6,263,127,136,1896-2-6,-9
1896,2,7,216,95,121,1896-2-7,-26
1896,2,8,191,68,123,1896-2-8,-55
1896,2,9,88,34,54,1896-2-9,-20
1896,2,10,68,38,30,1896-2-10,8
1896,2,11,100,90,10,1896-2-11,80
1896,2,12,185,171,14,1896-2-12,157
1896,2,13,247,225,22,1896-2-13,203
1896,2,14,-1,-1,-1,1896-2-14,0
1896,2,15,512,512,0,1896-2-15,512
1896,2,16,467,467,0,1896-2-16,467
1896,2,17,183,183,0,1896-2-17,183
1896,2,18,283,283,0,1896-2-18,283
1896,2,19,996,454,542,1896-2-19,-88
1896,2,20,1396,611,785,1896-2-20,-174
1896,2,21,1754,877,877,1896-2-21,0
1896,2,22,1759,807,952,1896-2-22,-145
1896,2,23,2081,1058,1023,1896-2-23,35
1896,2,24,1772,922,850,1896-2-24,72
1896,2,25,1680,924,756,1896-2-25,168
1896,2,26,1765,978,787,1896-2-26,191
1896,2,27,1716,905,811,1896-2-27,94
1896,2,28,1747,828,919,1896-2-28,-91
1896,2,29,1457,589,868,1896-2-29,-279
1896,3,1,1337,74,1263,1896-3-1,-1189
1896,3,2,1250,71,1179,1896-3-2,-1108
1896,3,3,919,49,870,1896-3-3,-821
1896,3,4,1052,48,1004,1896-3-4,-956
1896,3,5,1110,17,1093,1896-3-5,-1076
1896,3,6,818,9,809,1896-3-6,-800
1896,3,7,784,13,771,1896-3-7,-758
1896,3,8,844,24,820,1896-3-8,-796
1896,3,9,481,14,467,1896-3-9,-453
1896,3,10,495,0,495,1896-3-10,-495
1896,3,11,152,0,152,1896-3-11,-152
1896,3,12,113,0,113,1896-3-12,-113
1896,3,13,173,0,173,1896-3-13,-173
1896,3,14,69,0,69,1896-3-14,-69
1896,3,15,162,8,154,1896-3-15,-146
1896,3,16,39,39,0,1896-3-16,39
1896,3,17,34,34,0,1896-3-17,34
1896,3,18,141,105,36,1896-3-18,69
1896,3,19,120,62,58,1896-3-19,4
1896,3,20,128,56,72,1896-3-20,-16
1896,3,21,77,29,48,1896-3-21,-19
1896,3,22,137,0,137,1896-3-22,-137
1896,3,23,298,0,298,1896-3-23,-298
1896,3,24,273,0,273,1896-3-24,-273
1896,3,25,368,136,232,1896-3-25,-96
1896,3,26,722,620,102,1896-3-26,518
1896,3,27,910,885,25,1896-3-27,860
1896,3,28,934,905,29,1896-3-28,876
1896,3,29,848,839,9,1896-3-29,830
1896,3,30,1081,803,278,1896-3-30,525
1896,3,31,983,690,293,1896-3-31,397
1896,4,1,1034,726,308,1896-4-1,418
1896,4,2,690,481,209,1896-4-2,272
1896,4,3,721,481,240,1896-4-3,241
1896,4,4,613,381,232,1896-4-4,149
1896,4,5,761,513,248,1896-4-5,265
1896,4,6,1040,820,220,1896-4-6,600
1896,4,7,912,748,164,1896-4-7,584
1896,4,8,1132,1000,132,1896-4-8,868
1896,4,9,1025,885,140,1896-4-9,745
1896,4,10,930,789,141,1896-4-10,648
1896,4,11,840,737,103,1896-4-11,634
1896,4,12,571,571,0,1896-4-12,571
1896,4,13,536,536,0,1896-4-13,536
1896,4,14,19,19,0,1896-4-14,19
1896,4,15,0,0,0,1896-4-15,0
1896,4,16,0,0,0,1896-4-16,0
1896,4,17,0,0,0,1896-4-17,0
1896,4,18,10,0,10,1896-4-18,-10
1896,4,19,138,0,138,1896-4-19,-138
1896,4,20,109,0,109,1896-4-20,-109
1896,4,21,185,12,173,1896-4-21,-161
1896,4,22,112,24,88,1896-4-22,-64
1896,4,23,256,84,172,1896-4-23,-88
1896,4,24,134,88,46,1896-4-24,42
1896,4,25,271,240,31,1896-4-25,209
1896,4,26,262,229,33,1896-4-26,196
1896,4,27,199,150,49,1896-4-27,101
1896,4,28,116,88,28,1896-4-28,60
1896,4,29,24,17,7,1896-4-29,10
1896,4,30,65,27,38,1896-4-30,-11
1896,5,1,29,0,29,1896-5-1,-29
1896,5,2,68,0,68,1896-5-2,-68
1896,5,3,126,0,126,1896-5-3,-126
1896,5,4,147,0,147,1896-5-4,-147
1896,5,5,267,0,267,1896-5-5,-267
1896,5,6,198,0,198,1896-5-6,-198
1896,5,7,124,0,124,1896-5-7,-124
1896,5,8,78,0,78,1896-5-8,-78
1896,5,9,25,0,25,1896-5-9,-25
1896,5,10,67,0,67,1896-5-10,-67
1896,5,11,62,19,43,1896-5-11,-24
1896,5,12,19,0,19,1896-5-12,-19
1896,5,13,10,0,10,1896-5-13,-10
1896,5,14,19,0,19,1896-5-14,-19
1896,5,15,2,0,2,1896-5-15,-2
1896,5,16,0,0,0,1896-5-16,0
1896,5,17,0,0,0,1896-5-17,0
1896,5,18,41,0,41,1896-5-18,-41
1896,5,19,35,0,35,1896-5-19,-35
1896,5,20,78,12,66,1896-5-20,-54
1896,5,21,93,0,93,1896-5-21,-93
1896,5,22,226,0,226,1896-5-22,-226
1896,5,23,155,0,155,1896-5-23,-155
1896,5,24,56,0,56,1896-5-24,-56
1896,5,25,43,11,32,1896-5-25,-21
1896,5,26,152,19,133,1896-5-26,-114
1896,5,27,138,9,129,1896-5-27,-120
1896,5,28,452,0,452,1896-5-28,-452
1896,5,29,820,0,820,1896-5-29,-820
1896,5,30,903,0,903,1896-5-30,-903
1896,5,31,1182,0,1182,1896-5-31,-1182
1896,6,1,1112,0,1112,1896-6-1,-1112
1896,6,2,1071,0,1071,1896-6-2,-1071
1896,6,3,1287,0,1287,1896-6-3,-1287
1896,6,4,899,0,899,1896-6-4,-899
1896,6,5,536,6,530,1896-6-5,-524
1896,6,6,497,7,490,1896-6-6,-483
1896,6,7,462,5,457,1896-6-7,-452
1896,6,8,495,0,495,1896-6-8,-495
1896,6,9,724,0,724,1896-6-9,-724
1896,6,10,1019,0,1019,1896-6-10,-1019
1896,6,11,976,0,976,1896-6-11,-976
1896,6,12,1171,0,1171,1896-6-12,-1171
1896,6,13,1236,12,1224,1896-6-13,-1212
1896,6,14,1120,0,1120,1896-6-14,-1120
1896,6,15,1139,64,1075,1896-6-15,-1011
1896,6,16,1036,39,997,1896-6-16,-958
1896,6,17,753,12,741,1896-6-17,-729
1896,6,18,613,15,598,1896-6-18,-583
1896,6,19,410,23,387,1896-6-19,-364
1896,6,20,445,61,384,1896-6-20,-323
1896,6,21,204,204,0,1896-6-21,204
1896,6,22,662,457,205,1896-6-22,252
1896,6,23,1112,573,539,1896-6-23,34
1896,6,24,1244,569,675,1896-6-24,-106
1896,6,25,1339,607,732,1896-6-25,-125
1896,6,26,1277,515,762,1896-6-26,-247
1896,6,27,862,270,592,1896-6-27,-322
1896,6,28,599,208,391,1896-6-28,-183
1896,6,29,226,60,166,1896-6-29,-106
1896,6,30,92,0,92,1896-6-30,-92
1896,7,1,179,37,142,1896-7-1,-105
1896,7,2,205,14,191,1896-7-2,-177
1896,7,3,223,22,201,1896-7-3,-179
1896,7,4,211,9,202,1896-7-4,-193
1896,7,5,123,7,116,1896-7-5,-109
1896,7,6,344,7,337,1896-7-6,-330
1896,7,7,361,63,298,1896-7-7,-235
1896,7,8,283,27,256,1896-7-8,-229
1896,7,9,193,10,183,1896-7-9,-173
1896,7,10,186,0,186,1896-7-10,-186
1896,7,11,83,0,83,1896-7-11,-83
1896,7,12,89,14,75,1896-7-12,-61
1896,7,13,614,0,614,1896-7-13,-614
1896,7,14,947,16,931,1896-7-14,-915
1896,7,15,1100,205,895,1896-7-15,-690
1896,7,16,1218,338,880,1896-7-16,-542
1896,7,17,1208,445,763,1896-7-17,-318
1896,7,18,1377,462,915,1896-7-18,-453
1896,7,19,1207,363,844,1896-7-19,-481
1896,7,20,1098,299,799,1896-7-20,-500
1896,7,21,979,239,740,1896-7-21,-501
1896,7,22,867,135,732,1896-7-22,-597
1896,7,23,698,44,654,1896-7-23,-610
1896,7,24,844,0,844,1896-7-24,-844
1896,7,25,567,0,567,1896-7-25,-567
1896,7,26,203,0,203,1896-7-26,-203
1896,7,27,138,0,138,1896-7-27,-138
1896,7,28,153,0,153,1896-7-28,-153
1896,7,29,80,0,80,1896-7-29,-80
1896,7,30,61,0,61,1896-7-30,-61
1896,7,31,77,0,77,1896-7-31,-77
1896,8,1,113,0,113,1896-8-1,-113
1896,8,2,105,0,105,1896-8-2,-105
1896,8,3,112,0,112,1896-8-3,-112
1896,8,4,74,0,74,1896-8-4,-74
1896,8,5,75,0,75,1896-8-5,-75
1896,8,6,12,0,12,1896-8-6,-12
1896,8,7,0,0,0,1896-8-7,0
1896,8,8,0,0,0,1896-8-8,0
1896,8,9,292,0,292,1896-8-9,-292
1896,8,10,-1,-1,-1,1896-8-10,0
1896,8,11,262,0,262,1896-8-11,-262
1896,8,12,278,0,278,1896-8-12,-278
1896,8,13,360,94,266,1896-8-13,-172
1896,8,14,383,110,273,1896-8-14,-163
1896,8,15,471,81,390,1896-8-15,-309
1896,8,16,485,83,402,1896-8-16,-319
1896,8,17,485,69,416,1896-8-17,-347
1896,8,18,450,71,379,1896-8-18,-308
1896,8,19,280,28,252,1896-8-19,-224
1896,8,20,210,8,202,1896-8-20,-194
1896,8,21,239,50,189,1896-8-21,-139
1896,8,22,177,161,16,1896-8-22,145
1896,8,23,158,158,0,1896-8-23,158
1896,8,24,255,255,0,1896-8-24,255
1896,8,25,261,261,0,1896-8-25,261
1896,8,26,141,121,20,1896-8-26,101
1896,8,27,322,112,210,1896-8-27,-98
1896,8,28,318,0,318,1896-8-28,-318
1896,8,29,424,0,424,1896-8-29,-424
1896,8,30,756,0,756,1896-8-30,-756
1896,8,31,709,0,709,1896-8-31,-709
1896,9,1,715,0,715,1896-9-1,-715
1896,9,2,544,0,544,1896-9-2,-544
1896,9,3,561,0,561,1896-9-3,-561
1896,9,4,627,0,627,1896-9-4,-627
1896,9,5,127,9,118,1896-9-5,-109
1896,9,6,89,0,89,1896-9-6,-89
1896,9,7,150,0,150,1896-9-7,-150
1896,9,8,233,0,233,1896-9-8,-233
1896,9,9,664,67,597,1896-9-9,-530
1896,9,10,1604,602,1002,1896-9-10,-400
1896,9,11,3433,2534,899,1896-9-11,1635
1896,9,12,3076,2451,625,1896-9-12,1826
1896,9,13,2111,2039,72,1896-9-13,1967
1896,9,14,2224,2111,113,1896-9-14,1998
1896,9,15,1872,1872,0,1896-9-15,1872
1896,9,16,2101,2101,0,1896-9-16,2101
1896,9,17,2244,2241,3,1896-9-17,2238
1896,9,18,2441,2441,0,1896-9-18,2441
1896,9,19,2331,2033,298,1896-9-19,1735
1896,9,20,2177,1554,623,1896-9-20,931
1896,9,21,1838,1007,831,1896-9-21,176
1896,9,22,1252,540,712,1896-9-22,-172
1896,9,23,747,57,690,1896-9-23,-633
1896,9,24,570,31,539,1896-9-24,-508
1896,9,25,440,10,430,1896-9-25,-420
1896,9,26,358,0,358,1896-9-26,-358
1896,9,27,311,0,311,1896-9-27,-311
1896,9,28,233,0,233,1896-9-28,-233
1896,9,29,227,0,227,1896-9-29,-227
1896,9,30,178,0,178,1896-9-30,-178
1896,10,1,29,0,29,1896-10-1,-29
1896,10,2,29,0,29,1896-10-2,-29
1896,10,3,23,0,23,1896-10-3,-23
1896,10,4,18,0,18,1896-10-4,-18
1896,10,5,0,0,0,1896-10-5,0
1896,10,6,185,185,0,1896-10-6,185
1896,10,7,128,128,0,1896-10-7,128
1896,10,8,78,78,0,1896-10-8,78
1896,10,9,95,95,0,1896-10-9,95
1896,10,10,95,95,0,1896-10-10,95
1896,10,11,82,82,0,1896-10-11,82
1896,10,12,51,51,0,1896-10-12,51
1896,10,13,28,28,0,1896-10-13,28
1896,10,14,63,19,44,1896-10-14,-25
1896,10,15,101,3,98,1896-10-15,-95
1896,10,16,142,0,142,1896-10-16,-142
1896,10,17,541,0,541,1896-10-17,-541
1896,10,18,792,239,553,1896-10-18,-314
1896,10,19,928,243,685,1896-10-19,-442
1896,10,20,943,280,663,1896-10-20,-383
1896,10,21,671,220,451,1896-10-21,-231
1896,10,22,624,203,421,1896-10-22,-218
1896,10,23,614,206,408,1896-10-23,-202
1896,10,24,953,174,779,1896-10-24,-605
1896,10,25,699,150,549,1896-10-25,-399
1896,10,26,554,89,465,1896-10-26,-376
1896,10,27,427,45,382,1896-10-27,-337
1896,10,28,164,0,164,1896-10-28,-164
1896,10,29,131,0,131,1896-10-29,-131
1896,10,30,147,0,147,1896-10-30,-147
1896,10,31,78,0,78,1896-10-31,-78
1896,11,1,36,0,36,1896-11-1,-36
1896,11,2,15,0,15,1896-11-2,-15
1896,11,3,1011,0,1011,1896-11-3,-1011
1896,11,4,1031,0,1031,1896-11-4,-1031
1896,11,5,902,0,902,1896-11-5,-902
1896,11,6,911,6,905,1896-11-6,-899
1896,11,7,1036,0,1036,1896-11-7,-1036
1896,11,8,1040,0,1040,1896-11-8,-1040
1896,11,9,1102,0,1102,1896-11-9,-1102
1896,11,10,1418,0,1418,1896-11-10,-1418
1896,11,11,1725,0,1725,1896-11-11,-1725
1896,11,12,1456,0,1456,1896-11-12,-1456
1896,11,13,1341,0,1341,1896-11-13,-1341
1896,11,14,1478,247,1231,1896-11-14,-984
1896,11,15,454,0,454,1896-11-15,-454
1896,11,16,410,0,410,1896-11-16,-410
1896,11,17,437,0,437,1896-11-17,-437
1896,11,18,42,0,42,1896-11-18,-42
1896,11,19,14,0,14,1896-11-19,-14
1896,11,20,28,0,28,1896-11-20,-28
1896,11,21,140,106,34,1896-11-21,72
1896,11,22,277,96,181,1896-11-22,-85
1896,11,23,223,60,163,1896-11-23,-103
1896,11,24,89,53,36,1896-11-24,17
1896,11,25,43,28,15,1896-11-25,13
1896,11,26,43,30,13,1896-11-26,17
1896,11,27,50,42,8,1896-11-27,34
1896,11,28,61,53,8,1896-11-28,45
1896,11,29,766,396,370,1896-11-29,26
1896,11,30,678,338,340,1896-11-30,-2
1896,12,1,537,256,281,1896-12-1,-25
1896,12,2,539,247,292,1896-12-2,-45
1896,12,3,569,298,271,1896-12-3,27
1896,12,4,642,409,233,1896-12-4,176
1896,12,5,669,395,274,1896-12-5,121
1896,12,6,546,389,157,1896-12-6,232
1896,12,7,620,403,217,1896-12-7,186
1896,12,8,534,316,218,1896-12-8,98
1896,12,9,555,352,203,1896-12-9,149
1896,12,10,494,315,179,1896-12-10,136
1896,12,11,346,134,212,1896-12-11,-78
1896,12,12,275,103,172,1896-12-12,-69
1896,12,13,165,0,165,1896-12-13,-165
1896,12,14,202,0,202,1896-12-14,-202
1896,12,15,283,0,283,1896-12-15,-283
1896,12,16,355,0,355,1896-12-16,-355
1896,12,17,271,0,271,1896-12-17,-271
1896,12,18,405,33,372,1896-12-18,-339
1896,12,19,713,50,663,1896-12-19,-613
1896,12,20,665,114,551,1896-12-20,-437
1896,12,21,893,413,480,1896-12-21,-67
1896,12,22,1007,585,422,1896-12-22,163
1896,12,23,691,664,27,1896-12-23,637
1896,12,24,662,662,0,1896-12-24,662
1896,12,25,706,648,58,1896-12-25,590
1896,12,26,568,475,93,1896-12-26,382
1896,12,27,694,362,332,1896-12-27,30
1896,12,28,489,168,321,1896-12-28,-153
1896,12,29,513,127,386,1896-12-29,-259
1896,12,30,457,113,344,1896-12-30,-231
1896,12,31,461,0,461,1896-12-31,-461
1897,1,1,320,0,320,1897-1-1,-320
1897,1,2,270,0,270,1897-1-2,-270
1897,1,3,501,0,501,1897-1-3,-501
1897,1,4,1868,0,1868,1897-1-4,-1868
1897,1,5,2588,0,2588,1897-1-5,-2588
1897,1,6,2708,0,2708,1897-1-6,-2708
1897,1,7,2628,0,2628,1897-1-7,-2628
1897,1,8,2845,0,2845,1897-1-8,-2845
1897,1,9,2441,0,2441,1897-1-9,-2441
1897,1,10,2327,0,2327,1897-1-10,-2327
1897,1,11,2554,18,2536,1897-1-11,-2518
1897,1,12,2542,0,2542,1897-1-12,-2542
1897,1,13,2928,0,2928,1897-1-13,-2928
1897,1,14,2388,0,2388,1897-1-14,-2388
1897,1,15,2389,0,2389,1897-1-15,-2389
1897,1,16,613,0,613,1897-1-16,-613
1897,1,17,459,11,448,1897-1-17,-437
1897,1,18,359,0,359,1897-1-18,-359
1897,1,19,341,0,341,1897-1-19,-341
1897,1,20,342,51,291,1897-1-20,-240
1897,1,21,521,238,283,1897-1-21,-45
1897,1,22,523,330,193,1897-1-22,137
1897,1,23,897,795,102,1897-1-23,693
1897,1,24,784,759,25,1897-1-24,734
1897,1,25,1184,1184,0,1897-1-25,1184
1897,1,26,635,623,12,1897-1-26,611
1897,1,27,323,323,0,1897-1-27,323
1897,1,28,395,377,18,1897-1-28,359
1897,1,29,333,325,8,1897-1-29,317
1897,1,30,826,273,553,1897-1-30,-280
1897,1,31,1428,342,1086,1897-1-31,-744
1897,2,1,1509,273,1236,1897-2-1,-963
1897,2,2,1700,327,1373,1897-2-2,-1046
1897,2,3,1870,502,1368,1897-2-3,-866
1897,2,4,1921,666,1255,1897-2-4,-589
1897,2,5,-1,-1,-1,1897-2-5,0
1897,2,6,1739,319,1420,1897-2-6,-1101
1897,2,7,1556,189,1367,1897-2-7,-1178
1897,2,8,1315,0,1315,1897-2-8,-1315
1897,2,9,823,0,823,1897-2-9,-823
1897,2,10,1120,364,756,1897-2-10,-392
1897,2,11,1022,371,651,1897-2-11,-280
1897,2,12,377,377,0,1897-2-12,377
1897,2,13,352,352,0,1897-2-13,352
1897,2,14,343,343,0,1897-2-14,343
1897,2,15,357,357,0,1897-2-15,357
1897,2,16,310,303,7,1897-2-16,296
1897,2,17,366,366,0,1897-2-17,366
1897,2,18,316,316,0,1897-2-18,316
1897,2,19,293,291,2,1897-2-19,289
1897,2,20,305,305,0,1897-2-20,305
1897,2,21,251,251,0,1897-2-21,251
1897,2,22,492,492,0,1897-2-22,492
1897,2,23,632,434,198,1897-2-23,236
1897,2,24,758,735,23,1897-2-24,712
1897,2,25,928,897,31,1897-2-25,866
1897,2,26,1270,594,676,1897-2-26,-82
1897,2,27,1350,715,635,1897-2-27,80
1897,2,28,1366,674,692,1897-2-28,-18
1897,3,1,1179,576,603,1897-3-1,-27
1897,3,2,1152,535,617,1897-3-2,-82
1897,3,3,1281,543,738,1897-3-3,-195
1897,3,4,1264,530,734,1897-3-4,-204
1897,3,5,1238,466,772,1897-3-5,-306
1897,3,6,1288,466,822,1897-3-6,-356
1897,3,7,876,116,760,1897-3-7,-644
1897,3,8,671,433,238,1897-3-8,195
1897,3,9,699,521,178,1897-3-9,343
1897,3,10,608,408,200,1897-3-10,208
1897,3,11,215,215,0,1897-3-11,215
1897,3,12,239,239,0,1897-3-12,239
1897,3,13,319,312,7,1897-3-13,305
1897,3,14,175,175,0,1897-3-14,175
1897,3,15,487,487,0,1897-3-15,487
1897,3,16,500,500,0,1897-3-16,500
1897,3,17,534,460,74,1897-3-17,386
1897,3,18,451,451,0,1897-3-18,451
1897,3,19,423,423,0,1897-3-19,423
1897,3,20,300,300,0,1897-3-20,300
1897,3,21,0,0,0,1897-3-21,0
1897,3,22,124,0,124,1897-3-22,-124
1897,3,23,105,6,99,1897-3-23,-93
1897,3,24,136,44,92,1897-3-24,-48
1897,3,25,123,35,88,1897-3-25,-53
1897,3,26,254,5,249,1897-3-26,-244
1897,3,27,218,0,218,1897-3-27,-218
1897,3,28,350,136,214,1897-3-28,-78
1897,3,29,371,158,213,1897-3-29,-55
1897,3,30,320,137,183,1897-3-30,-46
1897,3,31,337,140,197,1897-3-31,-57
1897,4,1,488,142,346,1897-4-1,-204
1897,4,2,410,139,271,1897-4-2,-132
1897,4,3,322,140,182,1897-4-3,-42
1897,4,4,444,245,199,1897-4-4,46
1897,4,5,410,259,151,1897-4-5,108
1897,4,6,520,284,236,1897-4-6,48
1897,4,7,1122,790,332,1897-4-7,458
1897,4,8,1160,790,370,1897-4-8,420
1897,4,9,968,652,316,1897-4-9,336
1897,4,10,824,490,334,1897-4-10,156
1897,4,11,568,429,139,1897-4-11,290
1897,4,12,578,416,162,1897-4-12,254
1897,4,13,598,436,162,1897-4-13,274
1897,4,14,449,420,29,1897-4-14,391
1897,4,15,432,406,26,1897-4-15,380
1897,4,16,548,534,14,1897-4-16,520
1897,4,17,24,24,0,1897-4-17,24
1897,4,18,21,21,0,1897-4-18,21
1897,4,19,114,114,0,1897-4-19,114
1897,4,20,170,170,0,1897-4-20,170
1897,4,21,186,186,0,1897-4-21,186
1897,4,22,171,171,0,1897-4-22,171
1897,4,23,0,0,0,1897-4-23,0
1897,4,24,0,0,0,1897-4-24,0
1897,4,25,33,33,0,1897-4-25,33
1897,4,26,28,28,0,1897-4-26,28
1897,4,27,22,22,0,1897-4-27,22
1897,4,28,284,47,237,1897-4-28,-190
1897,4,29,317,20,297,1897-4-29,-277
1897,4,30,311,9,302,1897-4-30,-293
1897,5,1,540,227,313,1897-5-1,-86
1897,5,2,705,181,524,1897-5-2,-343
1897,5,3,887,183,704,1897-5-3,-521
1897,5,4,984,168,816,1897-5-4,-648
1897,5,5,986,169,817,1897-5-5,-648
1897,5,6,988,154,834,1897-5-6,-680
1897,5,7,867,149,718,1897-5-7,-569
1897,5,8,818,149,669,1897-5-8,-520
1897,5,9,796,150,646,1897-5-9,-496
1897,5,10,669,108,561,1897-5-10,-453
1897,5,11,71,71,0,1897-5-11,71
1897,5,12,66,66,0,1897-5-12,66
1897,5,13,0,0,0,1897-5-13,0
1897,5,14,0,0,0,1897-5-14,0
1897,5,15,0,0,0,1897-5-15,0
1897,5,16,0,0,0,1897-5-16,0
1897,5,17,0,0,0,1897-5-17,0
1897,5,18,0,0,0,1897-5-18,0
1897,5,19,0,0,0,1897-5-19,0
1897,5,20,62,62,0,1897-5-20,62
1897,5,21,126,100,26,1897-5-21,74
1897,5,22,145,136,9,1897-5-22,127
1897,5,23,115,115,0,1897-5-23,115
1897,5,24,78,46,32,1897-5-24,14
1897,5,25,484,56,428,1897-5-25,-372
1897,5,26,477,52,425,1897-5-26,-373
1897,5,27,466,3,463,1897-5-27,-460
1897,5,28,541,0,541,1897-5-28,-541
1897,5,29,456,0,456,1897-5-29,-456
1897,5,30,514,0,514,1897-5-30,-514
1897,5,31,505,5,500,1897-5-31,-495
1897,6,1,462,0,462,1897-6-1,-462
1897,6,2,412,0,412,1897-6-2,-412
1897,6,3,382,0,382,1897-6-3,-382
1897,6,4,501,0,501,1897-6-4,-501
1897,6,5,340,0,340,1897-6-5,-340
1897,6,6,399,0,399,1897-6-6,-399
1897,6,7,0,0,0,1897-6-7,0
1897,6,8,0,0,0,1897-6-8,0
1897,6,9,6,0,6,1897-6-9,-6
1897,6,10,0,0,0,1897-6-10,0
1897,6,11,0,0,0,1897-6-11,0
1897,6,12,0,0,0,1897-6-12,0
1897,6,13,291,0,291,1897-6-13,-291
1897,6,14,378,0,378,1897-6-14,-378
1897,6,15,331,0,331,1897-6-15,-331
1897,6,16,277,0,277,1897-6-16,-277
1897,6,17,0,0,0,1897-6-17,0
1897,6,18,5,0,5,1897-6-18,-5
1897,6,19,0,0,0,1897-6-19,0
1897,6,20,3,3,0,1897-6-20,3
1897,6,21,180,0,180,1897-6-21,-180
1897,6,22,239,20,219,1897-6-22,-199
1897,6,23,224,32,192,1897-6-23,-160
1897,6,24,202,13,189,1897-6-24,-176
1897,6,25,207,14,193,1897-6-25,-179
1897,6,26,191,28,163,1897-6-26,-135
1897,6,27,161,5,156,1897-6-27,-151
1897,6,28,414,0,414,1897-6-28,-414
1897,6,29,425,0,425,1897-6-29,-425
1897,6,30,494,0,494,1897-6-30,-494
1897,7,1,394,0,394,1897-7-1,-394
1897,7,2,414,0,414,1897-7-2,-414
1897,7,3,484,0,484,1897-7-3,-484
1897,7,4,310,0,310,1897-7-4,-310
1897,7,5,293,0,293,1897-7-5,-293
1897,7,6,272,0,272,1897-7-6,-272
1897,7,7,449,0,449,1897-7-7,-449
1897,7,8,473,0,473,1897-7-8,-473
1897,7,9,422,0,422,1897-7-9,-422
1897,7,10,324,0,324,1897-7-10,-324
1897,7,11,241,0,241,1897-7-11,-241
1897,7,12,190,0,190,1897-7-12,-190
1897,7,13,171,13,158,1897-7-13,-145
1897,7,14,220,0,220,1897-7-14,-220
1897,7,15,299,30,269,1897-7-15,-239
1897,7,16,65,17,48,1897-7-16,-31
1897,7,17,-1,-1,-1,1897-7-17,0
1897,7,18,-1,-1,-1,1897-7-18,0
1897,7,19,-1,-1,-1,1897-7-19,0
1897,7,20,-1,-1,-1,1897-7-20,0
1897,7,21,-1,-1,-1,1897-7-21,0
1897,7,22,-1,-1,-1,1897-7-22,0
1897,7,23,-1,-1,-1,1897-7-23,0
1897,7,24,-1,-1,-1,1897-7-24,0
1897,7,25,-1,-1,-1,1897-7-25,0
1897,7,26,-1,-1,-1,1897-7-26,0
1897,7,27,-1,-1,-1,1897-7-27,0
1897,7,28,-1,-1,-1,1897-7-28,0
1897,7,29,17,17,0,1897-7-29,17
1897,7,30,463,141,322,1897-7-30,-181
1897,7,31,365,100,265,1897-7-31,-165
1897,8,1,186,65,121,1897-8-1,-56
1897,8,2,590,0,590,1897-8-2,-590
1897,8,3,1222,0,1222,1897-8-3,-1222
1897,8,4,1049,0,1049,1897-8-4,-1049
1897,8,5,1191,0,1191,1897-8-5,-1191
1897,8,6,1069,0,1069,1897-8-6,-1069
1897,8,7,1112,0,1112,1897-8-7,-1112
1897,8,8,941,0,941,1897-8-8,-941
1897,8,9,786,0,786,1897-8-9,-786
1897,8,10,692,14,678,1897-8-10,-664
1897,8,11,717,16,701,1897-8-11,-685
1897,8,12,843,0,843,1897-8-12,-843
1897,8,13,853,0,853,1897-8-13,-853
1897,8,14,897,0,897,1897-8-14,-897
1897,8,15,755,0,755,1897-8-15,-755
1897,8,16,240,0,240,1897-8-16,-240
1897,8,17,129,0,129,1897-8-17,-129
1897,8,18,130,0,130,1897-8-18,-130
1897,8,19,130,0,130,1897-8-19,-130
1897,8,20,123,0,123,1897-8-20,-123
1897,8,21,144,0,144,1897-8-21,-144
1897,8,22,143,0,143,1897-8-22,-143
1897,8,23,118,0,118,1897-8-23,-118
1897,8,24,139,28,111,1897-8-24,-83
1897,8,25,129,28,101,1897-8-25,-73
1897,8,26,74,0,74,1897-8-26,-74
1897,8,27,100,21,79,1897-8-27,-58
1897,8,28,28,28,0,1897-8-28,28
1897,8,29,26,26,0,1897-8-29,26
1897,8,30,342,0,342,1897-8-30,-342
1897,8,31,377,92,285,1897-8-31,-193
1897,9,1,319,63,256,1897-9-1,-193
1897,9,2,372,97,275,1897-9-2,-178
1897,9,3,962,150,812,1897-9-3,-662
1897,9,4,1580,169,1411,1897-9-4,-1242
1897,9,5,1642,171,1471,1897-9-5,-1300
1897,9,6,1723,181,1542,1897-9-6,-1361
1897,9,7,1519,135,1384,1897-9-7,-1249
1897,9,8,1561,135,1426,1897-9-8,-1291
1897,9,9,1550,213,1337,1897-9-9,-1124
1897,9,10,1201,167,1034,1897-9-10,-867
1897,9,11,985,88,897,1897-9-11,-809
1897,9,12,756,96,660,1897-9-12,-564
1897,9,13,689,54,635,1897-9-13,-581
1897,9,14,60,33,27,1897-9-14,6
1897,9,15,196,196,0,1897-9-15,196
1897,9,16,117,117,0,1897-9-16,117
1897,9,17,85,85,0,1897-9-17,85
1897,9,18,89,57,32,1897-9-18,25
1897,9,19,57,28,29,1897-9-19,-1
1897,9,20,339,28,311,1897-9-20,-283
1897,9,21,701,451,250,1897-9-21,201
1897,9,22,466,276,190,1897-9-22,86
1897,9,23,613,426,187,1897-9-23,239
1897,9,24,533,407,126,1897-9-24,281
1897,9,25,427,312,115,1897-9-25,197
1897,9,26,575,267,308,1897-9-26,-41
1897,9,27,640,367,273,1897-9-27,94
1897,9,28,523,285,238,1897-9-28,47
1897,9,29,461,264,197,1897-9-29,67
1897,9,30,376,239,137,1897-9-30,102
1897,10,1,325,209,116,1897-10-1,93
1897,10,2,318,198,120,1897-10-2,78
1897,10,3,287,168,119,1897-10-3,49
1897,10,4,277,169,108,1897-10-4,61
1897,10,5,303,169,134,1897-10-5,35
1897,10,6,264,151,113,1897-10-6,38
1897,10,7,286,150,136,1897-10-7,14
1897,10,8,108,101,7,1897-10-8,94
1897,10,9,7,7,0,1897-10-9,7
1897,10,10,26,26,0,1897-10-10,26
1897,10,11,69,69,0,1897-10-11,69
1897,10,12,35,35,0,1897-10-12,35
1897,10,13,15,15,0,1897-10-13,15
1897,10,14,0,0,0,1897-10-14,0
1897,10,15,17,17,0,1897-10-15,17
1897,10,16,37,37,0,1897-10-16,37
1897,10,17,54,54,0,1897-10-17,54
1897,10,18,10,10,0,1897-10-18,10
1897,10,19,12,12,0,1897-10-19,12
1897,10,20,38,38,0,1897-10-20,38
1897,10,21,25,25,0,1897-10-21,25
1897,10,22,14,14,0,1897-10-22,14
1897,10,23,3,3,0,1897-10-23,3
1897,10,24,0,0,0,1897-10-24,0
1897,10,25,0,0,0,1897-10-25,0
1897,10,26,0,0,0,1897-10-26,0
1897,10,27,0,0,0,1897-10-27,0
1897,10,28,0,0,0,1897-10-28,0
1897,10,29,0,0,0,1897-10-29,0
1897,10,30,0,0,0,1897-10-30,0
1897,10,31,34,0,34,1897-10-31,-34
1897,11,1,11,0,11,1897-11-1,-11
1897,11,2,105,0,105,1897-11-2,-105
1897,11,3,35,0,35,1897-11-3,-35
1897,11,4,24,0,24,1897-11-4,-24
1897,11,5,32,0,32,1897-11-5,-32
1897,11,6,21,0,21,1897-11-6,-21
1897,11,7,23,0,23,1897-11-7,-23
1897,11,8,18,0,18,1897-11-8,-18
1897,11,9,6,0,6,1897-11-9,-6
1897,11,10,0,0,0,1897-11-10,0
1897,11,11,0,0,0,1897-11-11,0
1897,11,12,19,0,19,1897-11-12,-19
1897,11,13,37,0,37,1897-11-13,-37
1897,11,14,25,0,25,1897-11-14,-25
1897,11,15,4,0,4,1897-11-15,-4
1897,11,16,4,0,4,1897-11-16,-4
1897,11,17,0,0,0,1897-11-17,0
1897,11,18,11,11,0,1897-11-18,11
1897,11,19,0,0,0,1897-11-19,0
1897,11,20,45,35,10,1897-11-20,25
1897,11,21,64,64,0,1897-11-21,64
1897,11,22,11,11,0,1897-11-22,11
1897,11,23,0,0,0,1897-11-23,0
1897,11,24,0,0,0,1897-11-24,0
1897,11,25,23,0,23,1897-11-25,-23
1897,11,26,24,0,24,1897-11-26,-24
1897,11,27,86,86,0,1897-11-27,86
1897,11,28,133,133,0,1897-11-28,133
1897,11,29,125,92,33,1897-11-29,59
1897,11,30,141,119,22,1897-11-30,97
1897,12,1,106,94,12,1897-12-1,82
1897,12,2,97,97,0,1897-12-2,97
1897,12,3,228,146,82,1897-12-3,64
1897,12,4,577,399,178,1897-12-4,221
1897,12,5,1036,800,236,1897-12-5,564
1897,12,6,1483,1264,219,1897-12-6,1045
1897,12,7,1927,1808,119,1897-12-7,1689
1897,12,8,2146,2075,71,1897-12-8,2004
1897,12,9,1420,1361,59,1897-12-9,1302
1897,12,10,1327,1290,37,1897-12-10,1253
1897,12,11,1516,1492,24,1897-12-11,1468
1897,12,12,1395,1382,13,1897-12-12,1369
1897,12,13,1287,1287,0,1897-12-13,1287
1897,12,14,1216,1216,0,1897-12-14,1216
1897,12,15,1436,1436,0,1897-12-15,1436
1897,12,16,1241,1241,0,1897-12-16,1241
1897,12,17,1154,1154,0,1897-12-17,1154
1897,12,18,1255,1255,0,1897-12-18,1255
1897,12,19,746,746,0,1897-12-19,746
1897,12,20,52,52,0,1897-12-20,52
1897,12,21,55,55,0,1897-12-21,55
1897,12,22,22,22,0,1897-12-22,22
1897,12,23,18,18,0,1897-12-23,18
1897,12,24,7,7,0,1897-12-24,7
1897,12,25,0,0,0,1897-12-25,0
1897,12,26,226,226,0,1897-12-26,226
1897,12,27,172,172,0,1897-12-27,172
1897,12,28,188,188,0,1897-12-28,188
1897,12,29,171,171,0,1897-12-29,171
1897,12,30,353,336,17,1897-12-30,319
1897,12,31,401,358,43,1897-12-31,315
1898,1,1,320,284,36,1898-1-1,248
1898,1,2,231,231,0,1898-1-2,231
1898,1,3,370,370,0,1898-1-3,370
1898,1,4,436,398,38,1898-1-4,360
1898,1,5,396,382,14,1898-1-5,368
1898,1,6,344,344,0,1898-1-6,344
1898,1,7,365,365,0,1898-1-7,365
1898,1,8,256,256,0,1898-1-8,256
1898,1,9,233,233,0,1898-1-9,233
1898,1,10,220,220,0,1898-1-10,220
1898,1,11,126,126,0,1898-1-11,126
1898,1,12,126,126,0,1898-1-12,126
1898,1,13,112,108,4,1898-1-13,104
1898,1,14,434,103,331,1898-1-14,-228
1898,1,15,549,71,478,1898-1-15,-407
1898,1,16,644,195,449,1898-1-16,-254
1898,1,17,597,128,469,1898-1-17,-341
1898,1,18,506,112,394,1898-1-18,-282
1898,1,19,786,429,357,1898-1-19,72
1898,1,20,806,431,375,1898-1-20,56
1898,1,21,744,436,308,1898-1-21,128
1898,1,22,613,473,140,1898-1-22,333
1898,1,23,606,449,157,1898-1-23,292
1898,1,24,660,440,220,1898-1-24,220
1898,1,25,558,496,62,1898-1-25,434
1898,1,26,419,419,0,1898-1-26,419
1898,1,27,456,456,0,1898-1-27,456
1898,1,28,276,276,0,1898-1-28,276
1898,1,29,279,279,0,1898-1-29,279
1898,1,30,154,154,0,1898-1-30,154
1898,1,31,120,120,0,1898-1-31,120
1898,2,1,0,0,0,1898-2-1,0
1898,2,2,0,0,0,1898-2-2,0
1898,2,3,0,0,0,1898-2-3,0
1898,2,4,80,0,80,1898-2-4,-80
1898,2,5,143,0,143,1898-2-5,-143
1898,2,6,121,0,121,1898-2-6,-121
1898,2,7,352,86,266,1898-2-7,-180
1898,2,8,259,76,183,1898-2-8,-107
1898,2,9,307,0,307,1898-2-9,-307
1898,2,10,415,0,415,1898-2-10,-415
1898,2,11,327,0,327,1898-2-11,-327
1898,2,12,699,0,699,1898-2-12,-699
1898,2,13,849,4,845,1898-2-13,-841
1898,2,14,929,0,929,1898-2-14,-929
1898,2,15,1405,109,1296,1898-2-15,-1187
1898,2,16,1565,176,1389,1898-2-16,-1213
1898,2,17,1331,161,1170,1898-2-17,-1009
1898,2,18,1625,156,1469,1898-2-18,-1313
1898,2,19,1388,135,1253,1898-2-19,-1118
1898,2,20,425,121,304,1898-2-20,-183
1898,2,21,312,136,176,1898-2-21,-40
1898,2,22,323,95,228,1898-2-22,-133
1898,2,23,315,133,182,1898-2-23,-49
1898,2,24,224,119,105,1898-2-24,14
1898,2,25,160,83,77,1898-2-25,6
1898,2,26,311,99,212,1898-2-26,-113
1898,2,27,323,0,323,1898-2-27,-323
1898,2,28,483,0,483,1898-2-28,-483
1898,3,1,391,0,391,1898-3-1,-391
1898,3,2,307,0,307,1898-3-2,-307
1898,3,3,222,18,204,1898-3-3,-186
1898,3,4,182,0,182,1898-3-4,-182
1898,3,5,187,0,187,1898-3-5,-187
1898,3,6,1030,545,485,1898-3-6,60
1898,3,7,1249,393,856,1898-3-7,-463
1898,3,8,1274,384,890,1898-3-8,-506
1898,3,9,1457,275,1182,1898-3-9,-907
1898,3,10,1574,289,1285,1898-3-10,-996
1898,3,11,1492,231,1261,1898-3-11,-1030
1898,3,12,1721,192,1529,1898-3-12,-1337
1898,3,13,1699,194,1505,1898-3-13,-1311
1898,3,14,1906,148,1758,1898-3-14,-1610
1898,3,15,1559,102,1457,1898-3-15,-1355
1898,3,16,1438,41,1397,1898-3-16,-1356
1898,3,17,1025,0,1025,1898-3-17,-1025
1898,3,18,223,31,192,1898-3-18,-161
1898,3,19,9,9,0,1898-3-19,9
1898,3,20,0,0,0,1898-3-20,0
1898,3,21,0,0,0,1898-3-21,0
1898,3,22,11,0,11,1898-3-22,-11
1898,3,23,0,0,0,1898-3-23,0
1898,3,24,0,0,0,1898-3-24,0
1898,3,25,0,0,0,1898-3-25,0
1898,3,26,52,0,52,1898-3-26,-52
1898,3,27,32,0,32,1898-3-27,-32
1898,3,28,27,0,27,1898-3-28,-27
1898,3,29,16,0,16,1898-3-29,-16
1898,3,30,0,0,0,1898-3-30,0
1898,3,31,278,0,278,1898-3-31,-278
1898,4,1,410,0,410,1898-4-1,-410
1898,4,2,406,0,406,1898-4-2,-406
1898,4,3,439,0,439,1898-4-3,-439
1898,4,4,345,0,345,1898-4-4,-345
1898,4,5,367,0,367,1898-4-5,-367
1898,4,6,315,0,315,1898-4-6,-315
1898,4,7,291,0,291,1898-4-7,-291
1898,4,8,195,0,195,1898-4-8,-195
1898,4,9,206,0,206,1898-4-9,-206
1898,4,10,206,0,206,1898-4-10,-206
1898,4,11,169,0,169,1898-4-11,-169
1898,4,12,148,0,148,1898-4-12,-148
1898,4,13,127,0,127,1898-4-13,-127
1898,4,14,9,0,9,1898-4-14,-9
1898,4,15,9,0,9,1898-4-15,-9
1898,4,16,0,0,0,1898-4-16,0
1898,4,17,0,0,0,1898-4-17,0
1898,4,18,0,0,0,1898-4-18,0
1898,4,19,0,0,0,1898-4-19,0
1898,4,20,0,0,0,1898-4-20,0
1898,4,21,0,0,0,1898-4-21,0
1898,4,22,28,28,0,1898-4-22,28
1898,4,23,20,20,0,1898-4-23,20
1898,4,24,14,14,0,1898-4-24,14
1898,4,25,10,10,0,1898-4-25,10
1898,4,26,47,22,25,1898-4-26,-3
1898,4,27,56,14,42,1898-4-27,-28
1898,4,28,66,7,59,1898-4-28,-52
1898,4,29,309,0,309,1898-4-29,-309
1898,4,30,580,0,580,1898-4-30,-580
1898,5,1,752,0,752,1898-5-1,-752
1898,5,2,486,0,486,1898-5-2,-486
1898,5,3,14,14,0,1898-5-3,14
1898,5,4,6,0,6,1898-5-4,-6
1898,5,5,0,0,0,1898-5-5,0
1898,5,6,404,20,384,1898-5-6,-364
1898,5,7,597,54,543,1898-5-7,-489
1898,5,8,547,31,516,1898-5-8,-485
1898,5,9,527,8,519,1898-5-9,-511
1898,5,10,559,0,559,1898-5-10,-559
1898,5,11,433,0,433,1898-5-11,-433
1898,5,12,366,0,366,1898-5-12,-366
1898,5,13,349,0,349,1898-5-13,-349
1898,5,14,256,6,250,1898-5-14,-244
1898,5,15,238,0,238,1898-5-15,-238
1898,5,16,155,0,155,1898-5-16,-155
1898,5,17,261,0,261,1898-5-17,-261
1898,5,18,296,25,271,1898-5-18,-246
1898,5,19,168,0,168,1898-5-19,-168
1898,5,20,145,10,135,1898-5-20,-125
1898,5,21,118,2,116,1898-5-21,-114
1898,5,22,112,4,108,1898-5-22,-104
1898,5,23,82,0,82,1898-5-23,-82
1898,5,24,96,0,96,1898-5-24,-96
1898,5,25,82,15,67,1898-5-25,-52
1898,5,26,132,11,121,1898-5-26,-110
1898,5,27,116,2,114,1898-5-27,-112
1898,5,28,84,0,84,1898-5-28,-84
1898,5,29,36,0,36,1898-5-29,-36
1898,5,30,82,0,82,1898-5-30,-82
1898,5,31,175,0,175,1898-5-31,-175
1898,6,1,215,29,186,1898-6-1,-157
1898,6,2,143,18,125,1898-6-2,-107
1898,6,3,94,41,53,1898-6-3,-12
1898,6,4,61,23,38,1898-6-4,-15
1898,6,5,0,0,0,1898-6-5,0
1898,6,6,69,69,0,1898-6-6,69
1898,6,7,0,0,0,1898-6-7,0
1898,6,8,8,8,0,1898-6-8,8
1898,6,9,0,0,0,1898-6-9,0
1898,6,10,0,0,0,1898-6-10,0
1898,6,11,4,0,4,1898-6-11,-4
1898,6,12,0,0,0,1898-6-12,0
1898,6,13,0,0,0,1898-6-13,0
1898,6,14,56,56,0,1898-6-14,56
1898,6,15,53,53,0,1898-6-15,53
1898,6,16,92,92,0,1898-6-16,92
1898,6,17,140,140,0,1898-6-17,140
1898,6,18,104,104,0,1898-6-18,104
1898,6,19,33,33,0,1898-6-19,33
1898,6,20,34,4,30,1898-6-20,-26
1898,6,21,113,0,113,1898-6-21,-113
1898,6,22,86,0,86,1898-6-22,-86
1898,6,23,100,9,91,1898-6-23,-82
1898,6,24,87,0,87,1898-6-24,-87
1898,6,25,93,16,77,1898-6-25,-61
1898,6,26,92,0,92,1898-6-26,-92
1898,6,27,125,0,125,1898-6-27,-125
1898,6,28,62,0,62,1898-6-28,-62
1898,6,29,49,0,49,1898-6-29,-49
1898,6,30,30,0,30,1898-6-30,-30
1898,7,1,23,0,23,1898-7-1,-23
1898,7,2,9,0,9,1898-7-2,-9
1898,7,3,0,0,0,1898-7-3,0
1898,7,4,0,0,0,1898-7-4,0
1898,7,5,0,0,0,1898-7-5,0
1898,7,6,0,0,0,1898-7-6,0
1898,7,7,0,0,0,1898-7-7,0
1898,7,8,0,0,0,1898-7-8,0
1898,7,9,0,0,0,1898-7-9,0
1898,7,10,0,0,0,1898-7-10,0
1898,7,11,0,0,0,1898-7-11,0
1898,7,12,0,0,0,1898-7-12,0
1898,7,13,0,0,0,1898-7-13,0
1898,7,14,0,0,0,1898-7-14,0
1898,7,15,23,23,0,1898-7-15,23
1898,7,16,46,46,0,1898-7-16,46
1898,7,17,12,12,0,1898-7-17,12
1898,7,18,0,0,0,1898-7-18,0
1898,7,19,74,0,74,1898-7-19,-74
1898,7,20,73,0,73,1898-7-20,-73
1898,7,21,62,0,62,1898-7-21,-62
1898,7,22,71,62,9,1898-7-22,53
1898,7,23,93,93,0,1898-7-23,93
1898,7,24,135,135,0,1898-7-24,135
1898,7,25,84,73,11,1898-7-25,62
1898,7,26,81,41,40,1898-7-26,1
1898,7,27,9,9,0,1898-7-27,9
1898,7,28,5,0,5,1898-7-28,-5
1898,7,29,27,0,27,1898-7-29,-27
1898,7,30,140,0,140,1898-7-30,-140
1898,7,31,523,199,324,1898-7-31,-125
1898,8,1,701,439,262,1898-8-1,177
1898,8,2,967,468,499,1898-8-2,-31
1898,8,3,1216,448,768,1898-8-3,-320
1898,8,4,1165,360,805,1898-8-4,-445
1898,8,5,1258,358,900,1898-8-5,-542
1898,8,6,1296,360,936,1898-8-6,-576
1898,8,7,990,309,681,1898-8-7,-372
1898,8,8,930,323,607,1898-8-8,-284
1898,8,9,876,298,578,1898-8-9,-280
1898,8,10,812,318,494,1898-8-10,-176
1898,8,11,667,266,401,1898-8-11,-135
1898,8,12,462,131,331,1898-8-12,-200
1898,8,13,670,411,259,1898-8-13,152
1898,8,14,345,326,19,1898-8-14,307
1898,8,15,327,317,10,1898-8-15,307
1898,8,16,292,284,8,1898-8-16,276
1898,8,17,194,184,10,1898-8-17,174
1898,8,18,98,98,0,1898-8-18,98
1898,8,19,20,0,20,1898-8-19,-20
1898,8,20,0,0,0,1898-8-20,0
1898,8,21,8,0,8,1898-8-21,-8
1898,8,22,48,0,48,1898-8-22,-48
1898,8,23,81,0,81,1898-8-23,-81
1898,8,24,0,0,0,1898-8-24,0
1898,8,25,0,0,0,1898-8-25,0
1898,8,26,0,0,0,1898-8-26,0
1898,8,27,294,202,92,1898-8-27,110
1898,8,28,217,181,36,1898-8-28,145
1898,8,29,171,171,0,1898-8-29,171
1898,8,30,134,134,0,1898-8-30,134
1898,8,31,140,140,0,1898-8-31,140
1898,9,1,152,121,31,1898-9-1,90
1898,9,2,135,135,0,1898-9-2,135
1898,9,3,1144,130,1014,1898-9-3,-884
1898,9,4,1218,126,1092,1898-9-4,-966
1898,9,5,1141,100,1041,1898-9-5,-941
1898,9,6,1228,105,1123,1898-9-6,-1018
1898,9,7,1524,75,1449,1898-9-7,-1374
1898,9,8,1782,0,1782,1898-9-8,-1782
1898,9,9,2021,0,2021,1898-9-9,-2021
1898,9,10,2235,0,2235,1898-9-10,-2235
1898,9,11,2201,0,2201,1898-9-11,-2201
1898,9,12,1830,0,1830,1898-9-12,-1830
1898,9,13,1912,24,1888,1898-9-13,-1864
1898,9,14,2089,118,1971,1898-9-14,-1853
1898,9,15,874,247,627,1898-9-15,-380
1898,9,16,317,234,83,1898-9-16,151
1898,9,17,228,131,97,1898-9-17,34
1898,9,18,226,65,161,1898-9-18,-96
1898,9,19,129,11,118,1898-9-19,-107
1898,9,20,132,0,132,1898-9-20,-132
1898,9,21,147,0,147,1898-9-21,-147
1898,9,22,142,0,142,1898-9-22,-142
1898,9,23,157,0,157,1898-9-23,-157
1898,9,24,146,24,122,1898-9-24,-98
1898,9,25,26,26,0,1898-9-25,26
1898,9,26,17,17,0,1898-9-26,17
1898,9,27,65,65,0,1898-9-27,65
1898,9,28,345,173,172,1898-9-28,1
1898,9,29,754,436,318,1898-9-29,118
1898,9,30,1430,395,1035,1898-9-30,-640
1898,10,1,1529,301,1228,1898-10-1,-927
1898,10,2,1296,213,1083,1898-10-2,-870
1898,10,3,1132,107,1025,1898-10-3,-918
1898,10,4,1097,57,1040,1898-10-4,-983
1898,10,5,986,52,934,1898-10-5,-882
1898,10,6,852,31,821,1898-10-6,-790
1898,10,7,769,26,743,1898-10-7,-717
1898,10,8,615,0,615,1898-10-8,-615
1898,10,9,590,0,590,1898-10-9,-590
1898,10,10,494,0,494,1898-10-10,-494
1898,10,11,392,0,392,1898-10-11,-392
1898,10,12,313,0,313,1898-10-12,-313
1898,10,13,44,12,32,1898-10-13,-20
1898,10,14,75,51,24,1898-10-14,27
1898,10,15,42,42,0,1898-10-15,42
1898,10,16,20,18,2,1898-10-16,16
1898,10,17,54,42,12,1898-10-17,30
1898,10,18,10,0,10,1898-10-18,-10
1898,10,19,7,0,7,1898-10-19,-7
1898,10,20,5,5,0,1898-10-20,5
1898,10,21,5,5,0,1898-10-21,5
1898,10,22,249,249,0,1898-10-22,249
1898,10,23,1117,1117,0,1898-10-23,1117
1898,10,24,1190,1190,0,1898-10-24,1190
1898,10,25,1117,1117,0,1898-10-25,1117
1898,10,26,1051,1051,0,1898-10-26,1051
1898,10,27,940,934,6,1898-10-27,928
1898,10,28,792,728,64,1898-10-28,664
1898,10,29,816,686,130,1898-10-29,556
1898,10,30,726,564,162,1898-10-30,402
1898,10,31,447,346,101,1898-10-31,245
1898,11,1,575,513,62,1898-11-1,451
1898,11,2,768,554,214,1898-11-2,340
1898,11,3,658,535,123,1898-11-3,412
1898,11,4,695,477,218,1898-11-4,259
1898,11,5,757,635,122,1898-11-5,513
1898,11,6,973,907,66,1898-11-6,841
1898,11,7,824,806,18,1898-11-7,788
1898,11,8,659,613,46,1898-11-8,567
1898,11,9,628,588,40,1898-11-9,548
1898,11,10,565,550,15,1898-11-10,535
1898,11,11,180,30,150,1898-11-11,-120
1898,11,12,139,21,118,1898-11-12,-97
1898,11,13,141,0,141,1898-11-13,-141
1898,11,14,95,0,95,1898-11-14,-95
1898,11,15,58,0,58,1898-11-15,-58
1898,11,16,19,0,19,1898-11-16,-19
1898,11,17,9,9,0,1898-11-17,9
1898,11,18,43,0,43,1898-11-18,-43
1898,11,19,139,0,139,1898-11-19,-139
1898,11,20,120,0,120,1898-11-20,-120
1898,11,21,88,0,88,1898-11-21,-88
1898,11,22,62,0,62,1898-11-22,-62
1898,11,23,57,0,57,1898-11-23,-57
1898,11,24,73,0,73,1898-11-24,-73
1898,11,25,66,0,66,1898-11-25,-66
1898,11,26,84,9,75,1898-11-26,-66
1898,11,27,273,5,268,1898-11-27,-263
1898,11,28,325,11,314,1898-11-28,-303
1898,11,29,232,17,215,1898-11-29,-198
1898,11,30,218,30,188,1898-11-30,-158
1898,12,1,199,26,173,1898-12-1,-147
1898,12,2,661,8,653,1898-12-2,-645
1898,12,3,618,0,618,1898-12-3,-618
1898,12,4,584,0,584,1898-12-4,-584
1898,12,5,557,0,557,1898-12-5,-557
1898,12,6,561,0,561,1898-12-6,-561
1898,12,7,-1,-1,-1,1898-12-7,0
1898,12,8,465,0,465,1898-12-8,-465
1898,12,9,301,0,301,1898-12-9,-301
1898,12,10,324,0,324,1898-12-10,-324
1898,12,11,238,0,238,1898-12-11,-238
1898,12,12,238,0,238,1898-12-12,-238
1898,12,13,164,0,164,1898-12-13,-164
1898,12,14,0,0,0,1898-12-14,0
1898,12,15,0,0,0,1898-12-15,0
1898,12,16,14,14,0,1898-12-16,14
1898,12,17,23,23,0,1898-12-17,23
1898,12,18,0,0,0,1898-12-18,0
1898,12,19,51,51,0,1898-12-19,51
1898,12,20,33,33,0,1898-12-20,33
1898,12,21,0,0,0,1898-12-21,0
1898,12,22,0,0,0,1898-12-22,0
1898,12,23,0,0,0,1898-12-23,0
1898,12,24,0,0,0,1898-12-24,0
1898,12,25,0,0,0,1898-12-25,0
1898,12,26,0,0,0,1898-12-26,0
1898,12,27,0,0,0,1898-12-27,0
1898,12,28,0,0,0,1898-12-28,0
1898,12,29,32,0,32,1898-12-29,-32
1898,12,30,19,0,19,1898-12-30,-19
1898,12,31,79,0,79,1898-12-31,-79
1899,1,1,218,2,216,1899-1-1,-214
1899,1,2,293,0,293,1899-1-2,-293
1899,1,3,356,0,356,1899-1-3,-356
1899,1,4,315,0,315,1899-1-4,-315
1899,1,5,428,0,428,1899-1-5,-428
1899,1,6,651,0,651,1899-1-6,-651
1899,1,7,465,14,451,1899-1-7,-437
1899,1,8,383,0,383,1899-1-8,-383
1899,1,9,441,20,421,1899-1-9,-401
1899,1,10,349,3,346,1899-1-10,-343
1899,1,11,286,0,286,1899-1-11,-286
1899,1,12,260,0,260,1899-1-12,-260
1899,1,13,265,0,265,1899-1-13,-265
1899,1,14,229,0,229,1899-1-14,-229
1899,1,15,179,0,179,1899-1-15,-179
1899,1,16,312,0,312,1899-1-16,-312
1899,1,17,118,0,118,1899-1-17,-118
1899,1,18,173,0,173,1899-1-18,-173
1899,1,19,105,0,105,1899-1-19,-105
1899,1,20,0,0,0,1899-1-20,0
1899,1,21,2,2,0,1899-1-21,2
1899,1,22,25,0,25,1899-1-22,-25
1899,1,23,22,0,22,1899-1-23,-22
1899,1,24,69,0,69,1899-1-24,-69
1899,1,25,135,0,135,1899-1-25,-135
1899,1,26,170,0,170,1899-1-26,-170
1899,1,27,131,0,131,1899-1-27,-131
1899,1,28,124,0,124,1899-1-28,-124
1899,1,29,71,0,71,1899-1-29,-71
1899,1,30,48,0,48,1899-1-30,-48
1899,1,31,62,0,62,1899-1-31,-62
1899,2,1,103,0,103,1899-2-1,-103
1899,2,2,143,0,143,1899-2-2,-143
1899,2,3,139,0,139,1899-2-3,-139
1899,2,4,57,0,57,1899-2-4,-57
1899,2,5,56,0,56,1899-2-5,-56
1899,2,6,-1,-1,-1,1899-2-6,0
1899,2,7,71,0,71,1899-2-7,-71
1899,2,8,160,0,160,1899-2-8,-160
1899,2,9,161,0,161,1899-2-9,-161
1899,2,10,48,0,48,1899-2-10,-48
1899,2,11,28,0,28,1899-2-11,-28
1899,2,12,0,0,0,1899-2-12,0
1899,2,13,0,0,0,1899-2-13,0
1899,2,14,0,0,0,1899-2-14,0
1899,2,15,0,0,0,1899-2-15,0
1899,2,16,0,0,0,1899-2-16,0
1899,2,17,0,0,0,1899-2-17,0
1899,2,18,0,0,0,1899-2-18,0
1899,2,19,12,0,12,1899-2-19,-12
1899,2,20,5,0,5,1899-2-20,-5
1899,2,21,1,0,1,1899-2-21,-1
1899,2,22,22,0,22,1899-2-22,-22
1899,2,23,0,0,0,1899-2-23,0
1899,2,24,0,0,0,1899-2-24,0
1899,2,25,0,0,0,1899-2-25,0
1899,2,26,0,0,0,1899-2-26,0
1899,2,27,13,0,13,1899-2-27,-13
1899,2,28,63,0,63,1899-2-28,-63
1899,3,1,82,0,82,1899-3-1,-82
1899,3,2,83,0,83,1899-3-2,-83
1899,3,3,303,0,303,1899-3-3,-303
1899,3,4,361,0,361,1899-3-4,-361
1899,3,5,0,0,0,1899-3-5,0
1899,3,6,0,0,0,1899-3-6,0
1899,3,7,0,0,0,1899-3-7,0
1899,3,8,0,0,0,1899-3-8,0
1899,3,9,0,0,0,1899-3-9,0
1899,3,10,0,0,0,1899-3-10,0
1899,3,11,15,15,0,1899-3-11,15
1899,3,12,28,28,0,1899-3-12,28
1899,3,13,25,25,0,1899-3-13,25
1899,3,14,9,9,0,1899-3-14,9
1899,3,15,59,0,59,1899-3-15,-59
1899,3,16,182,0,182,1899-3-16,-182
1899,3,17,453,4,449,1899-3-17,-445
1899,3,18,638,0,638,1899-3-18,-638
1899,3,19,518,0,518,1899-3-19,-518
1899,3,20,627,0,627,1899-3-20,-627
1899,3,21,665,0,665,1899-3-21,-665
1899,3,22,715,20,695,1899-3-22,-675
1899,3,23,552,24,528,1899-3-23,-504
1899,3,24,522,30,492,1899-3-24,-462
1899,3,25,463,0,463,1899-3-25,-463
1899,3,26,491,0,491,1899-3-26,-491
1899,3,27,716,0,716,1899-3-27,-716
1899,3,28,316,0,316,1899-3-28,-316
1899,3,29,285,0,285,1899-3-29,-285
1899,3,30,292,0,292,1899-3-30,-292
1899,3,31,300,0,300,1899-3-31,-300
1899,4,1,277,0,277,1899-4-1,-277
1899,4,2,258,0,258,1899-4-2,-258
1899,4,3,278,0,278,1899-4-3,-278
1899,4,4,229,0,229,1899-4-4,-229
1899,4,5,241,0,241,1899-4-5,-241
1899,4,6,264,0,264,1899-4-6,-264
1899,4,7,244,0,244,1899-4-7,-244
1899,4,8,0,0,0,1899-4-8,0
1899,4,9,116,0,116,1899-4-9,-116
1899,4,10,144,27,117,1899-4-10,-90
1899,4,11,143,23,120,1899-4-11,-97
1899,4,12,188,9,179,1899-4-12,-170
1899,4,13,173,3,170,1899-4-13,-167
1899,4,14,125,0,125,1899-4-14,-125
1899,4,15,127,0,127,1899-4-15,-127
1899,4,16,86,0,86,1899-4-16,-86
1899,4,17,55,0,55,1899-4-17,-55
1899,4,18,31,0,31,1899-4-18,-31
1899,4,19,14,0,14,1899-4-19,-14
1899,4,20,59,59,0,1899-4-20,59
1899,4,21,74,74,0,1899-4-21,74
1899,4,22,44,44,0,1899-4-22,44
1899,4,23,107,18,89,1899-4-23,-71
1899,4,24,158,14,144,1899-4-24,-130
1899,4,25,153,13,140,1899-4-25,-127
1899,4,26,152,13,139,1899-4-26,-126
1899,4,27,167,6,161,1899-4-27,-155
1899,4,28,163,0,163,1899-4-28,-163
1899,4,29,147,0,147,1899-4-29,-147
1899,4,30,95,0,95,1899-4-30,-95
1899,5,1,129,0,129,1899-5-1,-129
1899,5,2,121,0,121,1899-5-2,-121
1899,5,3,113,0,113,1899-5-3,-113
1899,5,4,130,0,130,1899-5-4,-130
1899,5,5,0,0,0,1899-5-5,0
1899,5,6,0,0,0,1899-5-6,0
1899,5,7,0,0,0,1899-5-7,0
1899,5,8,0,0,0,1899-5-8,0
1899,5,9,0,0,0,1899-5-9,0
1899,5,10,0,0,0,1899-5-10,0
1899,5,11,0,0,0,1899-5-11,0
1899,5,12,37,0,37,1899-5-12,-37
1899,5,13,8,0,8,1899-5-13,-8
1899,5,14,0,0,0,1899-5-14,0
1899,5,15,0,0,0,1899-5-15,0
1899,5,16,0,0,0,1899-5-16,0
1899,5,17,0,0,0,1899-5-17,0
1899,5,18,87,0,87,1899-5-18,-87
1899,5,19,44,0,44,1899-5-19,-44
1899,5,20,114,0,114,1899-5-20,-114
1899,5,21,87,0,87,1899-5-21,-87
1899,5,22,90,0,90,1899-5-22,-90
1899,5,23,129,0,129,1899-5-23,-129
1899,5,24,110,0,110,1899-5-24,-110
1899,5,25,81,0,81,1899-5-25,-81
1899,5,26,72,0,72,1899-5-26,-72
1899,5,27,70,0,70,1899-5-27,-70
1899,5,28,61,0,61,1899-5-28,-61
1899,5,29,47,0,47,1899-5-29,-47
1899,5,30,27,0,27,1899-5-30,-27
1899,5,31,14,0,14,1899-5-31,-14
1899,6,1,28,0,28,1899-6-1,-28
1899,6,2,0,0,0,1899-6-2,0
1899,6,3,0,0,0,1899-6-3,0
1899,6,4,49,49,0,1899-6-4,49
1899,6,5,80,80,0,1899-6-5,80
1899,6,6,99,99,0,1899-6-6,99
1899,6,7,111,111,0,1899-6-7,111
1899,6,8,101,101,0,1899-6-8,101
1899,6,9,54,54,0,1899-6-9,54
1899,6,10,117,117,0,1899-6-10,117
1899,6,11,90,90,0,1899-6-11,90
1899,6,12,83,49,34,1899-6-12,15
1899,6,13,93,0,93,1899-6-13,-93
1899,6,14,298,0,298,1899-6-14,-298
1899,6,15,223,0,223,1899-6-15,-223
1899,6,16,188,0,188,1899-6-16,-188
1899,6,17,126,0,126,1899-6-17,-126
1899,6,18,46,0,46,1899-6-18,-46
1899,6,19,26,0,26,1899-6-19,-26
1899,6,20,18,0,18,1899-6-20,-18
1899,6,21,0,0,0,1899-6-21,0
1899,6,22,0,0,0,1899-6-22,0
1899,6,23,336,336,0,1899-6-23,336
1899,6,24,453,453,0,1899-6-24,453
1899,6,25,436,436,0,1899-6-25,436
1899,6,26,637,637,0,1899-6-26,637
1899,6,27,661,661,0,1899-6-27,661
1899,6,28,622,622,0,1899-6-28,622
1899,6,29,569,569,0,1899-6-29,569
1899,6,30,555,555,0,1899-6-30,555
1899,7,1,589,589,0,1899-7-1,589
1899,7,2,401,401,0,1899-7-2,401
1899,7,3,307,307,0,1899-7-3,307
1899,7,4,494,201,293,1899-7-4,-92
1899,7,5,485,69,416,1899-7-5,-347
1899,7,6,423,27,396,1899-7-6,-369
1899,7,7,395,12,383,1899-7-7,-371
1899,7,8,365,3,362,1899-7-8,-359
1899,7,9,363,0,363,1899-7-9,-363
1899,7,10,341,0,341,1899-7-10,-341
1899,7,11,312,0,312,1899-7-11,-312
1899,7,12,289,0,289,1899-7-12,-289
1899,7,13,280,0,280,1899-7-13,-280
1899,7,14,254,18,236,1899-7-14,-218
1899,7,15,235,39,196,1899-7-15,-157
1899,7,16,189,6,183,1899-7-16,-177
1899,7,17,0,0,0,1899-7-17,0
1899,7,18,0,0,0,1899-7-18,0
1899,7,19,0,0,0,1899-7-19,0
1899,7,20,0,0,0,1899-7-20,0
1899,7,21,0,0,0,1899-7-21,0
1899,7,22,0,0,0,1899-7-22,0
1899,7,23,0,0,0,1899-7-23,0
1899,7,24,0,0,0,1899-7-24,0
1899,7,25,0,0,0,1899-7-25,0
1899,7,26,160,0,160,1899-7-26,-160
1899,7,27,108,0,108,1899-7-27,-108
1899,7,28,41,0,41,1899-7-28,-41
1899,7,29,51,0,51,1899-7-29,-51
1899,7,30,28,0,28,1899-7-30,-28
1899,7,31,0,0,0,1899-7-31,0
1899,8,1,10,0,10,1899-8-1,-10
1899,8,2,4,0,4,1899-8-2,-4
1899,8,3,0,0,0,1899-8-3,0
1899,8,4,0,0,0,1899-8-4,0
1899,8,5,0,0,0,1899-8-5,0
1899,8,6,0,0,0,1899-8-6,0
1899,8,7,0,0,0,1899-8-7,0
1899,8,8,0,0,0,1899-8-8,0
1899,8,9,0,0,0,1899-8-9,0
1899,8,10,0,0,0,1899-8-10,0
1899,8,11,0,0,0,1899-8-11,0
1899,8,12,0,0,0,1899-8-12,0
1899,8,13,0,0,0,1899-8-13,0
1899,8,14,0,0,0,1899-8-14,0
1899,8,15,0,0,0,1899-8-15,0
1899,8,16,0,0,0,1899-8-16,0
1899,8,17,0,0,0,1899-8-17,0
1899,8,18,0,0,0,1899-8-18,0
1899,8,19,0,0,0,1899-8-19,0
1899,8,20,0,0,0,1899-8-20,0
1899,8,21,0,0,0,1899-8-21,0
1899,8,22,0,0,0,1899-8-22,0
1899,8,23,0,0,0,1899-8-23,0
1899,8,24,0,0,0,1899-8-24,0
1899,8,25,0,0,0,1899-8-25,0
1899,8,26,0,0,0,1899-8-26,0
1899,8,27,0,0,0,1899-8-27,0
1899,8,28,7,0,7,1899-8-28,-7
1899,8,29,0,0,0,1899-8-29,0
1899,8,30,17,0,17,1899-8-30,-17
1899,8,31,5,0,5,1899-8-31,-5
1899,9,1,0,0,0,1899-9-1,0
1899,9,2,0,0,0,1899-9-2,0
1899,9,3,0,0,0,1899-9-3,0
1899,9,4,16,11,5,1899-9-4,6
1899,9,5,0,0,0,1899-9-5,0
1899,9,6,0,0,0,1899-9-6,0
1899,9,7,0,0,0,1899-9-7,0
1899,9,8,0,0,0,1899-9-8,0
1899,9,9,0,0,0,1899-9-9,0
1899,9,10,0,0,0,1899-9-10,0
1899,9,11,0,0,0,1899-9-11,0
1899,9,12,0,0,0,1899-9-12,0
1899,9,13,7,0,7,1899-9-13,-7
1899,9,14,7,0,7,1899-9-14,-7
1899,9,15,0,0,0,1899-9-15,0
1899,9,16,0,0,0,1899-9-16,0
1899,9,17,0,0,0,1899-9-17,0
1899,9,18,14,0,14,1899-9-18,-14
1899,9,19,16,0,16,1899-9-19,-16
1899,9,20,3,0,3,1899-9-20,-3
1899,9,21,0,0,0,1899-9-21,0
1899,9,22,8,0,8,1899-9-22,-8
1899,9,23,0,0,0,1899-9-23,0
1899,9,24,0,0,0,1899-9-24,0
1899,9,25,0,0,0,1899-9-25,0
1899,9,26,126,42,84,1899-9-26,-42
1899,9,27,235,100,135,1899-9-27,-35
1899,9,28,162,92,70,1899-9-28,22
1899,9,29,146,71,75,1899-9-29,-4
1899,9,30,22,22,0,1899-9-30,22
1899,10,1,25,21,4,1899-10-1,17
1899,10,2,8,0,8,1899-10-2,-8
1899,10,3,0,0,0,1899-10-3,0
1899,10,4,0,0,0,1899-10-4,0
1899,10,5,0,0,0,1899-10-5,0
1899,10,6,0,0,0,1899-10-6,0
1899,10,7,0,0,0,1899-10-7,0
1899,10,8,0,0,0,1899-10-8,0
1899,10,9,12,12,0,1899-10-9,12
1899,10,10,21,21,0,1899-10-10,21
1899,10,11,13,13,0,1899-10-11,13
1899,10,12,11,11,0,1899-10-12,11
1899,10,13,0,0,0,1899-10-13,0
1899,10,14,0,0,0,1899-10-14,0
1899,10,15,0,0,0,1899-10-15,0
1899,10,16,4,4,0,1899-10-16,4
1899,10,17,0,0,0,1899-10-17,0
1899,10,18,0,0,0,1899-10-18,0
1899,10,19,0,0,0,1899-10-19,0
1899,10,20,0,0,0,1899-10-20,0
1899,10,21,0,0,0,1899-10-21,0
1899,10,22,0,0,0,1899-10-22,0
1899,10,23,93,0,93,1899-10-23,-93
1899,10,24,277,0,277,1899-10-24,-277
1899,10,25,286,0,286,1899-10-25,-286
1899,10,26,317,0,317,1899-10-26,-317
1899,10,27,452,0,452,1899-10-27,-452
1899,10,28,345,0,345,1899-10-28,-345
1899,10,29,254,0,254,1899-10-29,-254
1899,10,30,145,0,145,1899-10-30,-145
1899,10,31,56,0,56,1899-10-31,-56
1899,11,1,21,0,21,1899-11-1,-21
1899,11,2,17,0,17,1899-11-2,-17
1899,11,3,0,0,0,1899-11-3,0
1899,11,4,0,0,0,1899-11-4,0
1899,11,5,0,0,0,1899-11-5,0
1899,11,6,0,0,0,1899-11-6,0
1899,11,7,0,0,0,1899-11-7,0
1899,11,8,0,0,0,1899-11-8,0
1899,11,9,0,0,0,1899-11-9,0
1899,11,10,0,0,0,1899-11-10,0
1899,11,11,105,0,105,1899-11-11,-105
1899,11,12,113,0,113,1899-11-12,-113
1899,11,13,118,4,114,1899-11-13,-110
1899,11,14,107,0,107,1899-11-14,-107
1899,11,15,114,0,114,1899-11-15,-114
1899,11,16,64,0,64,1899-11-16,-64
1899,11,17,63,14,49,1899-11-17,-35
1899,11,18,109,77,32,1899-11-18,45
1899,11,19,41,15,26,1899-11-19,-11
1899,11,20,14,2,12,1899-11-20,-10
1899,11,21,7,0,7,1899-11-21,-7
1899,11,22,0,0,0,1899-11-22,0
1899,11,23,0,0,0,1899-11-23,0
1899,11,24,0,0,0,1899-11-24,0
1899,11,25,22,0,22,1899-11-25,-22
1899,11,26,9,0,9,1899-11-26,-9
1899,11,27,2,0,2,1899-11-27,-2
1899,11,28,16,0,16,1899-11-28,-16
1899,11,29,23,0,23,1899-11-29,-23
1899,11,30,21,0,21,1899-11-30,-21
1899,12,1,21,0,21,1899-12-1,-21
1899,12,2,12,0,12,1899-12-2,-12
1899,12,3,11,0,11,1899-12-3,-11
1899,12,4,22,0,22,1899-12-4,-22
1899,12,5,69,0,69,1899-12-5,-69
1899,12,6,131,0,131,1899-12-6,-131
1899,12,7,81,0,81,1899-12-7,-81
1899,12,8,30,0,30,1899-12-8,-30
1899,12,9,9,0,9,1899-12-9,-9
1899,12,10,0,0,0,1899-12-10,0
1899,12,11,0,0,0,1899-12-11,0
1899,12,12,143,143,0,1899-12-12,143
1899,12,13,219,181,38,1899-12-13,143
1899,12,14,209,165,44,1899-12-14,121
1899,12,15,281,127,154,1899-12-15,-27
1899,12,16,149,80,69,1899-12-16,11
1899,12,17,77,30,47,1899-12-17,-17
1899,12,18,91,23,68,1899-12-18,-45
1899,12,19,43,11,32,1899-12-19,-21
1899,12,20,15,11,4,1899-12-20,7
1899,12,21,6,6,0,1899-12-21,6
1899,12,22,0,0,0,1899-12-22,0
1899,12,23,0,0,0,1899-12-23,0
1899,12,24,0,0,0,1899-12-24,0
1899,12,25,0,0,0,1899-12-25,0
1899,12,26,0,0,0,1899-12-26,0
1899,12,27,0,0,0,1899-12-27,0
1899,12,28,0,0,0,1899-12-28,0
1899,12,29,28,0,28,1899-12-29,-28
1899,12,30,20,0,20,1899-12-30,-20
1899,12,31,12,0,12,1899-12-31,-12
1900,1,1,11,0,11,1900-1-1,-11
1900,1,2,29,0,29,1900-1-2,-29
1900,1,3,0,0,0,1900-1-3,0
1900,1,4,0,0,0,1900-1-4,0
1900,1,5,0,0,0,1900-1-5,0
1900,1,6,0,0,0,1900-1-6,0
1900,1,7,0,0,0,1900-1-7,0
1900,1,8,0,0,0,1900-1-8,0
1900,1,9,0,0,0,1900-1-9,0
1900,1,10,0,0,0,1900-1-10,0
1900,1,11,0,0,0,1900-1-11,0
1900,1,12,109,109,0,1900-1-12,109
1900,1,13,331,331,0,1900-1-13,331
1900,1,14,159,159,0,1900-1-14,159
1900,1,15,150,150,0,1900-1-15,150
1900,1,16,67,67,0,1900-1-16,67
1900,1,17,40,40,0,1900-1-17,40
1900,1,18,18,18,0,1900-1-18,18
1900,1,19,6,6,0,1900-1-19,6
1900,1,20,0,0,0,1900-1-20,0
1900,1,21,0,0,0,1900-1-21,0
1900,1,22,0,0,0,1900-1-22,0
1900,1,23,0,0,0,1900-1-23,0
1900,1,24,51,26,25,1900-1-24,1
1900,1,25,44,0,44,1900-1-25,-44
1900,1,26,49,0,49,1900-1-26,-49
1900,1,27,27,0,27,1900-1-27,-27
1900,1,28,152,120,32,1900-1-28,88
1900,1,29,153,134,19,1900-1-29,115
1900,1,30,135,135,0,1900-1-30,135
1900,1,31,219,219,0,1900-1-31,219
1900,2,1,163,163,0,1900-2-1,163
1900,2,2,-1,-1,-1,1900-2-2,0
1900,2,3,149,149,0,1900-2-3,149
1900,2,4,601,601,0,1900-2-4,601
1900,2,5,544,544,0,1900-2-5,544
1900,2,6,509,483,26,1900-2-6,457
1900,2,7,-1,-1,-1,1900-2-7,0
1900,2,8,337,290,47,1900-2-8,243
1900,2,9,178,151,27,1900-2-9,124
1900,2,10,143,143,0,1900-2-10,143
1900,2,11,161,55,106,1900-2-11,-51
1900,2,12,50,31,19,1900-2-12,12
1900,2,13,13,0,13,1900-2-13,-13
1900,2,14,9,9,0,1900-2-14,9
1900,2,15,0,0,0,1900-2-15,0
1900,2,16,0,0,0,1900-2-16,0
1900,2,17,0,0,0,1900-2-17,0
1900,2,18,0,0,0,1900-2-18,0
1900,2,19,0,0,0,1900-2-19,0
1900,2,20,0,0,0,1900-2-20,0
1900,2,21,0,0,0,1900-2-21,0
1900,2,22,0,0,0,1900-2-22,0
1900,2,23,0,0,0,1900-2-23,0
1900,2,24,0,0,0,1900-2-24,0
1900,2,25,0,0,0,1900-2-25,0
1900,2,26,0,0,0,1900-2-26,0
1900,2,27,0,0,0,1900-2-27,0
1900,2,28,0,0,0,1900-2-28,0
1900,3,1,0,0,0,1900-3-1,0
1900,3,2,0,0,0,1900-3-2,0
1900,3,3,17,17,0,1900-3-3,17
1900,3,4,36,32,4,1900-3-4,28
1900,3,5,10,10,0,1900-3-5,10
1900,3,6,141,0,141,1900-3-6,-141
1900,3,7,511,0,511,1900-3-7,-511
1900,3,8,750,0,750,1900-3-8,-750
1900,3,9,689,0,689,1900-3-9,-689
1900,3,10,624,0,624,1900-3-10,-624
1900,3,11,427,0,427,1900-3-11,-427
1900,3,12,0,0,0,1900-3-12,0
1900,3,13,0,0,0,1900-3-13,0
1900,3,14,0,0,0,1900-3-14,0
1900,3,15,0,0,0,1900-3-15,0
1900,3,16,0,0,0,1900-3-16,0
1900,3,17,0,0,0,1900-3-17,0
1900,3,18,0,0,0,1900-3-18,0
1900,3,19,0,0,0,1900-3-19,0
1900,3,20,0,0,0,1900-3-20,0
1900,3,21,0,0,0,1900-3-21,0
1900,3,22,0,0,0,1900-3-22,0
1900,3,23,0,0,0,1900-3-23,0
1900,3,24,0,0,0,1900-3-24,0
1900,3,25,4,4,0,1900-3-25,4
1900,3,26,332,2,330,1900-3-26,-328
1900,3,27,204,0,204,1900-3-27,-204
1900,3,28,222,0,222,1900-3-28,-222
1900,3,29,245,12,233,1900-3-29,-221
1900,3,30,264,55,209,1900-3-30,-154
1900,3,31,220,0,220,1900-3-31,-220
1900,4,1,136,0,136,1900-4-1,-136
1900,4,2,155,0,155,1900-4-2,-155
1900,4,3,144,0,144,1900-4-3,-144
1900,4,4,109,0,109,1900-4-4,-109
1900,4,5,129,0,129,1900-4-5,-129
1900,4,6,79,0,79,1900-4-6,-79
1900,4,7,103,0,103,1900-4-7,-103
1900,4,8,51,51,0,1900-4-8,51
1900,4,9,48,48,0,1900-4-9,48
1900,4,10,23,23,0,1900-4-10,23
1900,4,11,15,15,0,1900-4-11,15
1900,4,12,24,24,0,1900-4-12,24
1900,4,13,15,15,0,1900-4-13,15
1900,4,14,13,13,0,1900-4-14,13
1900,4,15,3,3,0,1900-4-15,3
1900,4,16,0,0,0,1900-4-16,0
1900,4,17,0,0,0,1900-4-17,0
1900,4,18,0,0,0,1900-4-18,0
1900,4,19,47,47,0,1900-4-19,47
1900,4,20,41,41,0,1900-4-20,41
1900,4,21,32,32,0,1900-4-21,32
1900,4,22,18,18,0,1900-4-22,18
1900,4,23,20,20,0,1900-4-23,20
1900,4,24,49,16,33,1900-4-24,-17
1900,4,25,89,20,69,1900-4-25,-49
1900,4,26,66,24,42,1900-4-26,-18
1900,4,27,74,7,67,1900-4-27,-60
1900,4,28,265,0,265,1900-4-28,-265
1900,4,29,434,48,386,1900-4-29,-338
1900,4,30,739,151,588,1900-4-30,-437
1900,5,1,681,128,553,1900-5-1,-425
1900,5,2,624,161,463,1900-5-2,-302
1900,5,3,503,54,449,1900-5-3,-395
1900,5,4,253,10,243,1900-5-4,-233
1900,5,5,199,21,178,1900-5-5,-157
1900,5,6,157,0,157,1900-5-6,-157
1900,5,7,75,0,75,1900-5-7,-75
1900,5,8,38,0,38,1900-5-8,-38
1900,5,9,0,0,0,1900-5-9,0
1900,5,10,0,0,0,1900-5-10,0
1900,5,11,0,0,0,1900-5-11,0
1900,5,12,0,0,0,1900-5-12,0
1900,5,13,0,0,0,1900-5-13,0
1900,5,14,21,0,21,1900-5-14,-21
1900,5,15,16,0,16,1900-5-15,-16
1900,5,16,0,0,0,1900-5-16,0
1900,5,17,0,0,0,1900-5-17,0
1900,5,18,0,0,0,1900-5-18,0
1900,5,19,0,0,0,1900-5-19,0
1900,5,20,0,0,0,1900-5-20,0
1900,5,21,104,104,0,1900-5-21,104
1900,5,22,233,233,0,1900-5-22,233
1900,5,23,227,227,0,1900-5-23,227
1900,5,24,211,211,0,1900-5-24,211
1900,5,25,154,154,0,1900-5-25,154
1900,5,26,124,124,0,1900-5-26,124
1900,5,27,81,50,31,1900-5-27,19
1900,5,28,87,55,32,1900-5-28,23
1900,5,29,54,42,12,1900-5-29,30
1900,5,30,60,27,33,1900-5-30,-6
1900,5,31,53,16,37,1900-5-31,-21
1900,6,1,62,9,53,1900-6-1,-44
1900,6,2,0,0,0,1900-6-2,0
1900,6,3,95,0,95,1900-6-3,-95
1900,6,4,0,0,0,1900-6-4,0
1900,6,5,0,0,0,1900-6-5,0
1900,6,6,0,0,0,1900-6-6,0
1900,6,7,0,0,0,1900-6-7,0
1900,6,8,0,0,0,1900-6-8,0
1900,6,9,0,0,0,1900-6-9,0
1900,6,10,0,0,0,1900-6-10,0
1900,6,11,0,0,0,1900-6-11,0
1900,6,12,0,0,0,1900-6-12,0
1900,6,13,0,0,0,1900-6-13,0
1900,6,14,0,0,0,1900-6-14,0
1900,6,15,24,24,0,1900-6-15,24
1900,6,16,192,192,0,1900-6-16,192
1900,6,17,261,261,0,1900-6-17,261
1900,6,18,309,309,0,1900-6-18,309
1900,6,19,202,169,33,1900-6-19,136
1900,6,20,342,246,96,1900-6-20,150
1900,6,21,270,221,49,1900-6-21,172
1900,6,22,303,256,47,1900-6-22,209
1900,6,23,66,47,19,1900-6-23,28
1900,6,24,124,108,16,1900-6-24,92
1900,6,25,9,0,9,1900-6-25,-9
1900,6,26,12,0,12,1900-6-26,-12
1900,6,27,0,0,0,1900-6-27,0
1900,6,28,0,0,0,1900-6-28,0
1900,6,29,443,0,443,1900-6-29,-443
1900,6,30,698,0,698,1900-6-30,-698
1900,7,1,434,0,434,1900-7-1,-434
1900,7,2,0,0,0,1900-7-2,0
1900,7,3,61,61,0,1900-7-3,61
1900,7,4,86,86,0,1900-7-4,86
1900,7,5,0,0,0,1900-7-5,0
1900,7,6,0,0,0,1900-7-6,0
1900,7,7,0,0,0,1900-7-7,0
1900,7,8,0,0,0,1900-7-8,0
1900,7,9,0,0,0,1900-7-9,0
1900,7,10,0,0,0,1900-7-10,0
1900,7,11,0,0,0,1900-7-11,0
1900,7,12,0,0,0,1900-7-12,0
1900,7,13,0,0,0,1900-7-13,0
1900,7,14,0,0,0,1900-7-14,0
1900,7,15,83,0,83,1900-7-15,-83
1900,7,16,95,0,95,1900-7-16,-95
1900,7,17,123,0,123,1900-7-17,-123
1900,7,18,160,0,160,1900-7-18,-160
1900,7,19,146,0,146,1900-7-19,-146
1900,7,20,145,14,131,1900-7-20,-117
1900,7,21,99,17,82,1900-7-21,-65
1900,7,22,57,9,48,1900-7-22,-39
1900,7,23,45,10,35,1900-7-23,-25
1900,7,24,37,0,37,1900-7-24,-37
1900,7,25,26,0,26,1900-7-25,-26
1900,7,26,0,0,0,1900-7-26,0
1900,7,27,0,0,0,1900-7-27,0
1900,7,28,0,0,0,1900-7-28,0
1900,7,29,0,0,0,1900-7-29,0
1900,7,30,0,0,0,1900-7-30,0
1900,7,31,0,0,0,1900-7-31,0
1900,8,1,0,0,0,1900-8-1,0
1900,8,2,0,0,0,1900-8-2,0
1900,8,3,0,0,0,1900-8-3,0
1900,8,4,0,0,0,1900-8-4,0
1900,8,5,0,0,0,1900-8-5,0
1900,8,6,0,0,0,1900-8-6,0
1900,8,7,17,17,0,1900-8-7,17
1900,8,8,17,17,0,1900-8-8,17
1900,8,9,14,14,0,1900-8-9,14
1900,8,10,14,14,0,1900-8-10,14
1900,8,11,133,133,0,1900-8-11,133
1900,8,12,102,102,0,1900-8-12,102
1900,8,13,35,35,0,1900-8-13,35
1900,8,14,0,0,0,1900-8-14,0
1900,8,15,0,0,0,1900-8-15,0
1900,8,16,0,0,0,1900-8-16,0
1900,8,17,0,0,0,1900-8-17,0
1900,8,18,0,0,0,1900-8-18,0
1900,8,19,0,0,0,1900-8-19,0
1900,8,20,0,0,0,1900-8-20,0
1900,8,21,0,0,0,1900-8-21,0
1900,8,22,0,0,0,1900-8-22,0
1900,8,23,0,0,0,1900-8-23,0
1900,8,24,0,0,0,1900-8-24,0
1900,8,25,0,0,0,1900-8-25,0
1900,8,26,0,0,0,1900-8-26,0
1900,8,27,0,0,0,1900-8-27,0
1900,8,28,0,0,0,1900-8-28,0
1900,8,29,0,0,0,1900-8-29,0
1900,8,30,0,0,0,1900-8-30,0
1900,8,31,0,0,0,1900-8-31,0
1900,9,1,0,0,0,1900-9-1,0
1900,9,2,0,0,0,1900-9-2,0
1900,9,3,38,30,8,1900-9-3,22
1900,9,4,139,32,107,1900-9-4,-75
1900,9,5,164,24,140,1900-9-5,-116
1900,9,6,143,36,107,1900-9-6,-71
1900,9,7,96,43,53,1900-9-7,-10
1900,9,8,42,9,33,1900-9-8,-24
1900,9,9,28,0,28,1900-9-9,-28
1900,9,10,24,0,24,1900-9-10,-24
1900,9,11,19,0,19,1900-9-11,-19
1900,9,12,0,0,0,1900-9-12,0
1900,9,13,0,0,0,1900-9-13,0
1900,9,14,0,0,0,1900-9-14,0
1900,9,15,0,0,0,1900-9-15,0
1900,9,16,0,0,0,1900-9-16,0
1900,9,17,0,0,0,1900-9-17,0
1900,9,18,0,0,0,1900-9-18,0
1900,9,19,0,0,0,1900-9-19,0
1900,9,20,0,0,0,1900-9-20,0
1900,9,21,0,0,0,1900-9-21,0
1900,9,22,0,0,0,1900-9-22,0
1900,9,23,0,0,0,1900-9-23,0
1900,9,24,0,0,0,1900-9-24,0
1900,9,25,0,0,0,1900-9-25,0
1900,9,26,0,0,0,1900-9-26,0
1900,9,27,0,0,0,1900-9-27,0
1900,9,28,0,0,0,1900-9-28,0
1900,9,29,0,0,0,1900-9-29,0
1900,9,30,0,0,0,1900-9-30,0
1900,10,1,0,0,0,1900-10-1,0
1900,10,2,0,0,0,1900-10-2,0
1900,10,3,0,0,0,1900-10-3,0
1900,10,4,0,0,0,1900-10-4,0
1900,10,5,0,0,0,1900-10-5,0
1900,10,6,0,0,0,1900-10-6,0
1900,10,7,10,0,10,1900-10-7,-10
1900,10,8,70,0,70,1900-10-8,-70
1900,10,9,82,0,82,1900-10-9,-82
1900,10,10,117,0,117,1900-10-10,-117
1900,10,11,188,0,188,1900-10-11,-188
1900,10,12,70,0,70,1900-10-12,-70
1900,10,13,0,0,0,1900-10-13,0
1900,10,14,0,0,0,1900-10-14,0
1900,10,15,0,0,0,1900-10-15,0
1900,10,16,95,0,95,1900-10-16,-95
1900,10,17,410,0,410,1900-10-17,-410
1900,10,18,483,0,483,1900-10-18,-483
1900,10,19,312,0,312,1900-10-19,-312
1900,10,20,445,0,445,1900-10-20,-445
1900,10,21,323,0,323,1900-10-21,-323
1900,10,22,288,0,288,1900-10-22,-288
1900,10,23,312,0,312,1900-10-23,-312
1900,10,24,191,0,191,1900-10-24,-191
1900,10,25,215,0,215,1900-10-25,-215
1900,10,26,230,0,230,1900-10-26,-230
1900,10,27,278,0,278,1900-10-27,-278
1900,10,28,136,0,136,1900-10-28,-136
1900,10,29,18,0,18,1900-10-29,-18
1900,10,30,12,0,12,1900-10-30,-12
1900,10,31,0,0,0,1900-10-31,0
1900,11,1,0,0,0,1900-11-1,0
1900,11,2,0,0,0,1900-11-2,0
1900,11,3,0,0,0,1900-11-3,0
1900,11,4,0,0,0,1900-11-4,0
1900,11,5,0,0,0,1900-11-5,0
1900,11,6,0,0,0,1900-11-6,0
1900,11,7,0,0,0,1900-11-7,0
1900,11,8,0,0,0,1900-11-8,0
1900,11,9,0,0,0,1900-11-9,0
1900,11,10,0,0,0,1900-11-10,0
1900,11,11,0,0,0,1900-11-11,0
1900,11,12,0,0,0,1900-11-12,0
1900,11,13,12,0,12,1900-11-13,-12
1900,11,14,10,0,10,1900-11-14,-10
1900,11,15,0,0,0,1900-11-15,0
1900,11,16,0,0,0,1900-11-16,0
1900,11,17,0,0,0,1900-11-17,0
1900,11,18,27,27,0,1900-11-18,27
1900,11,19,92,92,0,1900-11-19,92
1900,11,20,68,68,0,1900-11-20,68
1900,11,21,94,94,0,1900-11-21,94
1900,11,22,25,25,0,1900-11-22,25
1900,11,23,20,20,0,1900-11-23,20
1900,11,24,0,0,0,1900-11-24,0
1900,11,25,0,0,0,1900-11-25,0
1900,11,26,0,0,0,1900-11-26,0
1900,11,27,0,0,0,1900-11-27,0
1900,11,28,0,0,0,1900-11-28,0
1900,11,29,0,0,0,1900-11-29,0
1900,11,30,0,0,0,1900-11-30,0
1900,12,1,0,0,0,1900-12-1,0
1900,12,2,0,0,0,1900-12-2,0
1900,12,3,0,0,0,1900-12-3,0
1900,12,4,0,0,0,1900-12-4,0
1900,12,5,0,0,0,1900-12-5,0
1900,12,6,0,0,0,1900-12-6,0
1900,12,7,0,0,0,1900-12-7,0
1900,12,8,0,0,0,1900-12-8,0
1900,12,9,0,0,0,1900-12-9,0
1900,12,10,0,0,0,1900-12-10,0
1900,12,11,0,0,0,1900-12-11,0
1900,12,12,0,0,0,1900-12-12,0
1900,12,13,0,0,0,1900-12-13,0
1900,12,14,0,0,0,1900-12-14,0
1900,12,15,0,0,0,1900-12-15,0
1900,12,16,0,0,0,1900-12-16,0
1900,12,17,0,0,0,1900-12-17,0
1900,12,18,0,0,0,1900-12-18,0
1900,12,19,0,0,0,1900-12-19,0
1900,12,20,0,0,0,1900-12-20,0
1900,12,21,0,0,0,1900-12-21,0
1900,12,22,0,0,0,1900-12-22,0
1900,12,23,0,0,0,1900-12-23,0
1900,12,24,0,0,0,1900-12-24,0
1900,12,25,0,0,0,1900-12-25,0
1900,12,26,0,0,0,1900-12-26,0
1900,12,27,0,0,0,1900-12-27,0
1900,12,28,0,0,0,1900-12-28,0
1900,12,29,0,0,0,1900-12-29,0
1900,12,30,0,0,0,1900-12-30,0
1900,12,31,0,0,0,1900-12-31,0
1901,1,1,0,0,0,1901-1-1,0
1901,1,2,0,0,0,1901-1-2,0
1901,1,3,0,0,0,1901-1-3,0
1901,1,4,0,0,0,1901-1-4,0
1901,1,5,0,0,0,1901-1-5,0
1901,1,6,0,0,0,1901-1-6,0
1901,1,7,0,0,0,1901-1-7,0
1901,1,8,0,0,0,1901-1-8,0
1901,1,9,0,0,0,1901-1-9,0
1901,1,10,0,0,0,1901-1-10,0
1901,1,11,0,0,0,1901-1-11,0
1901,1,12,0,0,0,1901-1-12,0
1901,1,13,0,0,0,1901-1-13,0
1901,1,14,7,0,7,1901-1-14,-7
1901,1,15,0,0,0,1901-1-15,0
1901,1,16,0,0,0,1901-1-16,0
1901,1,17,0,0,0,1901-1-17,0
1901,1,18,0,0,0,1901-1-18,0
1901,1,19,0,0,0,1901-1-19,0
1901,1,20,0,0,0,1901-1-20,0
1901,1,21,0,0,0,1901-1-21,0
1901,1,22,0,0,0,1901-1-22,0
1901,1,23,0,0,0,1901-1-23,0
1901,1,24,0,0,0,1901-1-24,0
1901,1,25,0,0,0,1901-1-25,0
1901,1,26,0,0,0,1901-1-26,0
1901,1,27,0,0,0,1901-1-27,0
1901,1,28,0,0,0,1901-1-28,0
1901,1,29,0,0,0,1901-1-29,0
1901,1,30,0,0,0,1901-1-30,0
1901,1,31,0,0,0,1901-1-31,0
1901,2,1,0,0,0,1901-2-1,0
1901,2,2,0,0,0,1901-2-2,0
1901,2,3,0,0,0,1901-2-3,0
1901,2,4,58,0,58,1901-2-4,-58
1901,2,5,40,0,40,1901-2-5,-40
1901,2,6,25,0,25,1901-2-6,-25
1901,2,7,22,0,22,1901-2-7,-22
1901,2,8,18,0,18,1901-2-8,-18
1901,2,9,10,0,10,1901-2-9,-10
1901,2,10,0,0,0,1901-2-10,0
1901,2,11,0,0,0,1901-2-11,0
1901,2,12,5,0,5,1901-2-12,-5
1901,2,13,0,0,0,1901-2-13,0
1901,2,14,0,0,0,1901-2-14,0
1901,2,15,0,0,0,1901-2-15,0
1901,2,16,0,0,0,1901-2-16,0
1901,2,17,0,0,0,1901-2-17,0
1901,2,18,0,0,0,1901-2-18,0
1901,2,19,0,0,0,1901-2-19,0
1901,2,20,0,0,0,1901-2-20,0
1901,2,21,0,0,0,1901-2-21,0
1901,2,22,0,0,0,1901-2-22,0
1901,2,23,0,0,0,1901-2-23,0
1901,2,24,0,0,0,1901-2-24,0
1901,2,25,0,0,0,1901-2-25,0
1901,2,26,0,0,0,1901-2-26,0
1901,2,27,0,0,0,1901-2-27,0
1901,2,28,0,0,0,1901-2-28,0
1901,3,1,0,0,0,1901-3-1,0
1901,3,2,0,0,0,1901-3-2,0
1901,3,3,16,0,16,1901-3-3,-16
1901,3,4,53,37,16,1901-3-4,21
1901,3,5,27,27,0,1901-3-5,27
1901,3,6,62,62,0,1901-3-6,62
1901,3,7,18,18,0,1901-3-7,18
1901,3,8,53,53,0,1901-3-8,53
1901,3,9,113,113,0,1901-3-9,113
1901,3,10,71,71,0,1901-3-10,71
1901,3,11,0,0,0,1901-3-11,0
1901,3,12,0,0,0,1901-3-12,0
1901,3,13,0,0,0,1901-3-13,0
1901,3,14,0,0,0,1901-3-14,0
1901,3,15,0,0,0,1901-3-15,0
1901,3,16,0,0,0,1901-3-16,0
1901,3,17,0,0,0,1901-3-17,0
1901,3,18,0,0,0,1901-3-18,0
1901,3,19,0,0,0,1901-3-19,0
1901,3,20,0,0,0,1901-3-20,0
1901,3,21,0,0,0,1901-3-21,0
1901,3,22,0,0,0,1901-3-22,0
1901,3,23,0,0,0,1901-3-23,0
1901,3,24,0,0,0,1901-3-24,0
1901,3,25,0,0,0,1901-3-25,0
1901,3,26,0,0,0,1901-3-26,0
1901,3,27,0,0,0,1901-3-27,0
1901,3,28,0,0,0,1901-3-28,0
1901,3,29,0,0,0,1901-3-29,0
1901,3,30,0,0,0,1901-3-30,0
1901,3,31,0,0,0,1901-3-31,0
1901,4,1,0,0,0,1901-4-1,0
1901,4,2,0,0,0,1901-4-2,0
1901,4,3,0,0,0,1901-4-3,0
1901,4,4,0,0,0,1901-4-4,0
1901,4,5,0,0,0,1901-4-5,0
1901,4,6,0,0,0,1901-4-6,0
1901,4,7,0,0,0,1901-4-7,0
1901,4,8,0,0,0,1901-4-8,0
1901,4,9,0,0,0,1901-4-9,0
1901,4,10,0,0,0,1901-4-10,0
1901,4,11,0,0,0,1901-4-11,0
1901,4,12,0,0,0,1901-4-12,0
1901,4,13,0,0,0,1901-4-13,0
1901,4,14,0,0,0,1901-4-14,0
1901,4,15,0,0,0,1901-4-15,0
1901,4,16,0,0,0,1901-4-16,0
1901,4,17,0,0,0,1901-4-17,0
1901,4,18,0,0,0,1901-4-18,0
1901,4,19,0,0,0,1901-4-19,0
1901,4,20,0,0,0,1901-4-20,0
1901,4,21,0,0,0,1901-4-21,0
1901,4,22,0,0,0,1901-4-22,0
1901,4,23,0,0,0,1901-4-23,0
1901,4,24,0,0,0,1901-4-24,0
1901,4,25,0,0,0,1901-4-25,0
1901,4,26,0,0,0,1901-4-26,0
1901,4,27,0,0,0,1901-4-27,0
1901,4,28,0,0,0,1901-4-28,0
1901,4,29,0,0,0,1901-4-29,0
1901,4,30,0,0,0,1901-4-30,0
1901,5,1,0,0,0,1901-5-1,0
1901,5,2,0,0,0,1901-5-2,0
1901,5,3,0,0,0,1901-5-3,0
1901,5,4,0,0,0,1901-5-4,0
1901,5,5,0,0,0,1901-5-5,0
1901,5,6,0,0,0,1901-5-6,0
1901,5,7,0,0,0,1901-5-7,0
1901,5,8,0,0,0,1901-5-8,0
1901,5,9,0,0,0,1901-5-9,0
1901,5,10,0,0,0,1901-5-10,0
1901,5,11,0,0,0,1901-5-11,0
1901,5,12,0,0,0,1901-5-12,0
1901,5,13,0,0,0,1901-5-13,0
1901,5,14,0,0,0,1901-5-14,0
1901,5,15,0,0,0,1901-5-15,0
1901,5,16,0,0,0,1901-5-16,0
1901,5,17,0,0,0,1901-5-17,0
1901,5,18,0,0,0,1901-5-18,0
1901,5,19,133,133,0,1901-5-19,133
1901,5,20,352,352,0,1901-5-20,352
1901,5,21,564,564,0,1901-5-21,564
1901,5,22,699,699,0,1901-5-22,699
1901,5,23,688,688,0,1901-5-23,688
1901,5,24,584,584,0,1901-5-24,584
1901,5,25,591,591,0,1901-5-25,591
1901,5,26,568,568,0,1901-5-26,568
1901,5,27,532,532,0,1901-5-27,532
1901,5,28,655,655,0,1901-5-28,655
1901,5,29,527,527,0,1901-5-29,527
1901,5,30,357,357,0,1901-5-30,357
1901,5,31,213,213,0,1901-5-31,213
1901,6,1,0,0,0,1901-6-1,0
1901,6,2,0,0,0,1901-6-2,0
1901,6,3,3,3,0,1901-6-3,3
1901,6,4,0,0,0,1901-6-4,0
1901,6,5,0,0,0,1901-6-5,0
1901,6,6,0,0,0,1901-6-6,0
1901,6,7,0,0,0,1901-6-7,0
1901,6,8,0,0,0,1901-6-8,0
1901,6,9,0,0,0,1901-6-9,0
1901,6,10,0,0,0,1901-6-10,0
1901,6,11,0,0,0,1901-6-11,0
1901,6,12,0,0,0,1901-6-12,0
1901,6,13,0,0,0,1901-6-13,0
1901,6,14,0,0,0,1901-6-14,0
1901,6,15,0,0,0,1901-6-15,0
1901,6,16,135,135,0,1901-6-16,135
1901,6,17,122,122,0,1901-6-17,122
1901,6,18,89,89,0,1901-6-18,89
1901,6,19,152,152,0,1901-6-19,152
1901,6,20,99,99,0,1901-6-20,99
1901,6,21,105,105,0,1901-6-21,105
1901,6,22,94,90,4,1901-6-22,86
1901,6,23,133,99,34,1901-6-23,65
1901,6,24,159,66,93,1901-6-24,-27
1901,6,25,135,34,101,1901-6-25,-67
1901,6,26,21,21,0,1901-6-26,21
1901,6,27,0,0,0,1901-6-27,0
1901,6,28,0,0,0,1901-6-28,0
1901,6,29,0,0,0,1901-6-29,0
1901,6,30,0,0,0,1901-6-30,0
1901,7,1,0,0,0,1901-7-1,0
1901,7,2,0,0,0,1901-7-2,0
1901,7,3,0,0,0,1901-7-3,0
1901,7,4,0,0,0,1901-7-4,0
1901,7,5,0,0,0,1901-7-5,0
1901,7,6,0,0,0,1901-7-6,0
1901,7,7,0,0,0,1901-7-7,0
1901,7,8,4,0,4,1901-7-8,-4
1901,7,9,0,0,0,1901-7-9,0
1901,7,10,0,0,0,1901-7-10,0
1901,7,11,0,0,0,1901-7-11,0
1901,7,12,0,0,0,1901-7-12,0
1901,7,13,0,0,0,1901-7-13,0
1901,7,14,0,0,0,1901-7-14,0
1901,7,15,0,0,0,1901-7-15,0
1901,7,16,0,0,0,1901-7-16,0
1901,7,17,0,0,0,1901-7-17,0
1901,7,18,0,0,0,1901-7-18,0
1901,7,19,0,0,0,1901-7-19,0
1901,7,20,0,0,0,1901-7-20,0
1901,7,21,0,0,0,1901-7-21,0
1901,7,22,11,0,11,1901-7-22,-11
1901,7,23,10,0,10,1901-7-23,-10
1901,7,24,5,0,5,1901-7-24,-5
1901,7,25,0,0,0,1901-7-25,0
1901,7,26,0,0,0,1901-7-26,0
1901,7,27,0,0,0,1901-7-27,0
1901,7,28,0,0,0,1901-7-28,0
1901,7,29,0,0,0,1901-7-29,0
1901,7,30,0,0,0,1901-7-30,0
1901,7,31,0,0,0,1901-7-31,0
1901,8,1,0,0,0,1901-8-1,0
1901,8,2,0,0,0,1901-8-2,0
1901,8,3,0,0,0,1901-8-3,0
1901,8,4,0,0,0,1901-8-4,0
1901,8,5,0,0,0,1901-8-5,0
1901,8,6,0,0,0,1901-8-6,0
1901,8,7,0,0,0,1901-8-7,0
1901,8,8,0,0,0,1901-8-8,0
1901,8,9,0,0,0,1901-8-9,0
1901,8,10,0,0,0,1901-8-10,0
1901,8,11,0,0,0,1901-8-11,0
1901,8,12,0,0,0,1901-8-12,0
1901,8,13,0,0,0,1901-8-13,0
1901,8,14,0,0,0,1901-8-14,0
1901,8,15,0,0,0,1901-8-15,0
1901,8,16,0,0,0,1901-8-16,0
1901,8,17,0,0,0,1901-8-17,0
1901,8,18,0,0,0,1901-8-18,0
1901,8,19,0,0,0,1901-8-19,0
1901,8,20,0,0,0,1901-8-20,0
1901,8,21,0,0,0,1901-8-21,0
1901,8,22,0,0,0,1901-8-22,0
1901,8,23,0,0,0,1901-8-23,0
1901,8,24,0,0,0,1901-8-24,0
1901,8,25,0,0,0,1901-8-25,0
1901,8,26,0,0,0,1901-8-26,0
1901,8,27,0,0,0,1901-8-27,0
1901,8,28,0,0,0,1901-8-28,0
1901,8,29,0,0,0,1901-8-29,0
1901,8,30,0,0,0,1901-8-30,0
1901,8,31,0,0,0,1901-8-31,0
1901,9,1,0,0,0,1901-9-1,0
1901,9,2,0,0,0,1901-9-2,0
1901,9,3,0,0,0,1901-9-3,0
1901,9,4,0,0,0,1901-9-4,0
1901,9,5,0,0,0,1901-9-5,0
1901,9,6,0,0,0,1901-9-6,0
1901,9,7,0,0,0,1901-9-7,0
1901,9,8,0,0,0,1901-9-8,0
1901,9,9,0,0,0,1901-9-9,0
1901,9,10,0,0,0,1901-9-10,0
1901,9,11,0,0,0,1901-9-11,0
1901,9,12,7,7,0,1901-9-12,7
1901,9,13,0,0,0,1901-9-13,0
1901,9,14,0,0,0,1901-9-14,0
1901,9,15,0,0,0,1901-9-15,0
1901,9,16,0,0,0,1901-9-16,0
1901,9,17,0,0,0,1901-9-17,0
1901,9,18,0,0,0,1901-9-18,0
1901,9,19,0,0,0,1901-9-19,0
1901,9,20,0,0,0,1901-9-20,0
1901,9,21,0,0,0,1901-9-21,0
1901,9,22,0,0,0,1901-9-22,0
1901,9,23,0,0,0,1901-9-23,0
1901,9,24,0,0,0,1901-9-24,0
1901,9,25,0,0,0,1901-9-25,0
1901,9,26,0,0,0,1901-9-26,0
1901,9,27,0,0,0,1901-9-27,0
1901,9,28,0,0,0,1901-9-28,0
1901,9,29,0,0,0,1901-9-29,0
1901,9,30,0,0,0,1901-9-30,0
1901,10,1,0,0,0,1901-10-1,0
1901,10,2,0,0,0,1901-10-2,0
1901,10,3,0,0,0,1901-10-3,0
1901,10,4,0,0,0,1901-10-4,0
1901,10,5,0,0,0,1901-10-5,0
1901,10,6,0,0,0,1901-10-6,0
1901,10,7,13,0,13,1901-10-7,-13
1901,10,8,6,0,6,1901-10-8,-6
1901,10,9,8,0,8,1901-10-9,-8
1901,10,10,67,0,67,1901-10-10,-67
1901,10,11,38,0,38,1901-10-11,-38
1901,10,12,15,0,15,1901-10-12,-15
1901,10,13,0,0,0,1901-10-13,0
1901,10,14,0,0,0,1901-10-14,0
1901,10,15,0,0,0,1901-10-15,0
1901,10,16,0,0,0,1901-10-16,0
1901,10,17,0,0,0,1901-10-17,0
1901,10,18,0,0,0,1901-10-18,0
1901,10,19,0,0,0,1901-10-19,0
1901,10,20,0,0,0,1901-10-20,0
1901,10,21,0,0,0,1901-10-21,0
1901,10,22,0,0,0,1901-10-22,0
1901,10,23,0,0,0,1901-10-23,0
1901,10,24,0,0,0,1901-10-24,0
1901,10,25,0,0,0,1901-10-25,0
1901,10,26,0,0,0,1901-10-26,0
1901,10,27,0,0,0,1901-10-27,0
1901,10,28,125,0,125,1901-10-28,-125
1901,10,29,112,0,112,1901-10-29,-112
1901,10,30,53,0,53,1901-10-30,-53
1901,10,31,21,0,21,1901-10-31,-21
1901,11,1,6,0,6,1901-11-1,-6
1901,11,2,0,0,0,1901-11-2,0
1901,11,3,0,0,0,1901-11-3,0
1901,11,4,0,0,0,1901-11-4,0
1901,11,5,0,0,0,1901-11-5,0
1901,11,6,0,0,0,1901-11-6,0
1901,11,7,0,0,0,1901-11-7,0
1901,11,8,0,0,0,1901-11-8,0
1901,11,9,0,0,0,1901-11-9,0
1901,11,10,0,0,0,1901-11-10,0
1901,11,11,0,0,0,1901-11-11,0
1901,11,12,0,0,0,1901-11-12,0
1901,11,13,107,0,107,1901-11-13,-107
1901,11,14,118,0,118,1901-11-14,-118
1901,11,15,145,0,145,1901-11-15,-145
1901,11,16,140,0,140,1901-11-16,-140
1901,11,17,120,0,120,1901-11-17,-120
1901,11,18,125,0,125,1901-11-18,-125
1901,11,19,132,0,132,1901-11-19,-132
1901,11,20,121,0,121,1901-11-20,-121
1901,11,21,106,0,106,1901-11-21,-106
1901,11,22,110,0,110,1901-11-22,-110
1901,11,23,76,0,76,1901-11-23,-76
1901,11,24,71,0,71,1901-11-24,-71
1901,11,25,72,0,72,1901-11-25,-72
1901,11,26,0,0,0,1901-11-26,0
1901,11,27,0,0,0,1901-11-27,0
1901,11,28,0,0,0,1901-11-28,0
1901,11,29,0,0,0,1901-11-29,0
1901,11,30,0,0,0,1901-11-30,0
1901,12,1,0,0,0,1901-12-1,0
1901,12,2,0,0,0,1901-12-2,0
1901,12,3,0,0,0,1901-12-3,0
1901,12,4,0,0,0,1901-12-4,0
1901,12,5,0,0,0,1901-12-5,0
1901,12,6,0,0,0,1901-12-6,0
1901,12,7,0,0,0,1901-12-7,0
1901,12,8,0,0,0,1901-12-8,0
1901,12,9,0,0,0,1901-12-9,0
1901,12,10,0,0,0,1901-12-10,0
1901,12,11,0,0,0,1901-12-11,0
1901,12,12,0,0,0,1901-12-12,0
1901,12,13,0,0,0,1901-12-13,0
1901,12,14,0,0,0,1901-12-14,0
1901,12,15,0,0,0,1901-12-15,0
1901,12,16,0,0,0,1901-12-16,0
1901,12,17,0,0,0,1901-12-17,0
1901,12,18,0,0,0,1901-12-18,0
1901,12,19,0,0,0,1901-12-19,0
1901,12,20,0,0,0,1901-12-20,0
1901,12,21,0,0,0,1901-12-21,0
1901,12,22,0,0,0,1901-12-22,0
1901,12,23,0,0,0,1901-12-23,0
1901,12,24,0,0,0,1901-12-24,0
1901,12,25,0,0,0,1901-12-25,0
1901,12,26,0,0,0,1901-12-26,0
1901,12,27,0,0,0,1901-12-27,0
1901,12,28,0,0,0,1901-12-28,0
1901,12,29,0,0,0,1901-12-29,0
1901,12,30,0,0,0,1901-12-30,0
1901,12,31,0,0,0,1901-12-31,0
1902,1,1,0,0,0,1902-1-1,0
1902,1,2,0,0,0,1902-1-2,0
1902,1,3,0,0,0,1902-1-3,0
1902,1,4,0,0,0,1902-1-4,0
1902,1,5,32,0,32,1902-1-5,-32
1902,1,6,185,0,185,1902-1-6,-185
1902,1,7,406,0,406,1902-1-7,-406
1902,1,8,402,0,402,1902-1-8,-402
1902,1,9,490,0,490,1902-1-9,-490
1902,1,10,363,7,356,1902-1-10,-349
1902,1,11,333,0,333,1902-1-11,-333
1902,1,12,299,0,299,1902-1-12,-299
1902,1,13,253,0,253,1902-1-13,-253
1902,1,14,222,0,222,1902-1-14,-222
1902,1,15,61,0,61,1902-1-15,-61
1902,1,16,0,0,0,1902-1-16,0
1902,1,17,0,0,0,1902-1-17,0
1902,1,18,0,0,0,1902-1-18,0
1902,1,19,0,0,0,1902-1-19,0
1902,1,20,0,0,0,1902-1-20,0
1902,1,21,0,0,0,1902-1-21,0
1902,1,22,0,0,0,1902-1-22,0
1902,1,23,0,0,0,1902-1-23,0
1902,1,24,0,0,0,1902-1-24,0
1902,1,25,0,0,0,1902-1-25,0
1902,1,26,0,0,0,1902-1-26,0
1902,1,27,0,0,0,1902-1-27,0
1902,1,28,0,0,0,1902-1-28,0
1902,1,29,0,0,0,1902-1-29,0
1902,1,30,0,0,0,1902-1-30,0
1902,1,31,0,0,0,1902-1-31,0
1902,2,1,0,0,0,1902-2-1,0
1902,2,2,0,0,0,1902-2-2,0
1902,2,3,0,0,0,1902-2-3,0
1902,2,4,0,0,0,1902-2-4,0
1902,2,5,0,0,0,1902-2-5,0
1902,2,6,0,0,0,1902-2-6,0
1902,2,7,0,0,0,1902-2-7,0
1902,2,8,0,0,0,1902-2-8,0
1902,2,9,0,0,0,1902-2-9,0
1902,2,10,0,0,0,1902-2-10,0
1902,2,11,0,0,0,1902-2-11,0
1902,2,12,0,0,0,1902-2-12,0
1902,2,13,11,0,11,1902-2-13,-11
1902,2,14,0,0,0,1902-2-14,0
1902,2,15,0,0,0,1902-2-15,0
1902,2,16,0,0,0,1902-2-16,0
1902,2,17,0,0,0,1902-2-17,0
1902,2,18,0,0,0,1902-2-18,0
1902,2,19,0,0,0,1902-2-19,0
1902,2,20,0,0,0,1902-2-20,0
1902,2,21,0,0,0,1902-2-21,0
1902,2,22,0,0,0,1902-2-22,0
1902,2,23,0,0,0,1902-2-23,0
1902,2,24,0,0,0,1902-2-24,0
1902,2,25,0,0,0,1902-2-25,0
1902,2,26,0,0,0,1902-2-26,0
1902,2,27,0,0,0,1902-2-27,0
1902,2,28,0,0,0,1902-2-28,0
1902,3,1,0,0,0,1902-3-1,0
1902,3,2,8,0,8,1902-3-2,-8
1902,3,3,37,37,0,1902-3-3,37
1902,3,4,119,119,0,1902-3-4,119
1902,3,5,388,388,0,1902-3-5,388
1902,3,6,-1,-1,-1,1902-3-6,0
1902,3,7,639,639,0,1902-3-7,639
1902,3,8,788,788,0,1902-3-8,788
1902,3,9,1113,1113,0,1902-3-9,1113
1902,3,10,697,697,0,1902-3-10,697
1902,3,11,373,373,0,1902-3-11,373
1902,3,12,464,464,0,1902-3-12,464
1902,3,13,558,558,0,1902-3-13,558
1902,3,14,209,209,0,1902-3-14,209
1902,3,15,0,0,0,1902-3-15,0
1902,3,16,0,0,0,1902-3-16,0
1902,3,17,0,0,0,1902-3-17,0
1902,3,18,0,0,0,1902-3-18,0
1902,3,19,0,0,0,1902-3-19,0
1902,3,20,0,0,0,1902-3-20,0
1902,3,21,0,0,0,1902-3-21,0
1902,3,22,0,0,0,1902-3-22,0
1902,3,23,0,0,0,1902-3-23,0
1902,3,24,0,0,0,1902-3-24,0
1902,3,25,0,0,0,1902-3-25,0
1902,3,26,0,0,0,1902-3-26,0
1902,3,27,0,0,0,1902-3-27,0
1902,3,28,0,0,0,1902-3-28,0
1902,3,29,0,0,0,1902-3-29,0
1902,3,30,0,0,0,1902-3-30,0
1902,3,31,0,0,0,1902-3-31,0
1902,4,1,0,0,0,1902-4-1,0
1902,4,2,0,0,0,1902-4-2,0
1902,4,3,0,0,0,1902-4-3,0
1902,4,4,0,0,0,1902-4-4,0
1902,4,5,0,0,0,1902-4-5,0
1902,4,6,0,0,0,1902-4-6,0
1902,4,7,0,0,0,1902-4-7,0
1902,4,8,0,0,0,1902-4-8,0
1902,4,9,0,0,0,1902-4-9,0
1902,4,10,0,0,0,1902-4-10,0
1902,4,11,0,0,0,1902-4-11,0
1902,4,12,0,0,0,1902-4-12,0
1902,4,13,0,0,0,1902-4-13,0
1902,4,14,0,0,0,1902-4-14,0
1902,4,15,0,0,0,1902-4-15,0
1902,4,16,0,0,0,1902-4-16,0
1902,4,17,0,0,0,1902-4-17,0
1902,4,18,0,0,0,1902-4-18,0
1902,4,19,0,0,0,1902-4-19,0
1902,4,20,0,0,0,1902-4-20,0
1902,4,21,0,0,0,1902-4-21,0
1902,4,22,0,0,0,1902-4-22,0
1902,4,23,0,0,0,1902-4-23,0
1902,4,24,0,0,0,1902-4-24,0
1902,4,25,0,0,0,1902-4-25,0
1902,4,26,0,0,0,1902-4-26,0
1902,4,27,0,0,0,1902-4-27,0
1902,4,28,0,0,0,1902-4-28,0
1902,4,29,0,0,0,1902-4-29,0
1902,4,30,0,0,0,1902-4-30,0
1902,5,1,0,0,0,1902-5-1,0
1902,5,2,0,0,0,1902-5-2,0
1902,5,3,0,0,0,1902-5-3,0
1902,5,4,0,0,0,1902-5-4,0
1902,5,5,6,6,0,1902-5-5,6
1902,5,6,0,0,0,1902-5-6,0
1902,5,7,0,0,0,1902-5-7,0
1902,5,8,0,0,0,1902-5-8,0
1902,5,9,0,0,0,1902-5-9,0
1902,5,10,0,0,0,1902-5-10,0
1902,5,11,0,0,0,1902-5-11,0
1902,5,12,0,0,0,1902-5-12,0
1902,5,13,0,0,0,1902-5-13,0
1902,5,14,0,0,0,1902-5-14,0
1902,5,15,0,0,0,1902-5-15,0
1902,5,16,0,0,0,1902-5-16,0
1902,5,17,0,0,0,1902-5-17,0
1902,5,18,0,0,0,1902-5-18,0
1902,5,19,0,0,0,1902-5-19,0
1902,5,20,0,0,0,1902-5-20,0
1902,5,21,14,14,0,1902-5-21,14
1902,5,22,0,0,0,1902-5-22,0
1902,5,23,0,0,0,1902-5-23,0
1902,5,24,162,162,0,1902-5-24,162
1902,5,25,170,170,0,1902-5-25,170
1902,5,26,162,162,0,1902-5-26,162
1902,5,27,161,161,0,1902-5-27,161
1902,5,28,158,158,0,1902-5-28,158
1902,5,29,114,114,0,1902-5-29,114
1902,5,30,103,103,0,1902-5-30,103
1902,5,31,69,69,0,1902-5-31,69
1902,6,1,63,63,0,1902-6-1,63
1902,6,2,47,47,0,1902-6-2,47
1902,6,3,32,32,0,1902-6-3,32
1902,6,4,21,21,0,1902-6-4,21
1902,6,5,0,0,0,1902-6-5,0
1902,6,6,0,0,0,1902-6-6,0
1902,6,7,0,0,0,1902-6-7,0
1902,6,8,0,0,0,1902-6-8,0
1902,6,9,0,0,0,1902-6-9,0
1902,6,10,0,0,0,1902-6-10,0
1902,6,11,0,0,0,1902-6-11,0
1902,6,12,0,0,0,1902-6-12,0
1902,6,13,0,0,0,1902-6-13,0
1902,6,14,0,0,0,1902-6-14,0
1902,6,15,0,0,0,1902-6-15,0
1902,6,16,0,0,0,1902-6-16,0
1902,6,17,0,0,0,1902-6-17,0
1902,6,18,0,0,0,1902-6-18,0
1902,6,19,0,0,0,1902-6-19,0
1902,6,20,0,0,0,1902-6-20,0
1902,6,21,0,0,0,1902-6-21,0
1902,6,22,0,0,0,1902-6-22,0
1902,6,23,13,13,0,1902-6-23,13
1902,6,24,0,0,0,1902-6-24,0
1902,6,25,0,0,0,1902-6-25,0
1902,6,26,0,0,0,1902-6-26,0
1902,6,27,0,0,0,1902-6-27,0
1902,6,28,0,0,0,1902-6-28,0
1902,6,29,0,0,0,1902-6-29,0
1902,6,30,0,0,0,1902-6-30,0
1902,7,1,0,0,0,1902-7-1,0
1902,7,2,0,0,0,1902-7-2,0
1902,7,3,0,0,0,1902-7-3,0
1902,7,4,10,10,0,1902-7-4,10
1902,7,5,0,0,0,1902-7-5,0
1902,7,6,0,0,0,1902-7-6,0
1902,7,7,0,0,0,1902-7-7,0
1902,7,8,0,0,0,1902-7-8,0
1902,7,9,0,0,0,1902-7-9,0
1902,7,10,0,0,0,1902-7-10,0
1902,7,11,0,0,0,1902-7-11,0
1902,7,12,0,0,0,1902-7-12,0
1902,7,13,0,0,0,1902-7-13,0
1902,7,14,0,0,0,1902-7-14,0
1902,7,15,0,0,0,1902-7-15,0
1902,7,16,0,0,0,1902-7-16,0
1902,7,17,0,0,0,1902-7-17,0
1902,7,18,0,0,0,1902-7-18,0
1902,7,19,0,0,0,1902-7-19,0
1902,7,20,0,0,0,1902-7-20,0
1902,7,21,0,0,0,1902-7-21,0
1902,7,22,0,0,0,1902-7-22,0
1902,7,23,0,0,0,1902-7-23,0
1902,7,24,0,0,0,1902-7-24,0
1902,7,25,0,0,0,1902-7-25,0
1902,7,26,0,0,0,1902-7-26,0
1902,7,27,0,0,0,1902-7-27,0
1902,7,28,0,0,0,1902-7-28,0
1902,7,29,0,0,0,1902-7-29,0
1902,7,30,0,0,0,1902-7-30,0
1902,7,31,0,0,0,1902-7-31,0
1902,8,1,0,0,0,1902-8-1,0
1902,8,2,0,0,0,1902-8-2,0
1902,8,3,0,0,0,1902-8-3,0
1902,8,4,0,0,0,1902-8-4,0
1902,8,5,0,0,0,1902-8-5,0
1902,8,6,0,0,0,1902-8-6,0
1902,8,7,7,0,7,1902-8-7,-7
1902,8,8,0,0,0,1902-8-8,0
1902,8,9,0,0,0,1902-8-9,0
1902,8,10,0,0,0,1902-8-10,0
1902,8,11,0,0,0,1902-8-11,0
1902,8,12,0,0,0,1902-8-12,0
1902,8,13,0,0,0,1902-8-13,0
1902,8,14,0,0,0,1902-8-14,0
1902,8,15,0,0,0,1902-8-15,0
1902,8,16,0,0,0,1902-8-16,0
1902,8,17,19,19,0,1902-8-17,19
1902,8,18,10,10,0,1902-8-18,10
1902,8,19,0,0,0,1902-8-19,0
1902,8,20,25,25,0,1902-8-20,25
1902,8,21,0,0,0,1902-8-21,0
1902,8,22,0,0,0,1902-8-22,0
1902,8,23,0,0,0,1902-8-23,0
1902,8,24,12,12,0,1902-8-24,12
1902,8,25,0,0,0,1902-8-25,0
1902,8,26,0,0,0,1902-8-26,0
1902,8,27,0,0,0,1902-8-27,0
1902,8,28,0,0,0,1902-8-28,0
1902,8,29,0,0,0,1902-8-29,0
1902,8,30,0,0,0,1902-8-30,0
1902,8,31,0,0,0,1902-8-31,0
1902,9,1,0,0,0,1902-9-1,0
1902,9,2,0,0,0,1902-9-2,0
1902,9,3,0,0,0,1902-9-3,0
1902,9,4,0,0,0,1902-9-4,0
1902,9,5,0,0,0,1902-9-5,0
1902,9,6,0,0,0,1902-9-6,0
1902,9,7,0,0,0,1902-9-7,0
1902,9,8,0,0,0,1902-9-8,0
1902,9,9,0,0,0,1902-9-9,0
1902,9,10,0,0,0,1902-9-10,0
1902,9,11,0,0,0,1902-9-11,0
1902,9,12,0,0,0,1902-9-12,0
1902,9,13,0,0,0,1902-9-13,0
1902,9,14,0,0,0,1902-9-14,0
1902,9,15,0,0,0,1902-9-15,0
1902,9,16,0,0,0,1902-9-16,0
1902,9,17,0,0,0,1902-9-17,0
1902,9,18,19,19,0,1902-9-18,19
1902,9,19,45,45,0,1902-9-19,45
1902,9,20,50,50,0,1902-9-20,50
1902,9,21,175,175,0,1902-9-21,175
1902,9,22,425,112,313,1902-9-22,-201
1902,9,23,376,82,294,1902-9-23,-212
1902,9,24,266,41,225,1902-9-24,-184
1902,9,25,221,0,221,1902-9-25,-221
1902,9,26,206,0,206,1902-9-26,-206
1902,9,27,172,0,172,1902-9-27,-172
1902,9,28,142,0,142,1902-9-28,-142
1902,9,29,116,0,116,1902-9-29,-116
1902,9,30,68,0,68,1902-9-30,-68
1902,10,1,43,0,43,1902-10-1,-43
1902,10,2,33,0,33,1902-10-2,-33
1902,10,3,0,0,0,1902-10-3,0
1902,10,4,0,0,0,1902-10-4,0
1902,10,5,151,151,0,1902-10-5,151
1902,10,6,402,402,0,1902-10-6,402
1902,10,7,361,361,0,1902-10-7,361
1902,10,8,370,370,0,1902-10-8,370
1902,10,9,288,288,0,1902-10-9,288
1902,10,10,182,182,0,1902-10-10,182
1902,10,11,152,152,0,1902-10-11,152
1902,10,12,171,171,0,1902-10-12,171
1902,10,13,163,163,0,1902-10-13,163
1902,10,14,143,143,0,1902-10-14,143
1902,10,15,130,130,0,1902-10-15,130
1902,10,16,122,122,0,1902-10-16,122
1902,10,17,0,0,0,1902-10-17,0
1902,10,18,0,0,0,1902-10-18,0
1902,10,19,0,0,0,1902-10-19,0
1902,10,20,0,0,0,1902-10-20,0
1902,10,21,18,18,0,1902-10-21,18
1902,10,22,39,9,30,1902-10-22,-21
1902,10,23,125,0,125,1902-10-23,-125
1902,10,24,367,0,367,1902-10-24,-367
1902,10,25,270,0,270,1902-10-25,-270
1902,10,26,323,0,323,1902-10-26,-323
1902,10,27,333,0,333,1902-10-27,-333
1902,10,28,411,0,411,1902-10-28,-411
1902,10,29,253,0,253,1902-10-29,-253
1902,10,30,153,0,153,1902-10-30,-153
1902,10,31,0,0,0,1902-10-31,0
1902,11,1,0,0,0,1902-11-1,0
1902,11,2,0,0,0,1902-11-2,0
1902,11,3,0,0,0,1902-11-3,0
1902,11,4,0,0,0,1902-11-4,0
1902,11,5,0,0,0,1902-11-5,0
1902,11,6,0,0,0,1902-11-6,0
1902,11,7,0,0,0,1902-11-7,0
1902,11,8,0,0,0,1902-11-8,0
1902,11,9,0,0,0,1902-11-9,0
1902,11,10,0,0,0,1902-11-10,0
1902,11,11,0,0,0,1902-11-11,0
1902,11,12,0,0,0,1902-11-12,0
1902,11,13,0,0,0,1902-11-13,0
1902,11,14,55,55,0,1902-11-14,55
1902,11,15,90,78,12,1902-11-15,66
1902,11,16,66,47,19,1902-11-16,28
1902,11,17,36,36,0,1902-11-17,36
1902,11,18,168,168,0,1902-11-18,168
1902,11,19,365,365,0,1902-11-19,365
1902,11,20,396,396,0,1902-11-20,396
1902,11,21,568,568,0,1902-11-21,568
1902,11,22,512,512,0,1902-11-22,512
1902,11,23,495,495,0,1902-11-23,495
1902,11,24,679,679,0,1902-11-24,679
1902,11,25,752,752,0,1902-11-25,752
1902,11,26,294,294,0,1902-11-26,294
1902,11,27,2,0,2,1902-11-27,-2
1902,11,28,11,11,0,1902-11-28,11
1902,11,29,0,0,0,1902-11-29,0
1902,11,30,0,0,0,1902-11-30,0
1902,12,1,0,0,0,1902-12-1,0
1902,12,2,8,0,8,1902-12-2,-8
1902,12,3,0,0,0,1902-12-3,0
1902,12,4,0,0,0,1902-12-4,0
1902,12,5,0,0,0,1902-12-5,0
1902,12,6,0,0,0,1902-12-6,0
1902,12,7,0,0,0,1902-12-7,0
1902,12,8,0,0,0,1902-12-8,0
1902,12,9,0,0,0,1902-12-9,0
1902,12,10,0,0,0,1902-12-10,0
1902,12,11,0,0,0,1902-12-11,0
1902,12,12,20,20,0,1902-12-12,20
1902,12,13,0,0,0,1902-12-13,0
1902,12,14,12,0,12,1902-12-14,-12
1902,12,15,0,0,0,1902-12-15,0
1902,12,16,36,36,0,1902-12-16,36
1902,12,17,33,33,0,1902-12-17,33
1902,12,18,0,0,0,1902-12-18,0
1902,12,19,0,0,0,1902-12-19,0
1902,12,20,0,0,0,1902-12-20,0
1902,12,21,0,0,0,1902-12-21,0
1902,12,22,0,0,0,1902-12-22,0
1902,12,23,0,0,0,1902-12-23,0
1902,12,24,0,0,0,1902-12-24,0
1902,12,25,0,0,0,1902-12-25,0
1902,12,26,0,0,0,1902-12-26,0
1902,12,27,0,0,0,1902-12-27,0
1902,12,28,0,0,0,1902-12-28,0
1902,12,29,0,0,0,1902-12-29,0
1902,12,30,0,0,0,1902-12-30,0
1902,12,31,0,0,0,1902-12-31,0
1903,1,1,0,0,0,1903-1-1,0
1903,1,2,0,0,0,1903-1-2,0
1903,1,3,16,16,0,1903-1-3,16
1903,1,4,56,56,0,1903-1-4,56
1903,1,5,126,126,0,1903-1-5,126
1903,1,6,129,129,0,1903-1-6,129
1903,1,7,84,84,0,1903-1-7,84
1903,1,8,9,9,0,1903-1-8,9
1903,1,9,0,0,0,1903-1-9,0
1903,1,10,0,0,0,1903-1-10,0
1903,1,11,0,0,0,1903-1-11,0
1903,1,12,0,0,0,1903-1-12,0
1903,1,13,0,0,0,1903-1-13,0
1903,1,14,0,0,0,1903-1-14,0
1903,1,15,0,0,0,1903-1-15,0
1903,1,16,0,0,0,1903-1-16,0
1903,1,17,0,0,0,1903-1-17,0
1903,1,18,26,0,26,1903-1-18,-26
1903,1,19,52,0,52,1903-1-19,-52
1903,1,20,40,0,40,1903-1-20,-40
1903,1,21,16,0,16,1903-1-21,-16
1903,1,22,19,0,19,1903-1-22,-19
1903,1,23,94,0,94,1903-1-23,-94
1903,1,24,17,0,17,1903-1-24,-17
1903,1,25,0,0,0,1903-1-25,0
1903,1,26,14,14,0,1903-1-26,14
1903,1,27,0,0,0,1903-1-27,0
1903,1,28,38,17,21,1903-1-28,-4
1903,1,29,72,0,72,1903-1-29,-72
1903,1,30,72,0,72,1903-1-30,-72
1903,1,31,49,0,49,1903-1-31,-49
1903,2,1,52,0,52,1903-2-1,-52
1903,2,2,68,0,68,1903-2-2,-68
1903,2,3,52,0,52,1903-2-3,-52
1903,2,4,44,0,44,1903-2-4,-44
1903,2,5,0,0,0,1903-2-5,0
1903,2,6,35,0,35,1903-2-6,-35
1903,2,7,25,0,25,1903-2-7,-25
1903,2,8,5,0,5,1903-2-8,-5
1903,2,9,124,111,13,1903-2-9,98
1903,2,10,339,294,45,1903-2-10,249
1903,2,11,340,280,60,1903-2-11,220
1903,2,12,273,257,16,1903-2-12,241
1903,2,13,225,225,0,1903-2-13,225
1903,2,14,138,138,0,1903-2-14,138
1903,2,15,111,111,0,1903-2-15,111
1903,2,16,80,80,0,1903-2-16,80
1903,2,17,85,85,0,1903-2-17,85
1903,2,18,48,48,0,1903-2-18,48
1903,2,19,69,45,24,1903-2-19,21
1903,2,20,152,62,90,1903-2-20,-28
1903,2,21,64,5,59,1903-2-21,-54
1903,2,22,36,0,36,1903-2-22,-36
1903,2,23,157,129,28,1903-2-23,101
1903,2,24,195,161,34,1903-2-24,127
1903,2,25,326,135,191,1903-2-25,-56
1903,2,26,261,115,146,1903-2-26,-31
1903,2,27,194,109,85,1903-2-27,24
1903,2,28,138,102,36,1903-2-28,66
1903,3,1,144,110,34,1903-3-1,76
1903,3,2,117,98,19,1903-3-2,79
1903,3,3,69,62,7,1903-3-3,55
1903,3,4,33,33,0,1903-3-4,33
1903,3,5,13,13,0,1903-3-5,13
1903,3,6,0,0,0,1903-3-6,0
1903,3,7,0,0,0,1903-3-7,0
1903,3,8,0,0,0,1903-3-8,0
1903,3,9,9,9,0,1903-3-9,9
1903,3,10,0,0,0,1903-3-10,0
1903,3,11,0,0,0,1903-3-11,0
1903,3,12,7,0,7,1903-3-12,-7
1903,3,13,43,0,43,1903-3-13,-43
1903,3,14,14,0,14,1903-3-14,-14
1903,3,15,0,0,0,1903-3-15,0
1903,3,16,0,0,0,1903-3-16,0
1903,3,17,0,0,0,1903-3-17,0
1903,3,18,0,0,0,1903-3-18,0
1903,3,19,0,0,0,1903-3-19,0
1903,3,20,0,0,0,1903-3-20,0
1903,3,21,253,253,0,1903-3-21,253
1903,3,22,414,414,0,1903-3-22,414
1903,3,23,405,405,0,1903-3-23,405
1903,3,24,336,336,0,1903-3-24,336
1903,3,25,273,273,0,1903-3-25,273
1903,3,26,488,228,260,1903-3-26,-32
1903,3,27,589,251,338,1903-3-27,-87
1903,3,28,661,202,459,1903-3-28,-257
1903,3,29,706,324,382,1903-3-29,-58
1903,3,30,741,414,327,1903-3-30,87
1903,3,31,570,332,238,1903-3-31,94
1903,4,1,533,358,175,1903-4-1,183
1903,4,2,866,281,585,1903-4-2,-304
1903,4,3,511,20,491,1903-4-3,-471
1903,4,4,552,0,552,1903-4-4,-552
1903,4,5,449,0,449,1903-4-5,-449
1903,4,6,426,0,426,1903-4-6,-426
1903,4,7,470,12,458,1903-4-7,-446
1903,4,8,415,24,391,1903-4-8,-367
1903,4,9,385,18,367,1903-4-9,-349
1903,4,10,414,15,399,1903-4-10,-384
1903,4,11,-1,-1,-1,1903-4-11,0
1903,4,12,433,9,424,1903-4-12,-415
1903,4,13,361,20,341,1903-4-13,-321
1903,4,14,248,0,248,1903-4-14,-248
1903,4,15,0,0,0,1903-4-15,0
1903,4,16,0,0,0,1903-4-16,0
1903,4,17,0,0,0,1903-4-17,0
1903,4,18,0,0,0,1903-4-18,0
1903,4,19,55,30,25,1903-4-19,5
1903,4,20,11,11,0,1903-4-20,11
1903,4,21,9,9,0,1903-4-21,9
1903,4,22,142,3,139,1903-4-22,-136
1903,4,23,157,0,157,1903-4-23,-157
1903,4,24,257,48,209,1903-4-24,-161
1903,4,25,140,26,114,1903-4-25,-88
1903,4,26,253,124,129,1903-4-26,-5
1903,4,27,535,470,65,1903-4-27,405
1903,4,28,633,585,48,1903-4-28,537
1903,4,29,631,562,69,1903-4-29,493
1903,4,30,867,742,125,1903-4-30,617
1903,5,1,657,598,59,1903-5-1,539
1903,5,2,411,382,29,1903-5-2,353
1903,5,3,355,332,23,1903-5-3,309
1903,5,4,244,226,18,1903-5-4,208
1903,5,5,86,75,11,1903-5-5,64
1903,5,6,0,0,0,1903-5-6,0
1903,5,7,6,0,6,1903-5-7,-6
1903,5,8,0,0,0,1903-5-8,0
1903,5,9,0,0,0,1903-5-9,0
1903,5,10,0,0,0,1903-5-10,0
1903,5,11,0,0,0,1903-5-11,0
1903,5,12,8,8,0,1903-5-12,8
1903,5,13,10,10,0,1903-5-13,10
1903,5,14,17,17,0,1903-5-14,17
1903,5,15,7,7,0,1903-5-15,7
1903,5,16,50,0,50,1903-5-16,-50
1903,5,17,38,0,38,1903-5-17,-38
1903,5,18,8,0,8,1903-5-18,-8
1903,5,19,13,0,13,1903-5-19,-13
1903,5,20,129,118,11,1903-5-20,107
1903,5,21,157,93,64,1903-5-21,29
1903,5,22,99,70,29,1903-5-22,41
1903,5,23,25,25,0,1903-5-23,25
1903,5,24,27,27,0,1903-5-24,27
1903,5,25,42,30,12,1903-5-25,18
1903,5,26,93,93,0,1903-5-26,93
1903,5,27,80,80,0,1903-5-27,80
1903,5,28,30,30,0,1903-5-28,30
1903,5,29,0,0,0,1903-5-29,0
1903,5,30,14,14,0,1903-5-30,14
1903,5,31,0,0,0,1903-5-31,0
1903,6,1,0,0,0,1903-6-1,0
1903,6,2,0,0,0,1903-6-2,0
1903,6,3,0,0,0,1903-6-3,0
1903,6,4,0,0,0,1903-6-4,0
1903,6,5,25,25,0,1903-6-5,25
1903,6,6,0,0,0,1903-6-6,0
1903,6,7,0,0,0,1903-6-7,0
1903,6,8,51,12,39,1903-6-8,-27
1903,6,9,0,0,0,1903-6-9,0
1903,6,10,13,0,13,1903-6-10,-13
1903,6,11,17,0,17,1903-6-11,-17
1903,6,12,12,0,12,1903-6-12,-12
1903,6,13,51,0,51,1903-6-13,-51
1903,6,14,35,0,35,1903-6-14,-35
1903,6,15,16,0,16,1903-6-15,-16
1903,6,16,297,117,180,1903-6-16,-63
1903,6,17,53,53,0,1903-6-17,53
1903,6,18,51,51,0,1903-6-18,51
1903,6,19,-1,-1,-1,1903-6-19,0
1903,6,20,295,224,71,1903-6-20,153
1903,6,21,-1,-1,-1,1903-6-21,0
1903,6,22,417,374,43,1903-6-22,331
1903,6,23,398,382,16,1903-6-23,366
1903,6,24,277,277,0,1903-6-24,277
1903,6,25,223,223,0,1903-6-25,223
1903,6,26,211,211,0,1903-6-26,211
1903,6,27,160,160,0,1903-6-27,160
1903,6,28,59,59,0,1903-6-28,59
1903,6,29,0,0,0,1903-6-29,0
1903,6,30,305,0,305,1903-6-30,-305
1903,7,1,321,0,321,1903-7-1,-321
1903,7,2,333,0,333,1903-7-2,-333
1903,7,3,304,0,304,1903-7-3,-304
1903,7,4,299,0,299,1903-7-4,-299
1903,7,5,281,0,281,1903-7-5,-281
1903,7,6,285,0,285,1903-7-6,-285
1903,7,7,435,0,435,1903-7-7,-435
1903,7,8,576,0,576,1903-7-8,-576
1903,7,9,702,137,565,1903-7-9,-428
1903,7,10,747,137,610,1903-7-10,-473
1903,7,11,721,171,550,1903-7-11,-379
1903,7,12,-1,-1,-1,1903-7-12,0
1903,7,13,257,167,90,1903-7-13,77
1903,7,14,236,170,66,1903-7-14,104
1903,7,15,239,173,66,1903-7-15,107
1903,7,16,165,165,0,1903-7-16,165
1903,7,17,62,33,29,1903-7-17,4
1903,7,18,70,33,37,1903-7-18,-4
1903,7,19,-1,-1,-1,1903-7-19,0
1903,7,20,-1,-1,-1,1903-7-20,0
1903,7,21,90,17,73,1903-7-21,-56
1903,7,22,10,10,0,1903-7-22,10
1903,7,23,15,15,0,1903-7-23,15
1903,7,24,86,86,0,1903-7-24,86
1903,7,25,274,274,0,1903-7-25,274
1903,7,26,237,230,7,1903-7-26,223
1903,7,27,199,169,30,1903-7-27,139
1903,7,28,-1,-1,-1,1903-7-28,0
1903,7,29,229,214,15,1903-7-29,199
1903,7,30,293,284,9,1903-7-30,275
1903,7,31,21,12,9,1903-7-31,3
1903,8,1,23,0,23,1903-8-1,-23
1903,8,2,32,27,5,1903-8-2,22
1903,8,3,15,15,0,1903-8-3,15
1903,8,4,16,16,0,1903-8-4,16
1903,8,5,14,5,9,1903-8-5,-4
1903,8,6,144,0,144,1903-8-6,-144
1903,8,7,130,0,130,1903-8-7,-130
1903,8,8,166,0,166,1903-8-8,-166
1903,8,9,269,0,269,1903-8-9,-269
1903,8,10,382,0,382,1903-8-10,-382
1903,8,11,425,31,394,1903-8-11,-363
1903,8,12,396,102,294,1903-8-12,-192
1903,8,13,382,158,224,1903-8-13,-66
1903,8,14,204,121,83,1903-8-14,38
1903,8,15,241,191,50,1903-8-15,141
1903,8,16,202,169,33,1903-8-16,136
1903,8,17,153,153,0,1903-8-17,153
1903,8,18,42,42,0,1903-8-18,42
1903,8,19,38,38,0,1903-8-19,38
1903,8,20,14,11,3,1903-8-20,8
1903,8,21,23,23,0,1903-8-21,23
1903,8,22,21,0,21,1903-8-22,-21
1903,8,23,13,0,13,1903-8-23,-13
1903,8,24,42,28,14,1903-8-24,14
1903,8,25,0,0,0,1903-8-25,0
1903,8,26,8,0,8,1903-8-26,-8
1903,8,27,32,0,32,1903-8-27,-32
1903,8,28,12,0,12,1903-8-28,-12
1903,8,29,34,0,34,1903-8-29,-34
1903,8,30,23,0,23,1903-8-30,-23
1903,8,31,0,0,0,1903-8-31,0
1903,9,1,2,0,2,1903-9-1,-2
1903,9,2,0,0,0,1903-9-2,0
1903,9,3,0,0,0,1903-9-3,0
1903,9,4,0,0,0,1903-9-4,0
1903,9,5,0,0,0,1903-9-5,0
1903,9,6,0,0,0,1903-9-6,0
1903,9,7,0,0,0,1903-9-7,0
1903,9,8,0,0,0,1903-9-8,0
1903,9,9,115,11,104,1903-9-9,-93
1903,9,10,88,5,83,1903-9-10,-78
1903,9,11,114,4,110,1903-9-11,-106
1903,9,12,111,0,111,1903-9-12,-111
1903,9,13,106,0,106,1903-9-13,-106
1903,9,14,75,15,60,1903-9-14,-45
1903,9,15,91,13,78,1903-9-15,-65
1903,9,16,77,33,44,1903-9-16,-11
1903,9,17,38,28,10,1903-9-17,18
1903,9,18,12,12,0,1903-9-18,12
1903,9,19,0,0,0,1903-9-19,0
1903,9,20,0,0,0,1903-9-20,0
1903,9,21,0,0,0,1903-9-21,0
1903,9,22,0,0,0,1903-9-22,0
1903,9,23,10,10,0,1903-9-23,10
1903,9,24,50,50,0,1903-9-24,50
1903,9,25,168,168,0,1903-9-25,168
1903,9,26,316,316,0,1903-9-26,316
1903,9,27,399,396,3,1903-9-27,393
1903,9,28,365,352,13,1903-9-28,339
1903,9,29,373,334,39,1903-9-29,295
1903,9,30,22,0,22,1903-9-30,-22
1903,10,1,7,0,7,1903-10-1,-7
1903,10,2,157,157,0,1903-10-2,157
1903,10,3,450,450,0,1903-10-3,450
1903,10,4,553,456,97,1903-10-4,359
1903,10,5,1808,415,1393,1903-10-5,-978
1903,10,6,1551,447,1104,1903-10-6,-657
1903,10,7,1956,337,1619,1903-10-7,-1282
1903,10,8,2466,288,2178,1903-10-8,-1890
1903,10,9,2443,248,2195,1903-10-9,-1947
1903,10,10,2599,270,2329,1903-10-10,-2059
1903,10,11,2492,233,2259,1903-10-11,-2026
1903,10,12,2236,205,2031,1903-10-12,-1826
1903,10,13,2181,192,1989,1903-10-13,-1797
1903,10,14,2239,342,1897,1903-10-14,-1555
1903,10,15,2079,176,1903,1903-10-15,-1727
1903,10,16,2106,158,1948,1903-10-16,-1790
1903,10,17,1728,183,1545,1903-10-17,-1362
1903,10,18,1181,166,1015,1903-10-18,-849
1903,10,19,169,169,0,1903-10-19,169
1903,10,20,162,162,0,1903-10-20,162
1903,10,21,229,209,20,1903-10-21,189
1903,10,22,195,195,0,1903-10-22,195
1903,10,23,176,176,0,1903-10-23,176
1903,10,24,196,196,0,1903-10-24,196
1903,10,25,294,175,119,1903-10-25,56
1903,10,26,759,159,600,1903-10-26,-441
1903,10,27,679,0,679,1903-10-27,-679
1903,10,28,807,0,807,1903-10-28,-807
1903,10,29,767,32,735,1903-10-29,-703
1903,10,30,1311,644,667,1903-10-30,-23
1903,10,31,1369,698,671,1903-10-31,27
1903,11,1,1195,592,603,1903-11-1,-11
1903,11,2,1419,827,592,1903-11-2,235
1903,11,3,1586,952,634,1903-11-3,318
1903,11,4,2052,938,1114,1903-11-4,-176
1903,11,5,2264,943,1321,1903-11-5,-378
1903,11,6,2182,872,1310,1903-11-6,-438
1903,11,7,2103,898,1205,1903-11-7,-307
1903,11,8,2055,794,1261,1903-11-8,-467
1903,11,9,1841,697,1144,1903-11-9,-447
1903,11,10,1763,716,1047,1903-11-10,-331
1903,11,11,1686,691,995,1903-11-11,-304
1903,11,12,1233,205,1028,1903-11-12,-823
1903,11,13,942,0,942,1903-11-13,-942
1903,11,14,1000,15,985,1903-11-14,-970
1903,11,15,938,0,938,1903-11-15,-938
1903,11,16,873,0,873,1903-11-16,-873
1903,11,17,171,0,171,1903-11-17,-171
1903,11,18,30,0,30,1903-11-18,-30
1903,11,19,42,0,42,1903-11-19,-42
1903,11,20,32,0,32,1903-11-20,-32
1903,11,21,0,0,0,1903-11-21,0
1903,11,22,21,0,21,1903-11-22,-21
1903,11,23,10,0,10,1903-11-23,-10
1903,11,24,134,0,134,1903-11-24,-134
1903,11,25,162,0,162,1903-11-25,-162
1903,11,26,124,0,124,1903-11-26,-124
1903,11,27,425,330,95,1903-11-27,235
1903,11,28,386,303,83,1903-11-28,220
1903,11,29,361,293,68,1903-11-29,225
1903,11,30,308,241,67,1903-11-30,174
1903,12,1,332,215,117,1903-12-1,98
1903,12,2,570,208,362,1903-12-2,-154
1903,12,3,621,197,424,1903-12-3,-227
1903,12,4,1108,218,890,1903-12-4,-672
1903,12,5,816,171,645,1903-12-5,-474
1903,12,6,806,168,638,1903-12-6,-470
1903,12,7,874,307,567,1903-12-7,-260
1903,12,8,1077,518,559,1903-12-8,-41
1903,12,9,1101,529,572,1903-12-9,-43
1903,12,10,1181,457,724,1903-12-10,-267
1903,12,11,1063,418,645,1903-12-11,-227
1903,12,12,723,449,274,1903-12-12,175
1903,12,13,823,461,362,1903-12-13,99
1903,12,14,724,458,266,1903-12-14,192
1903,12,15,683,629,54,1903-12-15,575
1903,12,16,711,683,28,1903-12-16,655
1903,12,17,778,736,42,1903-12-17,694
1903,12,18,708,673,35,1903-12-18,638
1903,12,19,675,629,46,1903-12-19,583
1903,12,20,481,420,61,1903-12-20,359
1903,12,21,293,241,52,1903-12-21,189
1903,12,22,282,272,10,1903-12-22,262
1903,12,23,252,246,6,1903-12-23,240
1903,12,24,212,212,0,1903-12-24,212
1903,12,25,13,13,0,1903-12-25,13
1903,12,26,10,10,0,1903-12-26,10
1903,12,27,168,168,0,1903-12-27,168
1903,12,28,169,0,169,1903-12-28,-169
1903,12,29,384,5,379,1903-12-29,-374
1903,12,30,466,23,443,1903-12-30,-420
1903,12,31,395,0,395,1903-12-31,-395
1904,1,1,433,5,428,1904-1-1,-423
1904,1,2,371,0,371,1904-1-2,-371
1904,1,3,237,0,237,1904-1-3,-237
1904,1,4,405,174,231,1904-1-4,-57
1904,1,5,325,171,154,1904-1-5,17
1904,1,6,304,172,132,1904-1-6,40
1904,1,7,345,199,146,1904-1-7,53
1904,1,8,296,198,98,1904-1-8,100
1904,1,9,257,153,104,1904-1-9,49
1904,1,10,-1,-1,-1,1904-1-10,0
1904,1,11,144,138,6,1904-1-11,132
1904,1,12,107,107,0,1904-1-12,107
1904,1,13,393,393,0,1904-1-13,393
1904,1,14,451,451,0,1904-1-14,451
1904,1,15,464,464,0,1904-1-15,464
1904,1,16,442,442,0,1904-1-16,442
1904,1,17,402,402,0,1904-1-17,402
1904,1,18,541,541,0,1904-1-18,541
1904,1,19,485,485,0,1904-1-19,485
1904,1,20,273,272,1,1904-1-20,271
1904,1,21,458,449,9,1904-1-21,440
1904,1,22,547,455,92,1904-1-22,363
1904,1,23,681,476,205,1904-1-23,271
1904,1,24,717,300,417,1904-1-24,-117
1904,1,25,900,123,777,1904-1-25,-654
1904,1,26,915,0,915,1904-1-26,-915
1904,1,27,784,0,784,1904-1-27,-784
1904,1,28,535,0,535,1904-1-28,-535
1904,1,29,56,0,56,1904-1-29,-56
1904,1,30,21,0,21,1904-1-30,-21
1904,1,31,61,0,61,1904-1-31,-61
1904,2,1,9,9,0,1904-2-1,9
1904,2,2,17,17,0,1904-2-2,17
1904,2,3,34,34,0,1904-2-3,34
1904,2,4,250,250,0,1904-2-4,250
1904,2,5,522,518,4,1904-2-5,514
1904,2,6,517,517,0,1904-2-6,517
1904,2,7,455,455,0,1904-2-7,455
1904,2,8,580,580,0,1904-2-8,580
1904,2,9,683,683,0,1904-2-9,683
1904,2,10,727,727,0,1904-2-10,727
1904,2,11,629,619,10,1904-2-11,609
1904,2,12,515,515,0,1904-2-12,515
1904,2,13,379,366,13,1904-2-13,353
1904,2,14,217,217,0,1904-2-14,217
1904,2,15,95,95,0,1904-2-15,95
1904,2,16,86,83,3,1904-2-16,80
1904,2,17,20,20,0,1904-2-17,20
1904,2,18,44,26,18,1904-2-18,8
1904,2,19,255,16,239,1904-2-19,-223
1904,2,20,358,47,311,1904-2-20,-264
1904,2,21,383,32,351,1904-2-21,-319
1904,2,22,535,113,422,1904-2-22,-309
1904,2,23,401,61,340,1904-2-23,-279
1904,2,24,459,28,431,1904-2-24,-403
1904,2,25,-1,-1,-1,1904-2-25,0
1904,2,26,377,23,354,1904-2-26,-331
1904,2,27,471,107,364,1904-2-27,-257
1904,2,28,400,32,368,1904-2-28,-336
1904,2,29,254,0,254,1904-2-29,-254
1904,3,1,263,0,263,1904-3-1,-263
1904,3,2,269,0,269,1904-3-2,-269
1904,3,3,312,13,299,1904-3-3,-286
1904,3,4,346,0,346,1904-3-4,-346
1904,3,5,322,0,322,1904-3-5,-322
1904,3,6,223,0,223,1904-3-6,-223
1904,3,7,-1,-1,-1,1904-3-7,0
1904,3,8,181,77,104,1904-3-8,-27
1904,3,9,329,97,232,1904-3-9,-135
1904,3,10,421,210,211,1904-3-10,-1
1904,3,11,420,206,214,1904-3-11,-8
1904,3,12,320,120,200,1904-3-12,-80
1904,3,13,186,0,186,1904-3-13,-186
1904,3,14,151,0,151,1904-3-14,-151
1904,3,15,286,144,142,1904-3-15,2
1904,3,16,306,169,137,1904-3-16,32
1904,3,17,375,204,171,1904-3-17,33
1904,3,18,317,183,134,1904-3-18,49
1904,3,19,589,464,125,1904-3-19,339
1904,3,20,919,803,116,1904-3-20,687
1904,3,21,636,549,87,1904-3-21,462
1904,3,22,575,556,19,1904-3-22,537
1904,3,23,483,466,17,1904-3-23,449
1904,3,24,489,412,77,1904-3-24,335
1904,3,25,546,455,91,1904-3-25,364
1904,3,26,474,441,33,1904-3-26,408
1904,3,27,329,329,0,1904-3-27,329
1904,3,28,380,270,110,1904-3-28,160
1904,3,29,400,317,83,1904-3-29,234
1904,3,30,262,217,45,1904-3-30,172
1904,3,31,166,157,9,1904-3-31,148
1904,4,1,154,154,0,1904-4-1,154
1904,4,2,197,197,0,1904-4-2,197
1904,4,3,255,255,0,1904-4-3,255
1904,4,4,135,135,0,1904-4-4,135
1904,4,5,169,169,0,1904-4-5,169
1904,4,6,152,152,0,1904-4-6,152
1904,4,7,129,129,0,1904-4-7,129
1904,4,8,690,126,564,1904-4-8,-438
1904,4,9,904,113,791,1904-4-9,-678
1904,4,10,1000,173,827,1904-4-10,-654
1904,4,11,1028,191,837,1904-4-11,-646
1904,4,12,942,167,775,1904-4-12,-608
1904,4,13,943,80,863,1904-4-13,-783
1904,4,14,1151,263,888,1904-4-14,-625
1904,4,15,1173,237,936,1904-4-15,-699
1904,4,16,1037,229,808,1904-4-16,-579
1904,4,17,1020,219,801,1904-4-17,-582
1904,4,18,1059,167,892,1904-4-18,-725
1904,4,19,1101,178,923,1904-4-19,-745
1904,4,20,672,172,500,1904-4-20,-328
1904,4,21,1027,176,851,1904-4-21,-675
1904,4,22,1362,485,877,1904-4-22,-392
1904,4,23,1804,832,972,1904-4-23,-140
1904,4,24,1683,744,939,1904-4-24,-195
1904,4,25,1627,836,791,1904-4-25,45
1904,4,26,1473,713,760,1904-4-26,-47
1904,4,27,1045,452,593,1904-4-27,-141
1904,4,28,1079,346,733,1904-4-28,-387
1904,4,29,1016,283,733,1904-4-29,-450
1904,4,30,1013,287,726,1904-4-30,-439
1904,5,1,880,300,580,1904-5-1,-280
1904,5,2,779,103,676,1904-5-2,-573
1904,5,3,439,226,213,1904-5-3,13
1904,5,4,296,219,77,1904-5-4,142
1904,5,5,266,126,140,1904-5-5,-14
1904,5,6,267,134,133,1904-5-6,1
1904,5,7,209,84,125,1904-5-7,-41
1904,5,8,236,64,172,1904-5-8,-108
1904,5,9,363,41,322,1904-5-9,-281
1904,5,10,415,15,400,1904-5-10,-385
1904,5,11,465,82,383,1904-5-11,-301
1904,5,12,372,90,282,1904-5-12,-192
1904,5,13,194,56,138,1904-5-13,-82
1904,5,14,209,49,160,1904-5-14,-111
1904,5,15,166,11,155,1904-5-15,-144
1904,5,16,234,174,60,1904-5-16,114
1904,5,17,129,115,14,1904-5-17,101
1904,5,18,134,116,18,1904-5-18,98
1904,5,19,134,114,20,1904-5-19,94
1904,5,20,204,204,0,1904-5-20,204
1904,5,21,135,119,16,1904-5-21,103
1904,5,22,130,130,0,1904-5-22,130
1904,5,23,35,18,17,1904-5-23,1
1904,5,24,30,20,10,1904-5-24,10
1904,5,25,82,64,18,1904-5-25,46
1904,5,26,157,71,86,1904-5-26,-15
1904,5,27,204,49,155,1904-5-27,-106
1904,5,28,330,22,308,1904-5-28,-286
1904,5,29,290,17,273,1904-5-29,-256
1904,5,30,285,11,274,1904-5-30,-263
1904,5,31,241,0,241,1904-5-31,-241
1904,6,1,126,0,126,1904-6-1,-126
1904,6,2,69,0,69,1904-6-2,-69
1904,6,3,125,14,111,1904-6-3,-97
1904,6,4,154,83,71,1904-6-4,12
1904,6,5,127,85,42,1904-6-5,43
1904,6,6,148,68,80,1904-6-6,-12
1904,6,7,274,141,133,1904-6-7,8
1904,6,8,139,125,14,1904-6-8,111
1904,6,9,126,116,10,1904-6-9,106
1904,6,10,269,269,0,1904-6-10,269
1904,6,11,106,106,0,1904-6-11,106
1904,6,12,292,292,0,1904-6-12,292
1904,6,13,718,703,15,1904-6-13,688
1904,6,14,844,682,162,1904-6-14,520
1904,6,15,710,571,139,1904-6-15,432
1904,6,16,666,491,175,1904-6-16,316
1904,6,17,434,354,80,1904-6-17,274
1904,6,18,378,287,91,1904-6-18,196
1904,6,19,451,351,100,1904-6-19,251
1904,6,20,365,293,72,1904-6-20,221
1904,6,21,394,337,57,1904-6-21,280
1904,6,22,570,442,128,1904-6-22,314
1904,6,23,694,533,161,1904-6-23,372
1904,6,24,544,485,59,1904-6-24,426
1904,6,25,351,296,55,1904-6-25,241
1904,6,26,234,193,41,1904-6-26,152
1904,6,27,132,111,21,1904-6-27,90
1904,6,28,58,50,8,1904-6-28,42
1904,6,29,83,24,59,1904-6-29,-35
1904,6,30,332,48,284,1904-6-30,-236
1904,7,1,381,129,252,1904-7-1,-123
1904,7,2,273,160,113,1904-7-2,47
1904,7,3,289,204,85,1904-7-3,119
1904,7,4,167,151,16,1904-7-4,135
1904,7,5,249,150,99,1904-7-5,51
1904,7,6,236,78,158,1904-7-6,-80
1904,7,7,397,67,330,1904-7-7,-263
1904,7,8,347,171,176,1904-7-8,-5
1904,7,9,269,269,0,1904-7-9,269
1904,7,10,445,445,0,1904-7-10,445
1904,7,11,397,397,0,1904-7-11,397
1904,7,12,450,450,0,1904-7-12,450
1904,7,13,509,509,0,1904-7-13,509
1904,7,14,430,430,0,1904-7-14,430
1904,7,15,703,509,194,1904-7-15,315
1904,7,16,1016,345,671,1904-7-16,-326
1904,7,17,1101,360,741,1904-7-17,-381
1904,7,18,1016,319,697,1904-7-18,-378
1904,7,19,900,211,689,1904-7-19,-478
1904,7,20,730,147,583,1904-7-20,-436
1904,7,21,807,328,479,1904-7-21,-151
1904,7,22,789,318,471,1904-7-22,-153
1904,7,23,699,279,420,1904-7-23,-141
1904,7,24,587,177,410,1904-7-24,-233
1904,7,25,584,173,411,1904-7-25,-238
1904,7,26,586,183,403,1904-7-26,-220
1904,7,27,238,175,63,1904-7-27,112
1904,7,28,197,185,12,1904-7-28,173
1904,7,29,295,130,165,1904-7-29,-35
1904,7,30,353,79,274,1904-7-30,-195
1904,7,31,410,66,344,1904-7-31,-278
1904,8,1,320,17,303,1904-8-1,-286
1904,8,2,365,114,251,1904-8-2,-137
1904,8,3,432,141,291,1904-8-3,-150
1904,8,4,558,359,199,1904-8-4,160
1904,8,5,635,609,26,1904-8-5,583
1904,8,6,707,690,17,1904-8-6,673
1904,8,7,637,479,158,1904-8-7,321
1904,8,8,668,354,314,1904-8-8,40
1904,8,9,519,260,259,1904-8-9,1
1904,8,10,486,261,225,1904-8-10,36
1904,8,11,525,229,296,1904-8-11,-67
1904,8,12,434,186,248,1904-8-12,-62
1904,8,13,436,132,304,1904-8-13,-172
1904,8,14,466,245,221,1904-8-14,24
1904,8,15,319,112,207,1904-8-15,-95
1904,8,16,175,42,133,1904-8-16,-91
1904,8,17,134,34,100,1904-8-17,-66
1904,8,18,115,65,50,1904-8-18,15
1904,8,19,182,108,74,1904-8-19,34
1904,8,20,130,75,55,1904-8-20,20
1904,8,21,66,66,0,1904-8-21,66
1904,8,22,236,59,177,1904-8-22,-118
1904,8,23,424,46,378,1904-8-23,-332
1904,8,24,478,30,448,1904-8-24,-418
1904,8,25,575,22,553,1904-8-25,-531
1904,8,26,1355,81,1274,1904-8-26,-1193
1904,8,27,1501,67,1434,1904-8-27,-1367
1904,8,28,1228,61,1167,1904-8-28,-1106
1904,8,29,1428,233,1195,1904-8-29,-962
1904,8,30,1348,217,1131,1904-8-30,-914
1904,8,31,979,140,839,1904-8-31,-699
1904,9,1,707,65,642,1904-9-1,-577
1904,9,2,663,7,656,1904-9-2,-649
1904,9,3,73,0,73,1904-9-3,-73
1904,9,4,20,0,20,1904-9-4,-20
1904,9,5,69,4,65,1904-9-5,-61
1904,9,6,45,0,45,1904-9-6,-45
1904,9,7,21,4,17,1904-9-7,-13
1904,9,8,59,9,50,1904-9-8,-41
1904,9,9,124,57,67,1904-9-9,-10
1904,9,10,168,27,141,1904-9-10,-114
1904,9,11,92,0,92,1904-9-11,-92
1904,9,12,55,0,55,1904-9-12,-55
1904,9,13,131,26,105,1904-9-13,-79
1904,9,14,204,39,165,1904-9-14,-126
1904,9,15,5,5,0,1904-9-15,5
1904,9,16,126,126,0,1904-9-16,126
1904,9,17,152,138,14,1904-9-17,124
1904,9,18,93,55,38,1904-9-18,17
1904,9,19,170,32,138,1904-9-19,-106
1904,9,20,395,99,296,1904-9-20,-197
1904,9,21,292,61,231,1904-9-21,-170
1904,9,22,310,56,254,1904-9-22,-198
1904,9,23,713,71,642,1904-9-23,-571
1904,9,24,685,83,602,1904-9-24,-519
1904,9,25,680,76,604,1904-9-25,-528
1904,9,26,504,109,395,1904-9-26,-286
1904,9,27,234,116,118,1904-9-27,-2
1904,9,28,296,186,110,1904-9-28,76
1904,9,29,304,214,90,1904-9-29,124
1904,9,30,249,178,71,1904-9-30,107
1904,10,1,278,162,116,1904-10-1,46
1904,10,2,193,153,40,1904-10-2,113
1904,10,3,282,282,0,1904-10-3,282
1904,10,4,74,74,0,1904-10-4,74
1904,10,5,235,235,0,1904-10-5,235
1904,10,6,674,556,118,1904-10-6,438
1904,10,7,768,519,249,1904-10-7,270
1904,10,8,1097,834,263,1904-10-8,571
1904,10,9,974,696,278,1904-10-9,418
1904,10,10,1000,596,404,1904-10-10,192
1904,10,11,1136,641,495,1904-10-11,146
1904,10,12,848,448,400,1904-10-12,48
1904,10,13,787,410,377,1904-10-13,33
1904,10,14,709,339,370,1904-10-14,-31
1904,10,15,586,309,277,1904-10-15,32
1904,10,16,541,272,269,1904-10-16,3
1904,10,17,648,412,236,1904-10-17,176
1904,10,18,341,309,32,1904-10-18,277
1904,10,19,371,337,34,1904-10-19,303
1904,10,20,389,315,74,1904-10-20,241
1904,10,21,165,68,97,1904-10-21,-29
1904,10,22,286,22,264,1904-10-22,-242
1904,10,23,327,33,294,1904-10-23,-261
1904,10,24,296,72,224,1904-10-24,-152
1904,10,25,474,268,206,1904-10-25,62
1904,10,26,529,329,200,1904-10-26,129
1904,10,27,971,868,103,1904-10-27,765
1904,10,28,1065,846,219,1904-10-28,627
1904,10,29,1238,935,303,1904-10-29,632
1904,10,30,1279,949,330,1904-10-30,619
1904,10,31,1122,883,239,1904-10-31,644
1904,11,1,1268,946,322,1904-11-1,624
1904,11,2,294,0,294,1904-11-2,-294
1904,11,3,242,4,238,1904-11-3,-234
1904,11,4,242,0,242,1904-11-4,-242
1904,11,5,307,62,245,1904-11-5,-183
1904,11,6,295,58,237,1904-11-6,-179
1904,11,7,207,37,170,1904-11-7,-133
1904,11,8,98,29,69,1904-11-8,-40
1904,11,9,96,0,96,1904-11-9,-96
1904,11,10,266,0,266,1904-11-10,-266
1904,11,11,307,59,248,1904-11-11,-189
1904,11,12,325,12,313,1904-11-12,-301
1904,11,13,295,0,295,1904-11-13,-295
1904,11,14,321,0,321,1904-11-14,-321
1904,11,15,305,0,305,1904-11-15,-305
1904,11,16,479,168,311,1904-11-16,-143
1904,11,17,321,141,180,1904-11-17,-39
1904,11,18,315,171,144,1904-11-18,27
1904,11,19,467,352,115,1904-11-19,237
1904,11,20,319,232,87,1904-11-20,145
1904,11,21,198,178,20,1904-11-21,158
1904,11,22,249,249,0,1904-11-22,249
1904,11,23,323,323,0,1904-11-23,323
1904,11,24,758,758,0,1904-11-24,758
1904,11,25,1224,1206,18,1904-11-25,1188
1904,11,26,1854,1726,128,1904-11-26,1598
1904,11,27,865,677,188,1904-11-27,489
1904,11,28,600,505,95,1904-11-28,410
1904,11,29,571,523,48,1904-11-29,475
1904,11,30,703,589,114,1904-11-30,475
1904,12,1,638,564,74,1904-12-1,490
1904,12,2,103,0,103,1904-12-2,-103
1904,12,3,90,0,90,1904-12-3,-90
1904,12,4,363,230,133,1904-12-4,97
1904,12,5,741,728,13,1904-12-5,715
1904,12,6,844,844,0,1904-12-6,844
1904,12,7,952,952,0,1904-12-7,952
1904,12,8,1755,1755,0,1904-12-8,1755
1904,12,9,1600,1600,0,1904-12-9,1600
1904,12,10,1632,1632,0,1904-12-10,1632
1904,12,11,1980,1964,16,1904-12-11,1948
1904,12,12,1832,1777,55,1904-12-12,1722
1904,12,13,2103,1924,179,1904-12-13,1745
1904,12,14,1590,1372,218,1904-12-14,1154
1904,12,15,1493,1365,128,1904-12-15,1237
1904,12,16,1182,1149,33,1904-12-16,1116
1904,12,17,706,706,0,1904-12-17,706
1904,12,18,790,790,0,1904-12-18,790
1904,12,19,507,507,0,1904-12-19,507
1904,12,20,428,428,0,1904-12-20,428
1904,12,21,635,581,54,1904-12-21,527
1904,12,22,766,746,20,1904-12-22,726
1904,12,23,95,85,10,1904-12-23,75
1904,12,24,76,76,0,1904-12-24,76
1904,12,25,114,68,46,1904-12-25,22
1904,12,26,45,0,45,1904-12-26,-45
1904,12,27,78,23,55,1904-12-27,-32
1904,12,28,62,45,17,1904-12-28,28
1904,12,29,59,59,0,1904-12-29,59
1904,12,30,335,73,262,1904-12-30,-189
1904,12,31,521,4,517,1904-12-31,-513
1905,1,1,-1,-1,-1,1905-1-1,0
1905,1,2,440,0,440,1905-1-2,-440
1905,1,3,365,0,365,1905-1-3,-365
1905,1,4,289,0,289,1905-1-4,-289
1905,1,5,182,0,182,1905-1-5,-182
1905,1,6,414,13,401,1905-1-6,-388
1905,1,7,441,270,171,1905-1-7,99
1905,1,8,485,282,203,1905-1-8,79
1905,1,9,516,314,202,1905-1-9,112
1905,1,10,693,570,123,1905-1-10,447
1905,1,11,1011,847,164,1905-1-11,683
1905,1,12,1111,992,119,1905-1-12,873
1905,1,13,1265,1096,169,1905-1-13,927
1905,1,14,1300,1248,52,1905-1-14,1196
1905,1,15,1604,1523,81,1905-1-15,1442
1905,1,16,1922,1761,161,1905-1-16,1600
1905,1,17,1937,1843,94,1905-1-17,1749
1905,1,18,1835,1740,95,1905-1-18,1645
1905,1,19,1785,1625,160,1905-1-19,1465
1905,1,20,1740,1246,494,1905-1-20,752
1905,1,21,1503,785,718,1905-1-21,67
1905,1,22,1153,405,748,1905-1-22,-343
1905,1,23,637,31,606,1905-1-23,-575
1905,1,24,693,33,660,1905-1-24,-627
1905,1,25,386,0,386,1905-1-25,-386
1905,1,26,120,0,120,1905-1-26,-120
1905,1,27,142,0,142,1905-1-27,-142
1905,1,28,185,0,185,1905-1-28,-185
1905,1,29,2704,0,2704,1905-1-29,-2704
1905,1,30,2883,0,2883,1905-1-30,-2883
1905,1,31,3277,0,3277,1905-1-31,-3277
1905,2,1,3217,0,3217,1905-2-1,-3217
1905,2,2,4114,756,3358,1905-2-2,-2602
1905,2,3,3950,535,3415,1905-2-3,-2880
1905,2,4,4076,769,3307,1905-2-4,-2538
1905,2,5,4063,1009,3054,1905-2-5,-2045
1905,2,6,3894,771,3123,1905-2-6,-2352
1905,2,7,3850,773,3077,1905-2-7,-2304
1905,2,8,3754,1054,2700,1905-2-8,-1646
1905,2,9,3607,1334,2273,1905-2-9,-939
1905,2,10,2674,1093,1581,1905-2-10,-488
1905,2,11,1962,1344,618,1905-2-11,726
1905,2,12,1667,1303,364,1905-2-12,939
1905,2,13,1529,1321,208,1905-2-13,1113
1905,2,14,1857,1575,282,1905-2-14,1293
1905,2,15,787,644,143,1905-2-15,501
1905,2,16,524,433,91,1905-2-16,342
1905,2,17,586,390,196,1905-2-17,194
1905,2,18,544,292,252,1905-2-18,40
1905,2,19,482,213,269,1905-2-19,-56
1905,2,20,305,94,211,1905-2-20,-117
1905,2,21,217,67,150,1905-2-21,-83
1905,2,22,172,55,117,1905-2-22,-62
1905,2,23,301,252,49,1905-2-23,203
1905,2,24,589,564,25,1905-2-24,539
1905,2,25,1735,617,1118,1905-2-25,-501
1905,2,26,1592,481,1111,1905-2-26,-630
1905,2,27,1903,407,1496,1905-2-27,-1089
1905,2,28,1584,272,1312,1905-2-28,-1040
1905,3,1,2159,948,1211,1905-3-1,-263
1905,3,2,3668,2552,1116,1905-3-2,1436
1905,3,3,3741,2734,1007,1905-3-3,1727
1905,3,4,3922,2659,1263,1905-3-4,1396
1905,3,5,3761,2531,1230,1905-3-5,1301
1905,3,6,3466,2606,860,1905-3-6,1746
1905,3,7,3264,2604,660,1905-3-7,1944
1905,3,8,2714,2232,482,1905-3-8,1750
1905,3,9,2211,1869,342,1905-3-9,1527
1905,3,10,1421,1204,217,1905-3-10,987
1905,3,11,1090,1090,0,1905-3-11,1090
1905,3,12,506,506,0,1905-3-12,506
1905,3,13,584,584,0,1905-3-13,584
1905,3,14,79,0,79,1905-3-14,-79
1905,3,15,70,0,70,1905-3-15,-70
1905,3,16,227,0,227,1905-3-16,-227
1905,3,17,408,0,408,1905-3-17,-408
1905,3,18,313,0,313,1905-3-18,-313
1905,3,19,319,0,319,1905-3-19,-319
1905,3,20,424,0,424,1905-3-20,-424
1905,3,21,391,60,331,1905-3-21,-271
1905,3,22,442,65,377,1905-3-22,-312
1905,3,23,365,37,328,1905-3-23,-291
1905,3,24,301,63,238,1905-3-24,-175
1905,3,25,882,41,841,1905-3-25,-800
1905,3,26,736,14,722,1905-3-26,-708
1905,3,27,669,35,634,1905-3-27,-599
1905,3,28,641,73,568,1905-3-28,-495
1905,3,29,550,75,475,1905-3-29,-400
1905,3,30,500,98,402,1905-3-30,-304
1905,3,31,404,40,364,1905-3-31,-324
1905,4,1,431,40,391,1905-4-1,-351
1905,4,2,351,53,298,1905-4-2,-245
1905,4,3,423,252,171,1905-4-3,81
1905,4,4,427,308,119,1905-4-4,189
1905,4,5,558,399,159,1905-4-5,240
1905,4,6,317,317,0,1905-4-6,317
1905,4,7,324,299,25,1905-4-7,274
1905,4,8,205,205,0,1905-4-8,205
1905,4,9,215,215,0,1905-4-9,215
1905,4,10,297,200,97,1905-4-10,103
1905,4,11,509,214,295,1905-4-11,-81
1905,4,12,663,215,448,1905-4-12,-233
1905,4,13,589,135,454,1905-4-13,-319
1905,4,14,654,83,571,1905-4-14,-488
1905,4,15,674,52,622,1905-4-15,-570
1905,4,16,507,38,469,1905-4-16,-431
1905,4,17,379,19,360,1905-4-17,-341
1905,4,18,282,0,282,1905-4-18,-282
1905,4,19,229,0,229,1905-4-19,-229
1905,4,20,192,28,164,1905-4-20,-136
1905,4,21,233,79,154,1905-4-21,-75
1905,4,22,310,310,0,1905-4-22,310
1905,4,23,512,512,0,1905-4-23,512
1905,4,24,635,543,92,1905-4-24,451
1905,4,25,580,471,109,1905-4-25,362
1905,4,26,420,350,70,1905-4-26,280
1905,4,27,297,241,56,1905-4-27,185
1905,4,28,352,325,27,1905-4-28,298
1905,4,29,298,281,17,1905-4-29,264
1905,4,30,389,377,12,1905-4-30,365
1905,5,1,459,450,9,1905-5-1,441
1905,5,2,366,356,10,1905-5-2,346
1905,5,3,495,487,8,1905-5-3,479
1905,5,4,540,536,4,1905-5-4,532
1905,5,5,464,464,0,1905-5-5,464
1905,5,6,427,427,0,1905-5-6,427
1905,5,7,618,449,169,1905-5-7,280
1905,5,8,840,435,405,1905-5-8,30
1905,5,9,838,478,360,1905-5-9,118
1905,5,10,779,565,214,1905-5-10,351
1905,5,11,985,653,332,1905-5-11,321
1905,5,12,1501,1008,493,1905-5-12,515
1905,5,13,1253,646,607,1905-5-13,39
1905,5,14,1240,624,616,1905-5-14,8
1905,5,15,1418,650,768,1905-5-15,-118
1905,5,16,1190,307,883,1905-5-16,-576
1905,5,17,1066,301,765,1905-5-17,-464
1905,5,18,977,244,733,1905-5-18,-489
1905,5,19,1053,223,830,1905-5-19,-607
1905,5,20,1198,324,874,1905-5-20,-550
1905,5,21,1068,190,878,1905-5-21,-688
1905,5,22,840,10,830,1905-5-22,-820
1905,5,23,13,13,0,1905-5-23,13
1905,5,24,0,0,0,1905-5-24,0
1905,5,25,9,9,0,1905-5-25,9
1905,5,26,122,122,0,1905-5-26,122
1905,5,27,114,114,0,1905-5-27,114
1905,5,28,154,154,0,1905-5-28,154
1905,5,29,125,125,0,1905-5-29,125
1905,5,30,147,147,0,1905-5-30,147
1905,5,31,396,392,4,1905-5-31,388
1905,6,1,800,787,13,1905-6-1,774
1905,6,2,643,616,27,1905-6-2,589
1905,6,3,594,463,131,1905-6-3,332
1905,6,4,719,407,312,1905-6-4,95
1905,6,5,590,410,180,1905-6-5,230
1905,6,6,518,339,179,1905-6-6,160
1905,6,7,541,285,256,1905-6-7,29
1905,6,8,883,422,461,1905-6-8,-39
1905,6,9,749,299,450,1905-6-9,-151
1905,6,10,591,234,357,1905-6-10,-123
1905,6,11,582,218,364,1905-6-11,-146
1905,6,12,439,81,358,1905-6-12,-277
1905,6,13,385,72,313,1905-6-13,-241
1905,6,14,468,90,378,1905-6-14,-288
1905,6,15,459,79,380,1905-6-15,-301
1905,6,16,487,69,418,1905-6-16,-349
1905,6,17,430,90,340,1905-6-17,-250
1905,6,18,356,45,311,1905-6-18,-266
1905,6,19,204,21,183,1905-6-19,-162
1905,6,20,61,20,41,1905-6-20,-21
1905,6,21,50,26,24,1905-6-21,2
1905,6,22,133,121,12,1905-6-22,109
1905,6,23,553,553,0,1905-6-23,553
1905,6,24,738,706,32,1905-6-24,674
1905,6,25,812,773,39,1905-6-25,734
1905,6,26,1328,1127,201,1905-6-26,926
1905,6,27,1571,1280,291,1905-6-27,989
1905,6,28,1475,1286,189,1905-6-28,1097
1905,6,29,1265,1192,73,1905-6-29,1119
1905,6,30,1117,976,141,1905-6-30,835
1905,7,1,1087,996,91,1905-7-1,905
1905,7,2,854,620,234,1905-7-2,386
1905,7,3,321,14,307,1905-7-3,-293
1905,7,4,297,21,276,1905-7-4,-255
1905,7,5,328,8,320,1905-7-5,-312
1905,7,6,510,22,488,1905-7-6,-466
1905,7,7,681,0,681,1905-7-7,-681
1905,7,8,684,0,684,1905-7-8,-684
1905,7,9,1220,0,1220,1905-7-9,-1220
1905,7,10,2084,963,1121,1905-7-10,-158
1905,7,11,3425,2199,1226,1905-7-11,973
1905,7,12,2961,1791,1170,1905-7-12,621
1905,7,13,3138,1944,1194,1905-7-13,750
1905,7,14,3079,1882,1197,1905-7-14,685
1905,7,15,3504,2138,1366,1905-7-15,772
1905,7,16,3958,2428,1530,1905-7-16,898
1905,7,17,3466,2409,1057,1905-7-17,1352
1905,7,18,2557,2347,210,1905-7-18,2137
1905,7,19,2779,2568,211,1905-7-19,2357
1905,7,20,2903,2727,176,1905-7-20,2551
1905,7,21,3093,2922,171,1905-7-21,2751
1905,7,22,3054,2925,129,1905-7-22,2796
1905,7,23,1071,1055,16,1905-7-23,1039
1905,7,24,945,918,27,1905-7-24,891
1905,7,25,276,268,8,1905-7-25,260
1905,7,26,58,54,4,1905-7-26,50
1905,7,27,12,12,0,1905-7-27,12
1905,7,28,0,0,0,1905-7-28,0
1905,7,29,13,0,13,1905-7-29,-13
1905,7,30,0,0,0,1905-7-30,0
1905,7,31,786,253,533,1905-7-31,-280
1905,8,1,1028,251,777,1905-8-1,-526
1905,8,2,1067,300,767,1905-8-2,-467
1905,8,3,1112,238,874,1905-8-3,-636
1905,8,4,1043,242,801,1905-8-4,-559
1905,8,5,1065,281,784,1905-8-5,-503
1905,8,6,1836,1082,754,1905-8-6,328
1905,8,7,1943,1202,741,1905-8-7,461
1905,8,8,2348,1460,888,1905-8-8,572
1905,8,9,2365,1362,1003,1905-8-9,359
1905,8,10,2310,1280,1030,1905-8-10,250
1905,8,11,2224,1254,970,1905-8-11,284
1905,8,12,1868,1087,781,1905-8-12,306
1905,8,13,1164,1164,0,1905-8-13,1164
1905,8,14,1048,1048,0,1905-8-14,1048
1905,8,15,1132,1132,0,1905-8-15,1132
1905,8,16,1080,1080,0,1905-8-16,1080
1905,8,17,958,958,0,1905-8-17,958
1905,8,18,692,692,0,1905-8-18,692
1905,8,19,597,597,0,1905-8-19,597
1905,8,20,635,618,17,1905-8-20,601
1905,8,21,586,539,47,1905-8-21,492
1905,8,22,759,662,97,1905-8-22,565
1905,8,23,801,653,148,1905-8-23,505
1905,8,24,781,571,210,1905-8-24,361
1905,8,25,687,480,207,1905-8-25,273
1905,8,26,385,385,0,1905-8-26,385
1905,8,27,314,314,0,1905-8-27,314
1905,8,28,856,275,581,1905-8-28,-306
1905,8,29,1053,461,592,1905-8-29,-131
1905,8,30,999,426,573,1905-8-30,-147
1905,8,31,1209,592,617,1905-8-31,-25
1905,9,1,1128,525,603,1905-9-1,-78
1905,9,2,875,417,458,1905-9-2,-41
1905,9,3,926,457,469,1905-9-3,-12
1905,9,4,1119,620,499,1905-9-4,121
1905,9,5,830,509,321,1905-9-5,188
1905,9,6,651,451,200,1905-9-6,251
1905,9,7,688,501,187,1905-9-7,314
1905,9,8,1060,508,552,1905-9-8,-44
1905,9,9,1199,252,947,1905-9-9,-695
1905,9,10,1402,554,848,1905-9-10,-294
1905,9,11,1010,391,619,1905-9-11,-228
1905,9,12,1147,613,534,1905-9-12,79
1905,9,13,1189,545,644,1905-9-13,-99
1905,9,14,1113,454,659,1905-9-14,-205
1905,9,15,917,438,479,1905-9-15,-41
1905,9,16,734,415,319,1905-9-16,96
1905,9,17,639,388,251,1905-9-17,137
1905,9,18,576,329,247,1905-9-18,82
1905,9,19,297,210,87,1905-9-19,123
1905,9,20,182,145,37,1905-9-20,108
1905,9,21,138,100,38,1905-9-21,62
1905,9,22,28,6,22,1905-9-22,-16
1905,9,23,37,37,0,1905-9-23,37
1905,9,24,20,20,0,1905-9-24,20
1905,9,25,83,83,0,1905-9-25,83
1905,9,26,78,78,0,1905-9-26,78
1905,9,27,115,50,65,1905-9-27,-15
1905,9,28,1246,1079,167,1905-9-28,912
1905,9,29,834,697,137,1905-9-29,560
1905,9,30,625,563,62,1905-9-30,501
1905,10,1,606,570,36,1905-10-1,534
1905,10,2,934,796,138,1905-10-2,658
1905,10,3,1103,929,174,1905-10-3,755
1905,10,4,1364,1181,183,1905-10-4,998
1905,10,5,1650,1497,153,1905-10-5,1344
1905,10,6,2185,1930,255,1905-10-6,1675
1905,10,7,1704,1555,149,1905-10-7,1406
1905,10,8,1379,1197,182,1905-10-8,1015
1905,10,9,907,816,91,1905-10-9,725
1905,10,10,688,669,19,1905-10-10,650
1905,10,11,681,597,84,1905-10-11,513
1905,10,12,700,700,0,1905-10-12,700
1905,10,13,927,927,0,1905-10-13,927
1905,10,14,2259,2259,0,1905-10-14,2259
1905,10,15,2861,2861,0,1905-10-15,2861
1905,10,16,3238,3238,0,1905-10-16,3238
1905,10,17,3161,3161,0,1905-10-17,3161
1905,10,18,3153,3153,0,1905-10-18,3153
1905,10,19,3270,3270,0,1905-10-19,3270
1905,10,20,3104,3104,0,1905-10-20,3104
1905,10,21,3636,3636,0,1905-10-21,3636
1905,10,22,3664,3664,0,1905-10-22,3664
1905,10,23,3374,3374,0,1905-10-23,3374
1905,10,24,2888,2888,0,1905-10-24,2888
1905,10,25,2828,2828,0,1905-10-25,2828
1905,10,26,2563,2563,0,1905-10-26,2563
1905,10,27,1668,1668,0,1905-10-27,1668
1905,10,28,1550,1535,15,1905-10-28,1520
1905,10,29,1867,1850,17,1905-10-29,1833
1905,10,30,1880,1853,27,1905-10-30,1826
1905,10,31,2082,2082,0,1905-10-31,2082
1905,11,1,1906,1838,68,1905-11-1,1770
1905,11,2,2165,2121,44,1905-11-2,2077
1905,11,3,1654,1445,209,1905-11-3,1236
1905,11,4,1301,1080,221,1905-11-4,859
1905,11,5,994,866,128,1905-11-5,738
1905,11,6,1198,1124,74,1905-11-6,1050
1905,11,7,1900,1885,15,1905-11-7,1870
1905,11,8,1791,1768,23,1905-11-8,1745
1905,11,9,1954,1914,40,1905-11-9,1874
1905,11,10,2224,2167,57,1905-11-10,2110
1905,11,11,2487,2315,172,1905-11-11,2143
1905,11,12,2905,2547,358,1905-11-12,2189
1905,11,13,2975,2509,466,1905-11-13,2043
1905,11,14,2537,2161,376,1905-11-14,1785
1905,11,15,1489,1252,237,1905-11-15,1015
1905,11,16,1286,1106,180,1905-11-16,926
1905,11,17,1075,889,186,1905-11-17,703
1905,11,18,1382,1180,202,1905-11-18,978
1905,11,19,1386,1192,194,1905-11-19,998
1905,11,20,1395,1267,128,1905-11-20,1139
1905,11,21,1552,1435,117,1905-11-21,1318
1905,11,22,1419,1186,233,1905-11-22,953
1905,11,23,1206,941,265,1905-11-23,676
1905,11,24,2275,927,1348,1905-11-24,-421
1905,11,25,3204,847,2357,1905-11-25,-1510
1905,11,26,3019,893,2126,1905-11-26,-1233
1905,11,27,3022,821,2201,1905-11-27,-1380
1905,11,28,2556,552,2004,1905-11-28,-1452
1905,11,29,2300,402,1898,1905-11-29,-1496
1905,11,30,1832,285,1547,1905-11-30,-1262
1905,12,1,1309,0,1309,1905-12-1,-1309
1905,12,2,1213,53,1160,1905-12-2,-1107
1905,12,3,859,134,725,1905-12-3,-591
1905,12,4,877,188,689,1905-12-4,-501
1905,12,5,833,209,624,1905-12-5,-415
1905,12,6,484,184,300,1905-12-6,-116
1905,12,7,472,123,349,1905-12-7,-226
1905,12,8,422,93,329,1905-12-8,-236
1905,12,9,302,92,210,1905-12-9,-118
1905,12,10,183,36,147,1905-12-10,-111
1905,12,11,149,17,132,1905-12-11,-115
1905,12,12,542,422,120,1905-12-12,302
1905,12,13,652,494,158,1905-12-13,336
1905,12,14,1083,871,212,1905-12-14,659
1905,12,15,963,702,261,1905-12-15,441
1905,12,16,781,600,181,1905-12-16,419
1905,12,17,616,599,17,1905-12-17,582
1905,12,18,704,685,19,1905-12-18,666
1905,12,19,733,661,72,1905-12-19,589
1905,12,20,713,630,83,1905-12-20,547
1905,12,21,626,559,67,1905-12-21,492
1905,12,22,762,708,54,1905-12-22,654
1905,12,23,1130,931,199,1905-12-23,732
1905,12,24,1471,1180,291,1905-12-24,889
1905,12,25,942,728,214,1905-12-25,514
1905,12,26,1305,651,654,1905-12-26,-3
1905,12,27,1268,568,700,1905-12-27,-132
1905,12,28,1139,410,729,1905-12-28,-319
1905,12,29,678,12,666,1905-12-29,-654
1905,12,30,646,49,597,1905-12-30,-548
1905,12,31,747,39,708,1905-12-31,-669
1906,1,1,832,31,801,1906-1-1,-770
1906,1,2,764,59,705,1906-1-2,-646
1906,1,3,721,72,649,1906-1-3,-577
1906,1,4,457,76,381,1906-1-4,-305
1906,1,5,400,80,320,1906-1-5,-240
1906,1,6,386,105,281,1906-1-6,-176
1906,1,7,77,77,0,1906-1-7,77
1906,1,8,486,486,0,1906-1-8,486
1906,1,9,626,626,0,1906-1-9,626
1906,1,10,589,589,0,1906-1-10,589
1906,1,11,523,523,0,1906-1-11,523
1906,1,12,566,566,0,1906-1-12,566
1906,1,13,535,535,0,1906-1-13,535
1906,1,14,508,508,0,1906-1-14,508
1906,1,15,404,404,0,1906-1-15,404
1906,1,16,326,326,0,1906-1-16,326
1906,1,17,308,290,18,1906-1-17,272
1906,1,18,280,280,0,1906-1-18,280
1906,1,19,323,323,0,1906-1-19,323
1906,1,20,332,332,0,1906-1-20,332
1906,1,21,159,90,69,1906-1-21,21
1906,1,22,679,167,512,1906-1-22,-345
1906,1,23,952,186,766,1906-1-23,-580
1906,1,24,1193,231,962,1906-1-24,-731
1906,1,25,1245,316,929,1906-1-25,-613
1906,1,26,2038,1208,830,1906-1-26,378
1906,1,27,1814,1042,772,1906-1-27,270
1906,1,28,1681,1086,595,1906-1-28,491
1906,1,29,1540,870,670,1906-1-29,200
1906,1,30,1381,794,587,1906-1-30,207
1906,1,31,706,628,78,1906-1-31,550
1906,2,1,774,684,90,1906-2-1,594
1906,2,2,576,541,35,1906-2-2,506
1906,2,3,579,579,0,1906-2-3,579
1906,2,4,605,595,10,1906-2-4,585
1906,2,5,431,368,63,1906-2-5,305
1906,2,6,273,241,32,1906-2-6,209
1906,2,7,200,188,12,1906-2-7,176
1906,2,8,184,184,0,1906-2-8,184
1906,2,9,252,252,0,1906-2-9,252
1906,2,10,213,213,0,1906-2-10,213
1906,2,11,238,238,0,1906-2-11,238
1906,2,12,129,129,0,1906-2-12,129
1906,2,13,166,166,0,1906-2-13,166
1906,2,14,310,129,181,1906-2-14,-52
1906,2,15,311,65,246,1906-2-15,-181
1906,2,16,155,0,155,1906-2-16,-155
1906,2,17,322,173,149,1906-2-17,24
1906,2,18,555,376,179,1906-2-18,197
1906,2,19,455,300,155,1906-2-19,145
1906,2,20,591,404,187,1906-2-20,217
1906,2,21,586,436,150,1906-2-21,286
1906,2,22,622,443,179,1906-2-22,264
1906,2,23,485,329,156,1906-2-23,173
1906,2,24,538,343,195,1906-2-24,148
1906,2,25,558,301,257,1906-2-25,44
1906,2,26,406,236,170,1906-2-26,66
1906,2,27,243,223,20,1906-2-27,203
1906,2,28,307,289,18,1906-2-28,271
1906,3,1,148,129,19,1906-3-1,110
1906,3,2,389,150,239,1906-3-2,-89
1906,3,3,286,132,154,1906-3-3,-22
1906,3,4,273,150,123,1906-3-4,27
1906,3,5,138,26,112,1906-3-5,-86
1906,3,6,570,469,101,1906-3-6,368
1906,3,7,419,380,39,1906-3-7,341
1906,3,8,478,421,57,1906-3-8,364
1906,3,9,488,418,70,1906-3-9,348
1906,3,10,774,599,175,1906-3-10,424
1906,3,11,774,624,150,1906-3-11,474
1906,3,12,660,542,118,1906-3-12,424
1906,3,13,632,543,89,1906-3-13,454
1906,3,14,740,603,137,1906-3-14,466
1906,3,15,891,831,60,1906-3-15,771
1906,3,16,784,748,36,1906-3-16,712
1906,3,17,822,377,445,1906-3-17,-68
1906,3,18,882,632,250,1906-3-18,382
1906,3,19,1659,1298,361,1906-3-19,937
1906,3,20,1716,1192,524,1906-3-20,668
1906,3,21,2409,1494,915,1906-3-21,579
1906,3,22,2613,1865,748,1906-3-22,1117
1906,3,23,2527,1909,618,1906-3-23,1291
1906,3,24,2272,1739,533,1906-3-24,1206
1906,3,25,2094,1533,561,1906-3-25,972
1906,3,26,1640,1267,373,1906-3-26,894
1906,3,27,1342,1018,324,1906-3-27,694
1906,3,28,1087,640,447,1906-3-28,193
1906,3,29,1133,547,586,1906-3-29,-39
1906,3,30,1133,443,690,1906-3-30,-247
1906,3,31,1006,345,661,1906-3-31,-316
1906,4,1,928,401,527,1906-4-1,-126
1906,4,2,911,420,491,1906-4-2,-71
1906,4,3,843,456,387,1906-4-3,69
1906,4,4,818,459,359,1906-4-4,100
1906,4,5,915,617,298,1906-4-5,319
1906,4,6,1360,1033,327,1906-4-6,706
1906,4,7,1325,880,445,1906-4-7,435
1906,4,8,940,846,94,1906-4-8,752
1906,4,9,1186,954,232,1906-4-9,722
1906,4,10,1004,825,179,1906-4-10,646
1906,4,11,746,625,121,1906-4-11,504
1906,4,12,630,549,81,1906-4-12,468
1906,4,13,501,460,41,1906-4-13,419
1906,4,14,806,790,16,1906-4-14,774
1906,4,15,682,674,8,1906-4-15,666
1906,4,16,736,643,93,1906-4-16,550
1906,4,17,559,509,50,1906-4-17,459
1906,4,18,500,488,12,1906-4-18,476
1906,4,19,490,461,29,1906-4-19,432
1906,4,20,452,431,21,1906-4-20,410
1906,4,21,299,299,0,1906-4-21,299
1906,4,22,311,305,6,1906-4-22,299
1906,4,23,385,385,0,1906-4-23,385
1906,4,24,495,495,0,1906-4-24,495
1906,4,25,490,490,0,1906-4-25,490
1906,4,26,631,599,32,1906-4-26,567
1906,4,27,431,431,0,1906-4-27,431
1906,4,28,406,406,0,1906-4-28,406
1906,4,29,369,369,0,1906-4-29,369
1906,4,30,489,489,0,1906-4-30,489
1906,5,1,476,476,0,1906-5-1,476
1906,5,2,486,486,0,1906-5-2,486
1906,5,3,306,306,0,1906-5-3,306
1906,5,4,746,397,349,1906-5-4,48
1906,5,5,888,110,778,1906-5-5,-668
1906,5,6,825,192,633,1906-5-6,-441
1906,5,7,769,270,499,1906-5-7,-229
1906,5,8,633,234,399,1906-5-8,-165
1906,5,9,645,272,373,1906-5-9,-101
1906,5,10,521,180,341,1906-5-10,-161
1906,5,11,491,162,329,1906-5-11,-167
1906,5,12,542,191,351,1906-5-12,-160
1906,5,13,814,476,338,1906-5-13,138
1906,5,14,1679,1340,339,1906-5-14,1001
1906,5,15,1879,1570,309,1906-5-15,1261
1906,5,16,2053,1780,273,1906-5-16,1507
1906,5,17,2179,1929,250,1906-5-17,1679
1906,5,18,1586,1586,0,1906-5-18,1586
1906,5,19,1474,1474,0,1906-5-19,1474
1906,5,20,1557,1557,0,1906-5-20,1557
1906,5,21,1454,1454,0,1906-5-21,1454
1906,5,22,821,821,0,1906-5-22,821
1906,5,23,1150,1150,0,1906-5-23,1150
1906,5,24,1103,1103,0,1906-5-24,1103
1906,5,25,1359,1359,0,1906-5-25,1359
1906,5,26,1323,1323,0,1906-5-26,1323
1906,5,27,1439,1423,16,1906-5-27,1407
1906,5,28,1292,1188,104,1906-5-28,1084
1906,5,29,1303,1077,226,1906-5-29,851
1906,5,30,1210,1085,125,1906-5-30,960
1906,5,31,1267,1171,96,1906-5-31,1075
1906,6,1,833,719,114,1906-6-1,605
1906,6,2,811,668,143,1906-6-2,525
1906,6,3,639,574,65,1906-6-3,509
1906,6,4,724,572,152,1906-6-4,420
1906,6,5,790,440,350,1906-6-5,90
1906,6,6,870,479,391,1906-6-6,88
1906,6,7,574,330,244,1906-6-7,86
1906,6,8,432,354,78,1906-6-8,276
1906,6,9,561,524,37,1906-6-9,487
1906,6,10,560,535,25,1906-6-10,510
1906,6,11,669,632,37,1906-6-11,595
1906,6,12,908,908,0,1906-6-12,908
1906,6,13,708,708,0,1906-6-13,708
1906,6,14,420,401,19,1906-6-14,382
1906,6,15,207,166,41,1906-6-15,125
1906,6,16,265,200,65,1906-6-16,135
1906,6,17,220,153,67,1906-6-17,86
1906,6,18,18,18,0,1906-6-18,18
1906,6,19,127,122,5,1906-6-19,117
1906,6,20,167,142,25,1906-6-20,117
1906,6,21,208,184,24,1906-6-21,160
1906,6,22,403,239,164,1906-6-22,75
1906,6,23,343,258,85,1906-6-23,173
1906,6,24,604,594,10,1906-6-24,584
1906,6,25,661,661,0,1906-6-25,661
1906,6,26,1225,916,309,1906-6-26,607
1906,6,27,1393,948,445,1906-6-27,503
1906,6,28,2368,1837,531,1906-6-28,1306
1906,6,29,2184,1682,502,1906-6-29,1180
1906,6,30,2588,2191,397,1906-6-30,1794
1906,7,1,2240,1770,470,1906-7-1,1300
1906,7,2,2083,1651,432,1906-7-2,1219
1906,7,3,2395,1843,552,1906-7-3,1291
1906,7,4,2485,2036,449,1906-7-4,1587
1906,7,5,2478,2087,391,1906-7-5,1696
1906,7,6,2146,1730,416,1906-7-6,1314
1906,7,7,2031,1665,366,1906-7-7,1299
1906,7,8,1371,1358,13,1906-7-8,1345
1906,7,9,1041,1019,22,1906-7-9,997
1906,7,10,1147,1100,47,1906-7-10,1053
1906,7,11,1453,1436,17,1906-7-11,1419
1906,7,12,1186,1143,43,1906-7-12,1100
1906,7,13,892,878,14,1906-7-13,864
1906,7,14,898,816,82,1906-7-14,734
1906,7,15,999,930,69,1906-7-15,861
1906,7,16,963,786,177,1906-7-16,609
1906,7,17,885,766,119,1906-7-17,647
1906,7,18,1661,1520,141,1906-7-18,1379
1906,7,19,1272,1141,131,1906-7-19,1010
1906,7,20,1696,1429,267,1906-7-20,1162
1906,7,21,1425,1260,165,1906-7-21,1095
1906,7,22,1141,1082,59,1906-7-22,1023
1906,7,23,958,849,109,1906-7-23,740
1906,7,24,843,622,221,1906-7-24,401
1906,7,25,1040,886,154,1906-7-25,732
1906,7,26,949,872,77,1906-7-26,795
1906,7,27,1033,912,121,1906-7-27,791
1906,7,28,1018,860,158,1906-7-28,702
1906,7,29,1173,702,471,1906-7-29,231
1906,7,30,1942,798,1144,1906-7-30,-346
1906,7,31,2010,523,1487,1906-7-31,-964
1906,8,1,1893,451,1442,1906-8-1,-991
1906,8,2,1903,481,1422,1906-8-2,-941
1906,8,3,1720,450,1270,1906-8-3,-820
1906,8,4,1523,432,1091,1906-8-4,-659
1906,8,5,1013,414,599,1906-8-5,-185
1906,8,6,448,448,0,1906-8-6,448
1906,8,7,441,441,0,1906-8-7,441
1906,8,8,105,105,0,1906-8-8,105
1906,8,9,124,105,19,1906-8-9,86
1906,8,10,172,122,50,1906-8-10,72
1906,8,11,150,111,39,1906-8-11,72
1906,8,12,187,84,103,1906-8-12,-19
1906,8,13,215,107,108,1906-8-13,-1
1906,8,14,170,93,77,1906-8-14,16
1906,8,15,218,182,36,1906-8-15,146
1906,8,16,265,203,62,1906-8-16,141
1906,8,17,268,169,99,1906-8-17,70
1906,8,18,144,88,56,1906-8-18,32
1906,8,19,289,289,0,1906-8-19,289
1906,8,20,278,278,0,1906-8-20,278
1906,8,21,591,263,328,1906-8-21,-65
1906,8,22,787,473,314,1906-8-22,159
1906,8,23,786,437,349,1906-8-23,88
1906,8,24,771,291,480,1906-8-24,-189
1906,8,25,832,333,499,1906-8-25,-166
1906,8,26,970,251,719,1906-8-26,-468
1906,8,27,1074,264,810,1906-8-27,-546
1906,8,28,1146,242,904,1906-8-28,-662
1906,8,29,1446,433,1013,1906-8-29,-580
1906,8,30,1469,501,968,1906-8-30,-467
1906,8,31,1496,442,1054,1906-8-31,-612
1906,9,1,1200,511,689,1906-9-1,-178
1906,9,2,876,520,356,1906-9-2,164
1906,9,3,545,414,131,1906-9-3,283
1906,9,4,415,303,112,1906-9-4,191
1906,9,5,170,73,97,1906-9-5,-24
1906,9,6,365,153,212,1906-9-6,-59
1906,9,7,449,204,245,1906-9-7,-41
1906,9,8,387,108,279,1906-9-8,-171
1906,9,9,494,229,265,1906-9-9,-36
1906,9,10,647,436,211,1906-9-10,225
1906,9,11,652,447,205,1906-9-11,242
1906,9,12,557,392,165,1906-9-12,227
1906,9,13,589,446,143,1906-9-13,303
1906,9,14,762,590,172,1906-9-14,418
1906,9,15,648,562,86,1906-9-15,476
1906,9,16,791,645,146,1906-9-16,499
1906,9,17,868,738,130,1906-9-17,608
1906,9,18,858,725,133,1906-9-18,592
1906,9,19,779,621,158,1906-9-19,463
1906,9,20,712,591,121,1906-9-20,470
1906,9,21,637,536,101,1906-9-21,435
1906,9,22,527,367,160,1906-9-22,207
1906,9,23,311,173,138,1906-9-23,35
1906,9,24,256,142,114,1906-9-24,28
1906,9,25,132,26,106,1906-9-25,-80
1906,9,26,100,21,79,1906-9-26,-58
1906,9,27,263,15,248,1906-9-27,-233
1906,9,28,183,4,179,1906-9-28,-175
1906,9,29,216,6,210,1906-9-29,-204
1906,9,30,99,9,90,1906-9-30,-81
1906,10,1,91,5,86,1906-10-1,-81
1906,10,2,136,0,136,1906-10-2,-136
1906,10,3,332,0,332,1906-10-3,-332
1906,10,4,444,25,419,1906-10-4,-394
1906,10,5,506,0,506,1906-10-5,-506
1906,10,6,435,4,431,1906-10-6,-427
1906,10,7,122,10,112,1906-10-7,-102
1906,10,8,55,17,38,1906-10-8,-21
1906,10,9,65,21,44,1906-10-9,-23
1906,10,10,92,16,76,1906-10-10,-60
1906,10,11,88,5,83,1906-10-11,-78
1906,10,12,30,0,30,1906-10-12,-30
1906,10,13,0,0,0,1906-10-13,0
1906,10,14,37,37,0,1906-10-14,37
1906,10,15,136,136,0,1906-10-15,136
1906,10,16,63,58,5,1906-10-16,53
1906,10,17,0,0,0,1906-10-17,0
1906,10,18,0,0,0,1906-10-18,0
1906,10,19,0,0,0,1906-10-19,0
1906,10,20,9,9,0,1906-10-20,9
1906,10,21,30,20,10,1906-10-21,10
1906,10,22,23,23,0,1906-10-22,23
1906,10,23,14,14,0,1906-10-23,14
1906,10,24,35,35,0,1906-10-24,35
1906,10,25,36,23,13,1906-10-25,10
1906,10,26,15,7,8,1906-10-26,-1
1906,10,27,3,0,3,1906-10-27,-3
1906,10,28,0,0,0,1906-10-28,0
1906,10,29,13,13,0,1906-10-29,13
1906,10,30,26,26,0,1906-10-30,26
1906,10,31,223,223,0,1906-10-31,223
1906,11,1,271,271,0,1906-11-1,271
1906,11,2,333,333,0,1906-11-2,333
1906,11,3,274,274,0,1906-11-3,274
1906,11,4,249,249,0,1906-11-4,249
1906,11,5,138,138,0,1906-11-5,138
1906,11,6,119,119,0,1906-11-6,119
1906,11,7,37,37,0,1906-11-7,37
1906,11,8,708,21,687,1906-11-8,-666
1906,11,9,698,48,650,1906-11-9,-602
1906,11,10,706,77,629,1906-11-10,-552
1906,11,11,681,67,614,1906-11-11,-547
1906,11,12,859,111,748,1906-11-12,-637
1906,11,13,806,92,714,1906-11-13,-622
1906,11,14,716,133,583,1906-11-14,-450
1906,11,15,579,110,469,1906-11-15,-359
1906,11,16,456,77,379,1906-11-16,-302
1906,11,17,424,35,389,1906-11-17,-354
1906,11,18,511,18,493,1906-11-18,-475
1906,11,19,615,5,610,1906-11-19,-605
1906,11,20,302,0,302,1906-11-20,-302
1906,11,21,234,0,234,1906-11-21,-234
1906,11,22,230,13,217,1906-11-22,-204
1906,11,23,411,225,186,1906-11-23,39
1906,11,24,554,424,130,1906-11-24,294
1906,11,25,758,668,90,1906-11-25,578
1906,11,26,1164,1079,85,1906-11-26,994
1906,11,27,1231,1166,65,1906-11-27,1101
1906,11,28,1022,954,68,1906-11-28,886
1906,11,29,890,890,0,1906-11-29,890
1906,11,30,846,846,0,1906-11-30,846
1906,12,1,749,731,18,1906-12-1,713
1906,12,2,772,742,30,1906-12-2,712
1906,12,3,1046,1003,43,1906-12-3,960
1906,12,4,925,883,42,1906-12-4,841
1906,12,5,529,424,105,1906-12-5,319
1906,12,6,273,198,75,1906-12-6,123
1906,12,7,57,14,43,1906-12-7,-29
1906,12,8,109,64,45,1906-12-8,19
1906,12,9,98,33,65,1906-12-9,-32
1906,12,10,170,86,84,1906-12-10,2
1906,12,11,202,136,66,1906-12-11,70
1906,12,12,1285,404,881,1906-12-12,-477
1906,12,13,1424,562,862,1906-12-13,-300
1906,12,14,1317,449,868,1906-12-14,-419
1906,12,15,1617,761,856,1906-12-15,-95
1906,12,16,1591,853,738,1906-12-16,115
1906,12,17,1586,797,789,1906-12-17,8
1906,12,18,1837,911,926,1906-12-18,-15
1906,12,19,1903,1056,847,1906-12-19,209
1906,12,20,1786,983,803,1906-12-20,180
1906,12,21,2590,1699,891,1906-12-21,808
1906,12,22,2423,1535,888,1906-12-22,647
1906,12,23,1991,1124,867,1906-12-23,257
1906,12,24,2152,1331,821,1906-12-24,510
1906,12,25,2129,1266,863,1906-12-25,403
1906,12,26,642,604,38,1906-12-26,566
1906,12,27,699,686,13,1906-12-27,673
1906,12,28,-1,-1,-1,1906-12-28,0
1906,12,29,1492,1484,8,1906-12-29,1476
1906,12,30,1435,1422,13,1906-12-30,1409
1906,12,31,1381,1337,44,1906-12-31,1293
1907,1,1,1308,1247,61,1907-1-1,1186
1907,1,2,1490,1294,196,1907-1-2,1098
1907,1,3,1325,1188,137,1907-1-3,1051
1907,1,4,1466,1351,115,1907-1-4,1236
1907,1,5,1514,1369,145,1907-1-5,1224
1907,1,6,1560,1459,101,1907-1-6,1358
1907,1,7,571,550,21,1907-1-7,529
1907,1,8,1186,611,575,1907-1-8,36
1907,1,9,1315,474,841,1907-1-9,-367
1907,1,10,1058,117,941,1907-1-10,-824
1907,1,11,798,94,704,1907-1-11,-610
1907,1,12,1157,157,1000,1907-1-12,-843
1907,1,13,1315,184,1131,1907-1-13,-947
1907,1,14,1002,15,987,1907-1-14,-972
1907,1,15,1286,66,1220,1907-1-15,-1154
1907,1,16,1571,125,1446,1907-1-16,-1321
1907,1,17,1322,194,1128,1907-1-17,-934
1907,1,18,1043,140,903,1907-1-18,-763
1907,1,19,863,107,756,1907-1-19,-649
1907,1,20,1165,308,857,1907-1-20,-549
1907,1,21,844,488,356,1907-1-21,132
1907,1,22,716,442,274,1907-1-22,168
1907,1,23,672,432,240,1907-1-23,192
1907,1,24,973,727,246,1907-1-24,481
1907,1,25,1271,1037,234,1907-1-25,803
1907,1,26,779,506,273,1907-1-26,233
1907,1,27,726,503,223,1907-1-27,280
1907,1,28,834,834,0,1907-1-28,834
1907,1,29,1683,1683,0,1907-1-29,1683
1907,1,30,2031,2031,0,1907-1-30,2031
1907,1,31,2253,2253,0,1907-1-31,2253
1907,2,1,2193,2187,6,1907-2-1,2181
1907,2,2,1692,1680,12,1907-2-2,1668
1907,2,3,1670,1664,6,1907-2-3,1658
1907,2,4,2239,1438,801,1907-2-4,637
1907,2,5,2565,1315,1250,1907-2-5,65
1907,2,6,2575,1017,1558,1907-2-6,-541
1907,2,7,3104,940,2164,1907-2-7,-1224
1907,2,8,2581,151,2430,1907-2-8,-2279
1907,2,9,2429,27,2402,1907-2-9,-2375
1907,2,10,3402,20,3382,1907-2-10,-3362
1907,2,11,3881,51,3830,1907-2-11,-3779
1907,2,12,3912,79,3833,1907-2-12,-3754
1907,2,13,3881,409,3472,1907-2-13,-3063
1907,2,14,3974,617,3357,1907-2-14,-2740
1907,2,15,3812,720,3092,1907-2-15,-2372
1907,2,16,3869,502,3367,1907-2-16,-2865
1907,2,17,3265,591,2674,1907-2-17,-2083
1907,2,18,2683,588,2095,1907-2-18,-1507
1907,2,19,908,689,219,1907-2-19,470
1907,2,20,794,629,165,1907-2-20,464
1907,2,21,1195,618,577,1907-2-21,41
1907,2,22,1251,552,699,1907-2-22,-147
1907,2,23,1673,660,1013,1907-2-23,-353
1907,2,24,2127,1004,1123,1907-2-24,-119
1907,2,25,2085,1133,952,1907-2-25,181
1907,2,26,1878,1057,821,1907-2-26,236
1907,2,27,1568,904,664,1907-2-27,240
1907,2,28,1478,826,652,1907-2-28,174
1907,3,1,1277,891,386,1907-3-1,505
1907,3,2,826,650,176,1907-3-2,474
1907,3,3,1106,605,501,1907-3-3,104
1907,3,4,1291,535,756,1907-3-4,-221
1907,3,5,1972,381,1591,1907-3-5,-1210
1907,3,6,1729,321,1408,1907-3-6,-1087
1907,3,7,1772,320,1452,1907-3-7,-1132
1907,3,8,1777,313,1464,1907-3-8,-1151
1907,3,9,2106,241,1865,1907-3-9,-1624
1907,3,10,1740,210,1530,1907-3-10,-1320
1907,3,11,1303,175,1128,1907-3-11,-953
1907,3,12,1112,186,926,1907-3-12,-740
1907,3,13,992,163,829,1907-3-13,-666
1907,3,14,830,0,830,1907-3-14,-830
1907,3,15,776,51,725,1907-3-15,-674
1907,3,16,651,48,603,1907-3-16,-555
1907,3,17,619,38,581,1907-3-17,-543
1907,3,18,277,60,217,1907-3-18,-157
1907,3,19,87,36,51,1907-3-19,-15
1907,3,20,228,196,32,1907-3-20,164
1907,3,21,220,202,18,1907-3-21,184
1907,3,22,202,196,6,1907-3-22,190
1907,3,23,339,272,67,1907-3-23,205
1907,3,24,365,215,150,1907-3-24,65
1907,3,25,477,274,203,1907-3-25,71
1907,3,26,122,16,106,1907-3-26,-90
1907,3,27,65,0,65,1907-3-27,-65
1907,3,28,31,0,31,1907-3-28,-31
1907,3,29,177,158,19,1907-3-29,139
1907,3,30,99,99,0,1907-3-30,99
1907,3,31,512,496,16,1907-3-31,480
1907,4,1,1244,1123,121,1907-4-1,1002
1907,4,2,1406,1214,192,1907-4-2,1022
1907,4,3,1412,1207,205,1907-4-3,1002
1907,4,4,1481,1285,196,1907-4-4,1089
1907,4,5,1742,1206,536,1907-4-5,670
1907,4,6,1390,1053,337,1907-4-6,716
1907,4,7,1234,958,276,1907-4-7,682
1907,4,8,1322,1039,283,1907-4-8,756
1907,4,9,962,833,129,1907-4-9,704
1907,4,10,1026,815,211,1907-4-10,604
1907,4,11,742,650,92,1907-4-11,558
1907,4,12,616,543,73,1907-4-12,470
1907,4,13,212,28,184,1907-4-13,-156
1907,4,14,289,29,260,1907-4-14,-231
1907,4,15,339,5,334,1907-4-15,-329
1907,4,16,250,0,250,1907-4-16,-250
1907,4,17,365,0,365,1907-4-17,-365
1907,4,18,638,127,511,1907-4-18,-384
1907,4,19,584,172,412,1907-4-19,-240
1907,4,20,444,425,19,1907-4-20,406
1907,4,21,426,426,0,1907-4-21,426
1907,4,22,345,333,12,1907-4-22,321
1907,4,23,324,324,0,1907-4-23,324
1907,4,24,243,213,30,1907-4-24,183
1907,4,25,290,233,57,1907-4-25,176
1907,4,26,312,181,131,1907-4-26,50
1907,4,27,429,177,252,1907-4-27,-75
1907,4,28,370,219,151,1907-4-28,68
1907,4,29,291,185,106,1907-4-29,79
1907,4,30,298,206,92,1907-4-30,114
1907,5,1,16,0,16,1907-5-1,-16
1907,5,2,12,0,12,1907-5-2,-12
1907,5,3,755,4,751,1907-5-3,-747
1907,5,4,1268,0,1268,1907-5-4,-1268
1907,5,5,1433,0,1433,1907-5-5,-1433
1907,5,6,1643,20,1623,1907-5-6,-1603
1907,5,7,1353,86,1267,1907-5-7,-1181
1907,5,8,1342,157,1185,1907-5-8,-1028
1907,5,9,1114,340,774,1907-5-9,-434
1907,5,10,1159,424,735,1907-5-10,-311
1907,5,11,1133,546,587,1907-5-11,-41
1907,5,12,1264,575,689,1907-5-12,-114
1907,5,13,1331,587,744,1907-5-13,-157
1907,5,14,1220,435,785,1907-5-14,-350
1907,5,15,1287,515,772,1907-5-15,-257
1907,5,16,274,153,121,1907-5-16,32
1907,5,17,282,149,133,1907-5-17,16
1907,5,18,227,111,116,1907-5-18,-5
1907,5,19,110,81,29,1907-5-19,52
1907,5,20,143,133,10,1907-5-20,123
1907,5,21,115,102,13,1907-5-21,89
1907,5,22,135,82,53,1907-5-22,29
1907,5,23,137,31,106,1907-5-23,-75
1907,5,24,236,25,211,1907-5-24,-186
1907,5,25,150,73,77,1907-5-25,-4
1907,5,26,82,82,0,1907-5-26,82
1907,5,27,50,45,5,1907-5-27,40
1907,5,28,65,27,38,1907-5-28,-11
1907,5,29,265,33,232,1907-5-29,-199
1907,5,30,133,23,110,1907-5-30,-87
1907,5,31,123,0,123,1907-5-31,-123
1907,6,1,122,0,122,1907-6-1,-122
1907,6,2,169,29,140,1907-6-2,-111
1907,6,3,220,71,149,1907-6-3,-78
1907,6,4,173,28,145,1907-6-4,-117
1907,6,5,137,10,127,1907-6-5,-117
1907,6,6,88,0,88,1907-6-6,-88
1907,6,7,64,0,64,1907-6-7,-64
1907,6,8,240,0,240,1907-6-8,-240
1907,6,9,172,0,172,1907-6-9,-172
1907,6,10,238,99,139,1907-6-10,-40
1907,6,11,213,133,80,1907-6-11,53
1907,6,12,207,130,77,1907-6-12,53
1907,6,13,1372,129,1243,1907-6-13,-1114
1907,6,14,2158,80,2078,1907-6-14,-1998
1907,6,15,2874,251,2623,1907-6-15,-2372
1907,6,16,2496,102,2394,1907-6-16,-2292
1907,6,17,2225,63,2162,1907-6-17,-2099
1907,6,18,2345,108,2237,1907-6-18,-2129
1907,6,19,2238,44,2194,1907-6-19,-2150
1907,6,20,2208,24,2184,1907-6-20,-2160
1907,6,21,1988,0,1988,1907-6-21,-1988
1907,6,22,1797,0,1797,1907-6-22,-1797
1907,6,23,1550,0,1550,1907-6-23,-1550
1907,6,24,1555,0,1555,1907-6-24,-1555
1907,6,25,1394,39,1355,1907-6-25,-1316
1907,6,26,77,49,28,1907-6-26,21
1907,6,27,32,24,8,1907-6-27,16
1907,6,28,33,33,0,1907-6-28,33
1907,6,29,54,54,0,1907-6-29,54
1907,6,30,43,43,0,1907-6-30,43
1907,7,1,27,27,0,1907-7-1,27
1907,7,2,512,512,0,1907-7-2,512
1907,7,3,462,451,11,1907-7-3,440
1907,7,4,363,354,9,1907-7-4,345
1907,7,5,400,393,7,1907-7-5,386
1907,7,6,275,270,5,1907-7-6,265
1907,7,7,341,341,0,1907-7-7,341
1907,7,8,354,354,0,1907-7-8,354
1907,7,9,375,375,0,1907-7-9,375
1907,7,10,282,282,0,1907-7-10,282
1907,7,11,1295,412,883,1907-7-11,-471
1907,7,12,2102,616,1486,1907-7-12,-870
1907,7,13,1860,147,1713,1907-7-13,-1566
1907,7,14,1608,135,1473,1907-7-14,-1338
1907,7,15,1731,87,1644,1907-7-15,-1557
1907,7,16,1676,16,1660,1907-7-16,-1644
1907,7,17,1732,15,1717,1907-7-17,-1702
1907,7,18,1261,0,1261,1907-7-18,-1261
1907,7,19,1263,0,1263,1907-7-19,-1263
1907,7,20,1296,0,1296,1907-7-20,-1296
1907,7,21,1295,0,1295,1907-7-21,-1295
1907,7,22,1222,0,1222,1907-7-22,-1222
1907,7,23,1207,44,1163,1907-7-23,-1119
1907,7,24,472,147,325,1907-7-24,-178
1907,7,25,500,166,334,1907-7-25,-168
1907,7,26,583,232,351,1907-7-26,-119
1907,7,27,598,302,296,1907-7-27,6
1907,7,28,671,334,337,1907-7-28,-3
1907,7,29,599,177,422,1907-7-29,-245
1907,7,30,517,146,371,1907-7-30,-225
1907,7,31,480,135,345,1907-7-31,-210
1907,8,1,472,105,367,1907-8-1,-262
1907,8,2,262,162,100,1907-8-2,62
1907,8,3,363,263,100,1907-8-3,163
1907,8,4,210,65,145,1907-8-4,-80
1907,8,5,343,79,264,1907-8-5,-185
1907,8,6,557,305,252,1907-8-6,53
1907,8,7,705,270,435,1907-8-7,-165
1907,8,8,709,321,388,1907-8-8,-67
1907,8,9,790,457,333,1907-8-9,124
1907,8,10,900,669,231,1907-8-10,438
1907,8,11,709,489,220,1907-8-11,269
1907,8,12,507,340,167,1907-8-12,173
1907,8,13,653,484,169,1907-8-13,315
1907,8,14,1144,192,952,1907-8-14,-760
1907,8,15,1175,167,1008,1907-8-15,-841
1907,8,16,1336,200,1136,1907-8-16,-936
1907,8,17,1137,112,1025,1907-8-17,-913
1907,8,18,995,88,907,1907-8-18,-819
1907,8,19,1164,72,1092,1907-8-19,-1020
1907,8,20,953,39,914,1907-8-20,-875
1907,8,21,1032,120,912,1907-8-21,-792
1907,8,22,1090,290,800,1907-8-22,-510
1907,8,23,878,0,878,1907-8-23,-878
1907,8,24,799,0,799,1907-8-24,-799
1907,8,25,561,0,561,1907-8-25,-561
1907,8,26,320,0,320,1907-8-26,-320
1907,8,27,779,624,155,1907-8-27,469
1907,8,28,1069,891,178,1907-8-28,713
1907,8,29,1429,1290,139,1907-8-29,1151
1907,8,30,1270,1228,42,1907-8-30,1186
1907,8,31,1248,1242,6,1907-8-31,1236
1907,9,1,1200,1193,7,1907-9-1,1186
1907,9,2,1244,1118,126,1907-9-2,992
1907,9,3,1155,1013,142,1907-9-3,871
1907,9,4,1075,950,125,1907-9-4,825
1907,9,5,1128,1024,104,1907-9-5,920
1907,9,6,1032,670,362,1907-9-6,308
1907,9,7,1240,708,532,1907-9-7,176
1907,9,8,1252,794,458,1907-9-8,336
1907,9,9,762,266,496,1907-9-9,-230
1907,9,10,738,395,343,1907-9-10,52
1907,9,11,1258,776,482,1907-9-11,294
1907,9,12,1521,700,821,1907-9-12,-121
1907,9,13,1979,782,1197,1907-9-13,-415
1907,9,14,1698,642,1056,1907-9-14,-414
1907,9,15,1558,519,1039,1907-9-15,-520
1907,9,16,1413,486,927,1907-9-16,-441
1907,9,17,1630,555,1075,1907-9-17,-520
1907,9,18,1618,745,873,1907-9-18,-128
1907,9,19,1369,690,679,1907-9-19,11
1907,9,20,1367,569,798,1907-9-20,-229
1907,9,21,1242,555,687,1907-9-21,-132
1907,9,22,1414,731,683,1907-9-22,48
1907,9,23,1081,700,381,1907-9-23,319
1907,9,24,1677,1311,366,1907-9-24,945
1907,9,25,1379,977,402,1907-9-25,575
1907,9,26,1571,1217,354,1907-9-26,863
1907,9,27,1846,1557,289,1907-9-27,1268
1907,9,28,2018,1764,254,1907-9-28,1510
1907,9,29,1994,1659,335,1907-9-29,1324
1907,9,30,1847,1471,376,1907-9-30,1095
1907,10,1,446,198,248,1907-10-1,-50
1907,10,2,647,243,404,1907-10-2,-161
1907,10,3,635,311,324,1907-10-3,-13
1907,10,4,383,142,241,1907-10-4,-99
1907,10,5,258,84,174,1907-10-5,-90
1907,10,6,233,68,165,1907-10-6,-97
1907,10,7,211,50,161,1907-10-7,-111
1907,10,8,152,0,152,1907-10-8,-152
1907,10,9,692,274,418,1907-10-9,-144
1907,10,10,1189,196,993,1907-10-10,-797
1907,10,11,1328,218,1110,1907-10-11,-892
1907,10,12,1432,225,1207,1907-10-12,-982
1907,10,13,1743,621,1122,1907-10-13,-501
1907,10,14,2229,899,1330,1907-10-14,-431
1907,10,15,2793,1691,1102,1907-10-15,589
1907,10,16,3527,2235,1292,1907-10-16,943
1907,10,17,3698,2206,1492,1907-10-17,714
1907,10,18,3404,2060,1344,1907-10-18,716
1907,10,19,1905,1652,253,1907-10-19,1399
1907,10,20,1630,1399,231,1907-10-20,1168
1907,10,21,1463,1435,28,1907-10-21,1407
1907,10,22,1269,1197,72,1907-10-22,1125
1907,10,23,1366,1280,86,1907-10-23,1194
1907,10,24,1069,958,111,1907-10-24,847
1907,10,25,977,875,102,1907-10-25,773
1907,10,26,567,474,93,1907-10-26,381
1907,10,27,618,365,253,1907-10-27,112
1907,10,28,240,41,199,1907-10-28,-158
1907,10,29,225,89,136,1907-10-29,-47
1907,10,30,357,252,105,1907-10-30,147
1907,10,31,310,152,158,1907-10-31,-6
1907,11,1,317,109,208,1907-11-1,-99
1907,11,2,653,73,580,1907-11-2,-507
1907,11,3,483,55,428,1907-11-3,-373
1907,11,4,500,25,475,1907-11-4,-450
1907,11,5,515,14,501,1907-11-5,-487
1907,11,6,309,36,273,1907-11-6,-237
1907,11,7,434,171,263,1907-11-7,-92
1907,11,8,370,120,250,1907-11-8,-130
1907,11,9,1437,1178,259,1907-11-9,919
1907,11,10,2162,1814,348,1907-11-10,1466
1907,11,11,2313,2040,273,1907-11-11,1767
1907,11,12,2673,2351,322,1907-11-12,2029
1907,11,13,2639,2475,164,1907-11-13,2311
1907,11,14,2364,2236,128,1907-11-14,2108
1907,11,15,2124,1980,144,1907-11-15,1836
1907,11,16,1439,1439,0,1907-11-16,1439
1907,11,17,1604,1604,0,1907-11-17,1604
1907,11,18,1798,1798,0,1907-11-18,1798
1907,11,19,2039,2004,35,1907-11-19,1969
1907,11,20,2148,2047,101,1907-11-20,1946
1907,11,21,1962,1680,282,1907-11-21,1398
1907,11,22,656,243,413,1907-11-22,-170
1907,11,23,325,67,258,1907-11-23,-191
1907,11,24,245,48,197,1907-11-24,-149
1907,11,25,337,96,241,1907-11-25,-145
1907,11,26,117,64,53,1907-11-26,11
1907,11,27,39,14,25,1907-11-27,-11
1907,11,28,29,7,22,1907-11-28,-15
1907,11,29,0,0,0,1907-11-29,0
1907,11,30,208,0,208,1907-11-30,-208
1907,12,1,631,0,631,1907-12-1,-631
1907,12,2,309,0,309,1907-12-2,-309
1907,12,3,330,0,330,1907-12-3,-330
1907,12,4,272,0,272,1907-12-4,-272
1907,12,5,445,200,245,1907-12-5,-45
1907,12,6,1035,796,239,1907-12-6,557
1907,12,7,925,699,226,1907-12-7,473
1907,12,8,948,784,164,1907-12-8,620
1907,12,9,1228,955,273,1907-12-9,682
1907,12,10,1410,1087,323,1907-12-10,764
1907,12,11,1550,1311,239,1907-12-11,1072
1907,12,12,1687,1467,220,1907-12-12,1247
1907,12,13,1276,1228,48,1907-12-13,1180
1907,12,14,1353,1255,98,1907-12-14,1157
1907,12,15,1834,1166,668,1907-12-15,498
1907,12,16,2148,809,1339,1907-12-16,-530
1907,12,17,2151,752,1399,1907-12-17,-647
1907,12,18,2205,739,1466,1907-12-18,-727
1907,12,19,1400,0,1400,1907-12-19,-1400
1907,12,20,1634,0,1634,1907-12-20,-1634
1907,12,21,1129,0,1129,1907-12-21,-1129
1907,12,22,732,0,732,1907-12-22,-732
1907,12,23,661,0,661,1907-12-23,-661
1907,12,24,664,0,664,1907-12-24,-664
1907,12,25,803,219,584,1907-12-25,-365
1907,12,26,749,125,624,1907-12-26,-499
1907,12,27,532,84,448,1907-12-27,-364
1907,12,28,109,96,13,1907-12-28,83
1907,12,29,121,89,32,1907-12-29,57
1907,12,30,372,112,260,1907-12-30,-148
1907,12,31,443,72,371,1907-12-31,-299
1908,1,1,380,70,310,1908-1-1,-240
1908,1,2,524,252,272,1908-1-2,-20
1908,1,3,732,551,181,1908-1-3,370
1908,1,4,820,527,293,1908-1-4,234
1908,1,5,1194,619,575,1908-1-5,44
1908,1,6,1050,584,466,1908-1-6,118
1908,1,7,717,415,302,1908-1-7,113
1908,1,8,913,441,472,1908-1-8,-31
1908,1,9,984,375,609,1908-1-9,-234
1908,1,10,540,450,90,1908-1-10,360
1908,1,11,877,365,512,1908-1-11,-147
1908,1,12,766,359,407,1908-1-12,-48
1908,1,13,724,339,385,1908-1-13,-46
1908,1,14,604,285,319,1908-1-14,-34
1908,1,15,323,21,302,1908-1-15,-281
1908,1,16,299,10,289,1908-1-16,-279
1908,1,17,332,7,325,1908-1-17,-318
1908,1,18,415,0,415,1908-1-18,-415
1908,1,19,247,0,247,1908-1-19,-247
1908,1,20,194,0,194,1908-1-20,-194
1908,1,21,207,0,207,1908-1-21,-207
1908,1,22,340,70,270,1908-1-22,-200
1908,1,23,517,57,460,1908-1-23,-403
1908,1,24,448,67,381,1908-1-24,-314
1908,1,25,307,22,285,1908-1-25,-263
1908,1,26,308,9,299,1908-1-26,-290
1908,1,27,324,4,320,1908-1-27,-316
1908,1,28,0,0,0,1908-1-28,0
1908,1,29,174,174,0,1908-1-29,174
1908,1,30,225,225,0,1908-1-30,225
1908,1,31,238,238,0,1908-1-31,238
1908,2,1,285,285,0,1908-2-1,285
1908,2,2,211,211,0,1908-2-2,211
1908,2,3,232,202,30,1908-2-3,172
1908,2,4,382,136,246,1908-2-4,-110
1908,2,5,399,125,274,1908-2-5,-149
1908,2,6,341,94,247,1908-2-6,-153
1908,2,7,47,18,29,1908-2-7,-11
1908,2,8,21,0,21,1908-2-8,-21
1908,2,9,328,295,33,1908-2-9,262
1908,2,10,324,256,68,1908-2-10,188
1908,2,11,281,223,58,1908-2-11,165
1908,2,12,316,190,126,1908-2-12,64
1908,2,13,360,233,127,1908-2-13,106
1908,2,14,310,159,151,1908-2-14,8
1908,2,15,318,171,147,1908-2-15,24
1908,2,16,201,80,121,1908-2-16,-41
1908,2,17,97,50,47,1908-2-17,3
1908,2,18,123,0,123,1908-2-18,-123
1908,2,19,27,16,11,1908-2-19,5
1908,2,20,177,24,153,1908-2-20,-129
1908,2,21,218,73,145,1908-2-21,-72
1908,2,22,154,51,103,1908-2-22,-52
1908,2,23,144,29,115,1908-2-23,-86
1908,2,24,179,30,149,1908-2-24,-119
1908,2,25,201,0,201,1908-2-25,-201
1908,2,26,273,0,273,1908-2-26,-273
1908,2,27,564,0,564,1908-2-27,-564
1908,2,28,879,0,879,1908-2-28,-879
1908,2,29,449,0,449,1908-2-29,-449
1908,3,1,78,0,78,1908-3-1,-78
1908,3,2,78,0,78,1908-3-2,-78
1908,3,3,85,0,85,1908-3-3,-85
1908,3,4,131,61,70,1908-3-4,-9
1908,3,5,163,51,112,1908-3-5,-61
1908,3,6,180,0,180,1908-3-6,-180
1908,3,7,261,0,261,1908-3-7,-261
1908,3,8,268,0,268,1908-3-8,-268
1908,3,9,79,0,79,1908-3-9,-79
1908,3,10,90,0,90,1908-3-10,-90
1908,3,11,215,0,215,1908-3-11,-215
1908,3,12,328,0,328,1908-3-12,-328
1908,3,13,276,0,276,1908-3-13,-276
1908,3,14,324,128,196,1908-3-14,-68
1908,3,15,479,135,344,1908-3-15,-209
1908,3,16,728,91,637,1908-3-16,-546
1908,3,17,395,76,319,1908-3-17,-243
1908,3,18,440,100,340,1908-3-18,-240
1908,3,19,462,151,311,1908-3-19,-160
1908,3,20,372,127,245,1908-3-20,-118
1908,3,21,281,100,181,1908-3-21,-81
1908,3,22,191,63,128,1908-3-22,-65
1908,3,23,159,23,136,1908-3-23,-113
1908,3,24,70,0,70,1908-3-24,-70
1908,3,25,26,0,26,1908-3-25,-26
1908,3,26,0,0,0,1908-3-26,0
1908,3,27,17,17,0,1908-3-27,17
1908,3,28,177,177,0,1908-3-28,177
1908,3,29,185,185,0,1908-3-29,185
1908,3,30,127,127,0,1908-3-30,127
1908,3,31,89,89,0,1908-3-31,89
1908,4,1,232,35,197,1908-4-1,-162
1908,4,2,413,0,413,1908-4-2,-413
1908,4,3,732,0,732,1908-4-3,-732
1908,4,4,849,0,849,1908-4-4,-849
1908,4,5,1397,0,1397,1908-4-5,-1397
1908,4,6,1515,0,1515,1908-4-6,-1515
1908,4,7,1598,0,1598,1908-4-7,-1598
1908,4,8,1414,44,1370,1908-4-8,-1326
1908,4,9,1522,16,1506,1908-4-9,-1490
1908,4,10,1381,53,1328,1908-4-10,-1275
1908,4,11,932,97,835,1908-4-11,-738
1908,4,12,739,57,682,1908-4-12,-625
1908,4,13,594,6,588,1908-4-13,-582
1908,4,14,265,4,261,1908-4-14,-257
1908,4,15,256,0,256,1908-4-15,-256
1908,4,16,275,0,275,1908-4-16,-275
1908,4,17,256,0,256,1908-4-17,-256
1908,4,18,298,0,298,1908-4-18,-298
1908,4,19,490,19,471,1908-4-19,-452
1908,4,20,535,55,480,1908-4-20,-425
1908,4,21,564,111,453,1908-4-21,-342
1908,4,22,293,0,293,1908-4-22,-293
1908,4,23,430,0,430,1908-4-23,-430
1908,4,24,364,0,364,1908-4-24,-364
1908,4,25,769,0,769,1908-4-25,-769
1908,4,26,517,0,517,1908-4-26,-517
1908,4,27,506,0,506,1908-4-27,-506
1908,4,28,577,46,531,1908-4-28,-485
1908,4,29,787,41,746,1908-4-29,-705
1908,4,30,718,101,617,1908-4-30,-516
1908,5,1,754,196,558,1908-5-1,-362
1908,5,2,665,156,509,1908-5-2,-353
1908,5,3,556,122,434,1908-5-3,-312
1908,5,4,559,100,459,1908-5-4,-359
1908,5,5,584,179,405,1908-5-5,-226
1908,5,6,813,406,407,1908-5-6,-1
1908,5,7,693,303,390,1908-5-7,-87
1908,5,8,697,282,415,1908-5-8,-133
1908,5,9,719,173,546,1908-5-9,-373
1908,5,10,711,60,651,1908-5-10,-591
1908,5,11,646,21,625,1908-5-11,-604
1908,5,12,668,55,613,1908-5-12,-558
1908,5,13,502,227,275,1908-5-13,-48
1908,5,14,239,219,20,1908-5-14,199
1908,5,15,294,279,15,1908-5-15,264
1908,5,16,310,283,27,1908-5-16,256
1908,5,17,272,265,7,1908-5-17,258
1908,5,18,282,277,5,1908-5-18,272
1908,5,19,272,272,0,1908-5-19,272
1908,5,20,260,260,0,1908-5-20,260
1908,5,21,222,214,8,1908-5-21,206
1908,5,22,230,214,16,1908-5-22,198
1908,5,23,218,200,18,1908-5-23,182
1908,5,24,203,197,6,1908-5-24,191
1908,5,25,228,223,5,1908-5-25,218
1908,5,26,157,0,157,1908-5-26,-157
1908,5,27,738,0,738,1908-5-27,-738
1908,5,28,693,48,645,1908-5-28,-597
1908,5,29,708,55,653,1908-5-29,-598
1908,5,30,689,41,648,1908-5-30,-607
1908,5,31,1188,106,1082,1908-5-31,-976
1908,6,1,1718,268,1450,1908-6-1,-1182
1908,6,2,1859,253,1606,1908-6-2,-1353
1908,6,3,2028,232,1796,1908-6-3,-1564
1908,6,4,1977,278,1699,1908-6-4,-1421
1908,6,5,1714,173,1541,1908-6-5,-1368
1908,6,6,1428,132,1296,1908-6-6,-1164
1908,6,7,1121,92,1029,1908-6-7,-937
1908,6,8,465,45,420,1908-6-8,-375
1908,6,9,494,186,308,1908-6-9,-122
1908,6,10,282,157,125,1908-6-10,32
1908,6,11,257,189,68,1908-6-11,121
1908,6,12,141,141,0,1908-6-12,141
1908,6,13,129,129,0,1908-6-13,129
1908,6,14,104,104,0,1908-6-14,104
1908,6,15,83,83,0,1908-6-15,83
1908,6,16,237,171,66,1908-6-16,105
1908,6,17,212,182,30,1908-6-17,152
1908,6,18,200,158,42,1908-6-18,116
1908,6,19,208,189,19,1908-6-19,170
1908,6,20,175,162,13,1908-6-20,149
1908,6,21,59,50,9,1908-6-21,41
1908,6,22,16,16,0,1908-6-22,16
1908,6,23,201,10,191,1908-6-23,-181
1908,6,24,641,0,641,1908-6-24,-641
1908,6,25,546,0,546,1908-6-25,-546
1908,6,26,590,0,590,1908-6-26,-590
1908,6,27,577,0,577,1908-6-27,-577
1908,6,28,478,16,462,1908-6-28,-446
1908,6,29,527,13,514,1908-6-29,-501
1908,6,30,456,32,424,1908-6-30,-392
1908,7,1,438,31,407,1908-7-1,-376
1908,7,2,548,123,425,1908-7-2,-302
1908,7,3,556,117,439,1908-7-3,-322
1908,7,4,430,74,356,1908-7-4,-282
1908,7,5,544,260,284,1908-7-5,-24
1908,7,6,375,164,211,1908-7-6,-47
1908,7,7,148,148,0,1908-7-7,148
1908,7,8,97,97,0,1908-7-8,97
1908,7,9,108,98,10,1908-7-9,88
1908,7,10,49,40,9,1908-7-10,31
1908,7,11,43,28,15,1908-7-11,13
1908,7,12,6,6,0,1908-7-12,6
1908,7,13,21,21,0,1908-7-13,21
1908,7,14,159,16,143,1908-7-14,-127
1908,7,15,558,0,558,1908-7-15,-558
1908,7,16,540,0,540,1908-7-16,-540
1908,7,17,415,0,415,1908-7-17,-415
1908,7,18,312,4,308,1908-7-18,-304
1908,7,19,263,53,210,1908-7-19,-157
1908,7,20,444,165,279,1908-7-20,-114
1908,7,21,466,154,312,1908-7-21,-158
1908,7,22,818,287,531,1908-7-22,-244
1908,7,23,718,282,436,1908-7-23,-154
1908,7,24,662,286,376,1908-7-24,-90
1908,7,25,297,83,214,1908-7-25,-131
1908,7,26,139,8,131,1908-7-26,-123
1908,7,27,137,0,137,1908-7-27,-137
1908,7,28,146,0,146,1908-7-28,-146
1908,7,29,252,0,252,1908-7-29,-252
1908,7,30,273,0,273,1908-7-30,-273
1908,7,31,914,634,280,1908-7-31,354
1908,8,1,944,638,306,1908-8-1,332
1908,8,2,1411,712,699,1908-8-2,13
1908,8,3,2046,794,1252,1908-8-3,-458
1908,8,4,2368,900,1468,1908-8-4,-568
1908,8,5,2730,1107,1623,1908-8-5,-516
1908,8,6,2738,933,1805,1908-8-6,-872
1908,8,7,3072,1018,2054,1908-8-7,-1036
1908,8,8,3394,1107,2287,1908-8-8,-1180
1908,8,9,3977,1318,2659,1908-8-9,-1341
1908,8,10,3035,1150,1885,1908-8-10,-735
1908,8,11,1511,677,834,1908-8-11,-157
1908,8,12,983,381,602,1908-8-12,-221
1908,8,13,860,361,499,1908-8-13,-138
1908,8,14,636,55,581,1908-8-14,-526
1908,8,15,1043,78,965,1908-8-15,-887
1908,8,16,1134,29,1105,1908-8-16,-1076
1908,8,17,1249,65,1184,1908-8-17,-1119
1908,8,18,1400,136,1264,1908-8-18,-1128
1908,8,19,1578,109,1469,1908-8-19,-1360
1908,8,20,631,122,509,1908-8-20,-387
1908,8,21,481,32,449,1908-8-21,-417
1908,8,22,333,24,309,1908-8-22,-285
1908,8,23,438,46,392,1908-8-23,-346
1908,8,24,360,12,348,1908-8-24,-336
1908,8,25,2020,1287,733,1908-8-25,554
1908,8,26,2115,1339,776,1908-8-26,563
1908,8,27,2036,1314,722,1908-8-27,592
1908,8,28,2204,1277,927,1908-8-28,350
1908,8,29,2238,1378,860,1908-8-29,518
1908,8,30,2637,1764,873,1908-8-30,891
1908,8,31,2660,1940,720,1908-8-31,1220
1908,9,1,2804,2099,705,1908-9-1,1394
1908,9,2,3240,2090,1150,1908-9-2,940
1908,9,3,3090,1833,1257,1908-9-3,576
1908,9,4,3150,1824,1326,1908-9-4,498
1908,9,5,2926,1664,1262,1908-9-5,402
1908,9,6,1810,609,1201,1908-9-6,-592
1908,9,7,1562,684,878,1908-9-7,-194
1908,9,8,1795,856,939,1908-9-8,-83
1908,9,9,1938,839,1099,1908-9-9,-260
1908,9,10,1830,936,894,1908-9-10,42
1908,9,11,1981,1091,890,1908-9-11,201
1908,9,12,1972,1121,851,1908-9-12,270
1908,9,13,1745,921,824,1908-9-13,97
1908,9,14,2211,1415,796,1908-9-14,619
1908,9,15,2059,1349,710,1908-9-15,639
1908,9,16,1701,1400,301,1908-9-16,1099
1908,9,17,1314,849,465,1908-9-17,384
1908,9,18,1443,898,545,1908-9-18,353
1908,9,19,1143,726,417,1908-9-19,309
1908,9,20,1139,827,312,1908-9-20,515
1908,9,21,1109,779,330,1908-9-21,449
1908,9,22,1132,853,279,1908-9-22,574
1908,9,23,1068,924,144,1908-9-23,780
1908,9,24,1181,976,205,1908-9-24,771
1908,9,25,1154,1001,153,1908-9-25,848
1908,9,26,931,740,191,1908-9-26,549
1908,9,27,720,639,81,1908-9-27,558
1908,9,28,845,624,221,1908-9-28,403
1908,9,29,635,429,206,1908-9-29,223
1908,9,30,1414,810,604,1908-9-30,206
1908,10,1,1573,847,726,1908-10-1,121
1908,10,2,1235,598,637,1908-10-2,-39
1908,10,3,896,324,572,1908-10-3,-248
1908,10,4,841,369,472,1908-10-4,-103
1908,10,5,764,344,420,1908-10-5,-76
1908,10,6,835,323,512,1908-10-6,-189
1908,10,7,817,371,446,1908-10-7,-75
1908,10,8,764,349,415,1908-10-8,-66
1908,10,9,709,330,379,1908-10-9,-49
1908,10,10,584,291,293,1908-10-10,-2
1908,10,11,520,251,269,1908-10-11,-18
1908,10,12,510,212,298,1908-10-12,-86
1908,10,13,83,10,73,1908-10-13,-63
1908,10,14,10,10,0,1908-10-14,10
1908,10,15,12,12,0,1908-10-15,12
1908,10,16,0,0,0,1908-10-16,0
1908,10,17,0,0,0,1908-10-17,0
1908,10,18,0,0,0,1908-10-18,0
1908,10,19,0,0,0,1908-10-19,0
1908,10,20,177,177,0,1908-10-20,177
1908,10,21,138,138,0,1908-10-21,138
1908,10,22,151,151,0,1908-10-22,151
1908,10,23,95,83,12,1908-10-23,71
1908,10,24,58,52,6,1908-10-24,46
1908,10,25,86,53,33,1908-10-25,20
1908,10,26,92,38,54,1908-10-26,-16
1908,10,27,79,22,57,1908-10-27,-35
1908,10,28,159,127,32,1908-10-28,95
1908,10,29,93,86,7,1908-10-29,79
1908,10,30,89,89,0,1908-10-30,89
1908,10,31,79,79,0,1908-10-31,79
1908,11,1,58,58,0,1908-11-1,58
1908,11,2,253,50,203,1908-11-2,-153
1908,11,3,255,43,212,1908-11-3,-169
1908,11,4,221,25,196,1908-11-4,-171
1908,11,5,266,67,199,1908-11-5,-132
1908,11,6,354,153,201,1908-11-6,-48
1908,11,7,369,205,164,1908-11-7,41
1908,11,8,568,383,185,1908-11-8,198
1908,11,9,1151,976,175,1908-11-9,801
1908,11,10,1647,1523,124,1908-11-10,1399
1908,11,11,1737,1621,116,1908-11-11,1505
1908,11,12,1485,1397,88,1908-11-12,1309
1908,11,13,1545,1489,56,1908-11-13,1433
1908,11,14,1418,1381,37,1908-11-14,1344
1908,11,15,1582,1485,97,1908-11-15,1388
1908,11,16,1674,1594,80,1908-11-16,1514
1908,11,17,1717,1676,41,1908-11-17,1635
1908,11,18,819,807,12,1908-11-18,795
1908,11,19,504,504,0,1908-11-19,504
1908,11,20,593,593,0,1908-11-20,593
1908,11,21,529,455,74,1908-11-21,381
1908,11,22,578,502,76,1908-11-22,426
1908,11,23,483,436,47,1908-11-23,389
1908,11,24,498,485,13,1908-11-24,472
1908,11,25,277,249,28,1908-11-25,221
1908,11,26,96,37,59,1908-11-26,-22
1908,11,27,170,23,147,1908-11-27,-124
1908,11,28,198,4,194,1908-11-28,-190
1908,11,29,125,0,125,1908-11-29,-125
1908,11,30,356,0,356,1908-11-30,-356
1908,12,1,281,3,278,1908-12-1,-275
1908,12,2,942,680,262,1908-12-2,418
1908,12,3,916,640,276,1908-12-3,364
1908,12,4,811,631,180,1908-12-4,451
1908,12,5,828,672,156,1908-12-5,516
1908,12,6,641,557,84,1908-12-6,473
1908,12,7,649,579,70,1908-12-7,509
1908,12,8,690,641,49,1908-12-8,592
1908,12,9,672,602,70,1908-12-9,532
1908,12,10,640,608,32,1908-12-10,576
1908,12,11,662,624,38,1908-12-11,586
1908,12,12,664,644,20,1908-12-12,624
1908,12,13,555,547,8,1908-12-13,539
1908,12,14,605,605,0,1908-12-14,605
1908,12,15,70,70,0,1908-12-15,70
1908,12,16,53,13,40,1908-12-16,-27
1908,12,17,59,13,46,1908-12-17,-33
1908,12,18,112,81,31,1908-12-18,50
1908,12,19,275,242,33,1908-12-19,209
1908,12,20,270,265,5,1908-12-20,260
1908,12,21,255,194,61,1908-12-21,133
1908,12,22,376,227,149,1908-12-22,78
1908,12,23,549,187,362,1908-12-23,-175
1908,12,24,925,157,768,1908-12-24,-611
1908,12,25,611,48,563,1908-12-25,-515
1908,12,26,768,0,768,1908-12-26,-768
1908,12,27,533,33,500,1908-12-27,-467
1908,12,28,1174,785,389,1908-12-28,396
1908,12,29,1213,891,322,1908-12-29,569
1908,12,30,1502,1280,222,1908-12-30,1058
1908,12,31,1481,1403,78,1908-12-31,1325
1909,1,1,1306,1306,0,1909-1-1,1306
1909,1,2,1285,1285,0,1909-1-2,1285
1909,1,3,1098,1098,0,1909-1-3,1098
1909,1,4,896,896,0,1909-1-4,896
1909,1,5,885,885,0,1909-1-5,885
1909,1,6,1007,1007,0,1909-1-6,1007
1909,1,7,1047,1004,43,1909-1-7,961
1909,1,8,1151,1086,65,1909-1-8,1021
1909,1,9,1219,1106,113,1909-1-9,993
1909,1,10,713,622,91,1909-1-10,531
1909,1,11,284,209,75,1909-1-11,134
1909,1,12,223,188,35,1909-1-12,153
1909,1,13,249,210,39,1909-1-13,171
1909,1,14,758,253,505,1909-1-14,-252
1909,1,15,715,239,476,1909-1-15,-237
1909,1,16,1057,587,470,1909-1-16,117
1909,1,17,1090,575,515,1909-1-17,60
1909,1,18,1035,646,389,1909-1-18,257
1909,1,19,718,364,354,1909-1-19,10
1909,1,20,600,331,269,1909-1-20,62
1909,1,21,586,302,284,1909-1-21,18
1909,1,22,593,316,277,1909-1-22,39
1909,1,23,1285,913,372,1909-1-23,541
1909,1,24,2147,1282,865,1909-1-24,417
1909,1,25,2152,1126,1026,1909-1-25,100
1909,1,26,2310,1323,987,1909-1-26,336
1909,1,27,2250,1296,954,1909-1-27,342
1909,1,28,2335,1392,943,1909-1-28,449
1909,1,29,2326,1445,881,1909-1-29,564
1909,1,30,1829,1036,793,1909-1-30,243
1909,1,31,1818,1055,763,1909-1-31,292
1909,2,1,1601,979,622,1909-2-1,357
1909,2,2,1351,933,418,1909-2-2,515
1909,2,3,1169,733,436,1909-2-3,297
1909,2,4,833,485,348,1909-2-4,137
1909,2,5,402,208,194,1909-2-5,14
1909,2,6,330,173,157,1909-2-6,16
1909,2,7,165,0,165,1909-2-7,-165
1909,2,8,230,0,230,1909-2-8,-230
1909,2,9,18,0,18,1909-2-9,-18
1909,2,10,97,0,97,1909-2-10,-97
1909,2,11,254,0,254,1909-2-11,-254
1909,2,12,501,186,315,1909-2-12,-129
1909,2,13,629,127,502,1909-2-13,-375
1909,2,14,664,135,529,1909-2-14,-394
1909,2,15,474,158,316,1909-2-15,-158
1909,2,16,680,137,543,1909-2-16,-406
1909,2,17,728,132,596,1909-2-17,-464
1909,2,18,703,135,568,1909-2-18,-433
1909,2,19,635,142,493,1909-2-19,-351
1909,2,20,741,122,619,1909-2-20,-497
1909,2,21,876,117,759,1909-2-21,-642
1909,2,22,650,355,295,1909-2-22,60
1909,2,23,906,401,505,1909-2-23,-104
1909,2,24,1402,590,812,1909-2-24,-222
1909,2,25,1422,367,1055,1909-2-25,-688
1909,2,26,1385,542,843,1909-2-26,-301
1909,2,27,1311,498,813,1909-2-27,-315
1909,2,28,1525,575,950,1909-2-28,-375
1909,3,1,1585,596,989,1909-3-1,-393
1909,3,2,1716,755,961,1909-3-2,-206
1909,3,3,2153,1185,968,1909-3-3,217
1909,3,4,2130,1320,810,1909-3-4,510
1909,3,5,2119,1539,580,1909-3-5,959
1909,3,6,1517,957,560,1909-3-6,397
1909,3,7,508,137,371,1909-3-7,-234
1909,3,8,539,120,419,1909-3-8,-299
1909,3,9,235,107,128,1909-3-9,-21
1909,3,10,183,0,183,1909-3-10,-183
1909,3,11,120,0,120,1909-3-11,-120
1909,3,12,204,0,204,1909-3-12,-204
1909,3,13,220,0,220,1909-3-13,-220
1909,3,14,165,0,165,1909-3-14,-165
1909,3,15,93,0,93,1909-3-15,-93
1909,3,16,121,0,121,1909-3-16,-121
1909,3,17,121,0,121,1909-3-17,-121
1909,3,18,111,0,111,1909-3-18,-111
1909,3,19,985,790,195,1909-3-19,595
1909,3,20,1181,973,208,1909-3-20,765
1909,3,21,1404,1152,252,1909-3-21,900
1909,3,22,1572,1338,234,1909-3-22,1104
1909,3,23,1519,1165,354,1909-3-23,811
1909,3,24,1571,1224,347,1909-3-24,877
1909,3,25,1656,1312,344,1909-3-25,968
1909,3,26,1374,1148,226,1909-3-26,922
1909,3,27,1258,1043,215,1909-3-27,828
1909,3,28,1318,962,356,1909-3-28,606
1909,3,29,1536,1284,252,1909-3-29,1032
1909,3,30,1581,1243,338,1909-3-30,905
1909,3,31,1028,797,231,1909-3-31,566
1909,4,1,884,462,422,1909-4-1,40
1909,4,2,1026,413,613,1909-4-2,-200
1909,4,3,843,108,735,1909-4-3,-627
1909,4,4,915,84,831,1909-4-4,-747
1909,4,5,940,97,843,1909-4-5,-746
1909,4,6,755,89,666,1909-4-6,-577
1909,4,7,711,86,625,1909-4-7,-539
1909,4,8,597,87,510,1909-4-8,-423
1909,4,9,503,31,472,1909-4-9,-441
1909,4,10,0,0,0,1909-4-10,0
1909,4,11,15,0,15,1909-4-11,-15
1909,4,12,27,0,27,1909-4-12,-27
1909,4,13,34,0,34,1909-4-13,-34
1909,4,14,117,117,0,1909-4-14,117
1909,4,15,113,113,0,1909-4-15,113
1909,4,16,132,87,45,1909-4-16,42
1909,4,17,158,102,56,1909-4-17,46
1909,4,18,423,244,179,1909-4-18,65
1909,4,19,514,322,192,1909-4-19,130
1909,4,20,645,425,220,1909-4-20,205
1909,4,21,637,325,312,1909-4-21,13
1909,4,22,952,313,639,1909-4-22,-326
1909,4,23,496,131,365,1909-4-23,-234
1909,4,24,551,19,532,1909-4-24,-513
1909,4,25,584,35,549,1909-4-25,-514
1909,4,26,480,12,468,1909-4-26,-456
1909,4,27,386,0,386,1909-4-27,-386
1909,4,28,258,0,258,1909-4-28,-258
1909,4,29,137,0,137,1909-4-29,-137
1909,4,30,293,28,265,1909-4-30,-237
1909,5,1,363,76,287,1909-5-1,-211
1909,5,2,268,88,180,1909-5-2,-92
1909,5,3,248,97,151,1909-5-3,-54
1909,5,4,202,69,133,1909-5-4,-64
1909,5,5,348,210,138,1909-5-5,72
1909,5,6,336,229,107,1909-5-6,122
1909,5,7,1305,148,1157,1909-5-7,-1009
1909,5,8,1345,211,1134,1909-5-8,-923
1909,5,9,1134,200,934,1909-5-9,-734
1909,5,10,997,177,820,1909-5-10,-643
1909,5,11,916,194,722,1909-5-11,-528
1909,5,12,803,166,637,1909-5-12,-471
1909,5,13,1033,216,817,1909-5-13,-601
1909,5,14,892,109,783,1909-5-14,-674
1909,5,15,849,50,799,1909-5-15,-749
1909,5,16,880,0,880,1909-5-16,-880
1909,5,17,641,0,641,1909-5-17,-641
1909,5,18,640,47,593,1909-5-18,-546
1909,5,19,480,77,403,1909-5-19,-326
1909,5,20,91,37,54,1909-5-20,-17
1909,5,21,155,29,126,1909-5-21,-97
1909,5,22,237,28,209,1909-5-22,-181
1909,5,23,240,0,240,1909-5-23,-240
1909,5,24,342,0,342,1909-5-24,-342
1909,5,25,253,0,253,1909-5-25,-253
1909,5,26,181,0,181,1909-5-26,-181
1909,5,27,138,0,138,1909-5-27,-138
1909,5,28,108,0,108,1909-5-28,-108
1909,5,29,75,0,75,1909-5-29,-75
1909,5,30,71,0,71,1909-5-30,-71
1909,5,31,25,0,25,1909-5-31,-25
1909,6,1,22,0,22,1909-6-1,-22
1909,6,2,12,0,12,1909-6-2,-12
1909,6,3,0,0,0,1909-6-3,0
1909,6,4,60,0,60,1909-6-4,-60
1909,6,5,288,0,288,1909-6-5,-288
1909,6,6,559,0,559,1909-6-6,-559
1909,6,7,620,0,620,1909-6-7,-620
1909,6,8,555,0,555,1909-6-8,-555
1909,6,9,409,8,401,1909-6-9,-393
1909,6,10,349,0,349,1909-6-10,-349
1909,6,11,117,0,117,1909-6-11,-117
1909,6,12,89,0,89,1909-6-12,-89
1909,6,13,109,0,109,1909-6-13,-109
1909,6,14,103,0,103,1909-6-14,-103
1909,6,15,54,0,54,1909-6-15,-54
1909,6,16,717,0,717,1909-6-16,-717
1909,6,17,655,67,588,1909-6-17,-521
1909,6,18,610,107,503,1909-6-18,-396
1909,6,19,605,142,463,1909-6-19,-321
1909,6,20,83,83,0,1909-6-20,83
1909,6,21,39,29,10,1909-6-21,19
1909,6,22,183,84,99,1909-6-22,-15
1909,6,23,295,127,168,1909-6-23,-41
1909,6,24,205,0,205,1909-6-24,-205
1909,6,25,338,0,338,1909-6-25,-338
1909,6,26,318,13,305,1909-6-26,-292
1909,6,27,378,61,317,1909-6-27,-256
1909,6,28,333,15,318,1909-6-28,-303
1909,6,29,218,45,173,1909-6-29,-128
1909,6,30,157,10,147,1909-6-30,-137
1909,7,1,189,0,189,1909-7-1,-189
1909,7,2,156,0,156,1909-7-2,-156
1909,7,3,157,0,157,1909-7-3,-157
1909,7,4,166,0,166,1909-7-4,-166
1909,7,5,133,0,133,1909-7-5,-133
1909,7,6,180,0,180,1909-7-6,-180
1909,7,7,11,0,11,1909-7-7,-11
1909,7,8,81,0,81,1909-7-8,-81
1909,7,9,46,0,46,1909-7-9,-46
1909,7,10,22,0,22,1909-7-10,-22
1909,7,11,0,0,0,1909-7-11,0
1909,7,12,74,74,0,1909-7-12,74
1909,7,13,38,38,0,1909-7-13,38
1909,7,14,55,37,18,1909-7-14,19
1909,7,15,210,198,12,1909-7-15,186
1909,7,16,186,186,0,1909-7-16,186
1909,7,17,364,364,0,1909-7-17,364
1909,7,18,387,387,0,1909-7-18,387
1909,7,19,955,885,70,1909-7-19,815
1909,7,20,1032,944,88,1909-7-20,856
1909,7,21,1130,1007,123,1909-7-21,884
1909,7,22,1691,1578,113,1909-7-22,1465
1909,7,23,1784,1699,85,1909-7-23,1614
1909,7,24,1830,1778,52,1909-7-24,1726
1909,7,25,1513,1486,27,1909-7-25,1459
1909,7,26,1442,1428,14,1909-7-26,1414
1909,7,27,1301,1301,0,1909-7-27,1301
1909,7,28,865,865,0,1909-7-28,865
1909,7,29,803,803,0,1909-7-29,803
1909,7,30,503,494,9,1909-7-30,485
1909,7,31,165,134,31,1909-7-31,103
1909,8,1,-1,-1,-1,1909-8-1,0
1909,8,2,289,83,206,1909-8-2,-123
1909,8,3,226,69,157,1909-8-3,-88
1909,8,4,221,74,147,1909-8-4,-73
1909,8,5,245,36,209,1909-8-5,-173
1909,8,6,234,38,196,1909-8-6,-158
1909,8,7,210,16,194,1909-8-7,-178
1909,8,8,127,0,127,1909-8-8,-127
1909,8,9,62,0,62,1909-8-9,-62
1909,8,10,126,0,126,1909-8-10,-126
1909,8,11,123,28,95,1909-8-11,-67
1909,8,12,167,57,110,1909-8-12,-53
1909,8,13,136,84,52,1909-8-13,32
1909,8,14,215,170,45,1909-8-14,125
1909,8,15,193,122,71,1909-8-15,51
1909,8,16,163,106,57,1909-8-16,49
1909,8,17,120,88,32,1909-8-17,56
1909,8,18,151,66,85,1909-8-18,-19
1909,8,19,104,65,39,1909-8-19,26
1909,8,20,99,61,38,1909-8-20,23
1909,8,21,51,44,7,1909-8-21,37
1909,8,22,36,36,0,1909-8-22,36
1909,8,23,30,15,15,1909-8-23,0
1909,8,24,44,16,28,1909-8-24,-12
1909,8,25,53,5,48,1909-8-25,-43
1909,8,26,89,0,89,1909-8-26,-89
1909,8,27,131,0,131,1909-8-27,-131
1909,8,28,0,0,0,1909-8-28,0
1909,8,29,66,0,66,1909-8-29,-66
1909,8,30,61,0,61,1909-8-30,-61
1909,8,31,94,65,29,1909-8-31,36
1909,9,1,168,168,0,1909-9-1,168
1909,9,2,182,182,0,1909-9-2,182
1909,9,3,120,120,0,1909-9-3,120
1909,9,4,99,82,17,1909-9-4,65
1909,9,5,136,0,136,1909-9-5,-136
1909,9,6,197,0,197,1909-9-6,-197
1909,9,7,351,0,351,1909-9-7,-351
1909,9,8,556,0,556,1909-9-8,-556
1909,9,9,1361,0,1361,1909-9-9,-1361
1909,9,10,1244,0,1244,1909-9-10,-1244
1909,9,11,1712,4,1708,1909-9-11,-1704
1909,9,12,1925,23,1902,1909-9-12,-1879
1909,9,13,2495,22,2473,1909-9-13,-2451
1909,9,14,858,6,852,1909-9-14,-846
1909,9,15,59,51,8,1909-9-15,43
1909,9,16,102,71,31,1909-9-16,40
1909,9,17,484,115,369,1909-9-17,-254
1909,9,18,502,46,456,1909-9-18,-410
1909,9,19,455,32,423,1909-9-19,-391
1909,9,20,479,26,453,1909-9-20,-427
1909,9,21,527,33,494,1909-9-21,-461
1909,9,22,568,25,543,1909-9-22,-518
1909,9,23,653,10,643,1909-9-23,-633
1909,9,24,815,18,797,1909-9-24,-779
1909,9,25,789,12,777,1909-9-25,-765
1909,9,26,986,0,986,1909-9-26,-986
1909,9,27,924,0,924,1909-9-27,-924
1909,9,28,2043,14,2029,1909-9-28,-2015
1909,9,29,1664,12,1652,1909-9-29,-1640
1909,9,30,1595,46,1549,1909-9-30,-1503
1909,10,1,773,30,743,1909-10-1,-713
1909,10,2,925,50,875,1909-10-2,-825
1909,10,3,1000,64,936,1909-10-3,-872
1909,10,4,908,78,830,1909-10-4,-752
1909,10,5,970,113,857,1909-10-5,-744
1909,10,6,935,104,831,1909-10-6,-727
1909,10,7,1005,142,863,1909-10-7,-721
1909,10,8,1469,275,1194,1909-10-8,-919
1909,10,9,1714,296,1418,1909-10-9,-1122
1909,10,10,1642,275,1367,1909-10-10,-1092
1909,10,11,1646,239,1407,1909-10-11,-1168
1909,10,12,1490,162,1328,1909-10-12,-1166
1909,10,13,1238,266,972,1909-10-13,-706
1909,10,14,1448,320,1128,1909-10-14,-808
1909,10,15,1369,216,1153,1909-10-15,-937
1909,10,16,2009,308,1701,1909-10-16,-1393
1909,10,17,723,287,436,1909-10-17,-149
1909,10,18,899,258,641,1909-10-18,-383
1909,10,19,974,332,642,1909-10-19,-310
1909,10,20,323,118,205,1909-10-20,-87
1909,10,21,204,35,169,1909-10-21,-134
1909,10,22,163,10,153,1909-10-22,-143
1909,10,23,142,32,110,1909-10-23,-78
1909,10,24,230,134,96,1909-10-24,38
1909,10,25,490,295,195,1909-10-25,100
1909,10,26,523,317,206,1909-10-26,111
1909,10,27,302,203,99,1909-10-27,104
1909,10,28,265,175,90,1909-10-28,85
1909,10,29,256,171,85,1909-10-29,86
1909,10,30,310,224,86,1909-10-30,138
1909,10,31,530,253,277,1909-10-31,-24
1909,11,1,935,411,524,1909-11-1,-113
1909,11,2,1201,589,612,1909-11-2,-23
1909,11,3,1006,501,505,1909-11-3,-4
1909,11,4,787,367,420,1909-11-4,-53
1909,11,5,810,186,624,1909-11-5,-438
1909,11,6,1428,255,1173,1909-11-6,-918
1909,11,7,699,137,562,1909-11-7,-425
1909,11,8,478,89,389,1909-11-8,-300
1909,11,9,359,39,320,1909-11-9,-281
1909,11,10,236,22,214,1909-11-10,-192
1909,11,11,239,29,210,1909-11-11,-181
1909,11,12,417,42,375,1909-11-12,-333
1909,11,13,335,77,258,1909-11-13,-181
1909,11,14,359,91,268,1909-11-14,-177
1909,11,15,401,110,291,1909-11-15,-181
1909,11,16,318,75,243,1909-11-16,-168
1909,11,17,343,146,197,1909-11-17,-51
1909,11,18,306,151,155,1909-11-18,-4
1909,11,19,479,348,131,1909-11-19,217
1909,11,20,506,389,117,1909-11-20,272
1909,11,21,703,273,430,1909-11-21,-157
1909,11,22,980,278,702,1909-11-22,-424
1909,11,23,1022,277,745,1909-11-23,-468
1909,11,24,783,165,618,1909-11-24,-453
1909,11,25,810,266,544,1909-11-25,-278
1909,11,26,951,276,675,1909-11-26,-399
1909,11,27,1286,433,853,1909-11-27,-420
1909,11,28,1362,505,857,1909-11-28,-352
1909,11,29,1737,911,826,1909-11-29,85
1909,11,30,2545,1495,1050,1909-11-30,445
1909,12,1,2464,1426,1038,1909-12-1,388
1909,12,2,2494,1346,1148,1909-12-2,198
1909,12,3,2177,1383,794,1909-12-3,589
1909,12,4,873,497,376,1909-12-4,121
1909,12,5,328,0,328,1909-12-5,-328
1909,12,6,283,0,283,1909-12-6,-283
1909,12,7,248,0,248,1909-12-7,-248
1909,12,8,110,0,110,1909-12-8,-110
1909,12,9,59,0,59,1909-12-9,-59
1909,12,10,83,0,83,1909-12-10,-83
1909,12,11,66,0,66,1909-12-11,-66
1909,12,12,0,0,0,1909-12-12,0
1909,12,13,32,32,0,1909-12-13,32
1909,12,14,50,50,0,1909-12-14,50
1909,12,15,384,384,0,1909-12-15,384
1909,12,16,522,522,0,1909-12-16,522
1909,12,17,604,596,8,1909-12-17,588
1909,12,18,781,664,117,1909-12-18,547
1909,12,19,1245,791,454,1909-12-19,337
1909,12,20,1224,759,465,1909-12-20,294
1909,12,21,1036,537,499,1909-12-21,38
1909,12,22,957,473,484,1909-12-22,-11
1909,12,23,1143,714,429,1909-12-23,285
1909,12,24,938,612,326,1909-12-24,286
1909,12,25,1325,389,936,1909-12-25,-547
1909,12,26,1335,439,896,1909-12-26,-457
1909,12,27,1233,375,858,1909-12-27,-483
1909,12,28,1484,626,858,1909-12-28,-232
1909,12,29,1400,582,818,1909-12-29,-236
1909,12,30,1672,735,937,1909-12-30,-202
1909,12,31,1141,538,603,1909-12-31,-65
1910,1,1,1133,500,633,1910-1-1,-133
1910,1,2,894,430,464,1910-1-2,-34
1910,1,3,899,477,422,1910-1-3,55
1910,1,4,814,392,422,1910-1-4,-30
1910,1,5,517,179,338,1910-1-5,-159
1910,1,6,527,169,358,1910-1-6,-189
1910,1,7,185,180,5,1910-1-7,175
1910,1,8,323,239,84,1910-1-8,155
1910,1,9,88,16,72,1910-1-9,-56
1910,1,10,184,0,184,1910-1-10,-184
1910,1,11,157,0,157,1910-1-11,-157
1910,1,12,171,0,171,1910-1-12,-171
1910,1,13,170,0,170,1910-1-13,-170
1910,1,14,165,0,165,1910-1-14,-165
1910,1,15,137,0,137,1910-1-15,-137
1910,1,16,127,0,127,1910-1-16,-127
1910,1,17,123,0,123,1910-1-17,-123
1910,1,18,174,0,174,1910-1-18,-174
1910,1,19,199,0,199,1910-1-19,-199
1910,1,20,193,11,182,1910-1-20,-171
1910,1,21,149,38,111,1910-1-21,-73
1910,1,22,392,16,376,1910-1-22,-360
1910,1,23,489,110,379,1910-1-23,-269
1910,1,24,557,152,405,1910-1-24,-253
1910,1,25,485,114,371,1910-1-25,-257
1910,1,26,403,89,314,1910-1-26,-225
1910,1,27,519,74,445,1910-1-27,-371
1910,1,28,494,83,411,1910-1-28,-328
1910,1,29,429,65,364,1910-1-29,-299
1910,1,30,391,65,326,1910-1-30,-261
1910,1,31,347,60,287,1910-1-31,-227
1910,2,1,322,35,287,1910-2-1,-252
1910,2,2,242,17,225,1910-2-2,-208
1910,2,3,355,18,337,1910-2-3,-319
1910,2,4,0,0,0,1910-2-4,0
1910,2,5,0,0,0,1910-2-5,0
1910,2,6,0,0,0,1910-2-6,0
1910,2,7,0,0,0,1910-2-7,0
1910,2,8,0,0,0,1910-2-8,0
1910,2,9,0,0,0,1910-2-9,0
1910,2,10,0,0,0,1910-2-10,0
1910,2,11,584,0,584,1910-2-11,-584
1910,2,12,665,0,665,1910-2-12,-665
1910,2,13,692,0,692,1910-2-13,-692
1910,2,14,598,0,598,1910-2-14,-598
1910,2,15,582,0,582,1910-2-15,-582
1910,2,16,692,0,692,1910-2-16,-692
1910,2,17,769,0,769,1910-2-17,-769
1910,2,18,878,0,878,1910-2-18,-878
1910,2,19,970,0,970,1910-2-19,-970
1910,2,20,1234,0,1234,1910-2-20,-1234
1910,2,21,1165,39,1126,1910-2-21,-1087
1910,2,22,1207,38,1169,1910-2-22,-1131
1910,2,23,958,33,925,1910-2-23,-892
1910,2,24,1166,15,1151,1910-2-24,-1136
1910,2,25,1276,12,1264,1910-2-25,-1252
1910,2,26,1258,9,1249,1910-2-26,-1240
1910,2,27,1038,6,1032,1910-2-27,-1026
1910,2,28,1068,0,1068,1910-2-28,-1068
1910,3,1,166,51,115,1910-3-1,-64
1910,3,2,205,175,30,1910-3-2,145
1910,3,3,364,361,3,1910-3-3,358
1910,3,4,456,359,97,1910-3-4,262
1910,3,5,965,561,404,1910-3-5,157
1910,3,6,670,670,0,1910-3-6,670
1910,3,7,655,655,0,1910-3-7,655
1910,3,8,608,608,0,1910-3-8,608
1910,3,9,91,91,0,1910-3-9,91
1910,3,10,304,126,178,1910-3-10,-52
1910,3,11,509,91,418,1910-3-11,-327
1910,3,12,373,40,333,1910-3-12,-293
1910,3,13,229,20,209,1910-3-13,-189
1910,3,14,180,3,177,1910-3-14,-174
1910,3,15,224,0,224,1910-3-15,-224
1910,3,16,256,7,249,1910-3-16,-242
1910,3,17,234,0,234,1910-3-17,-234
1910,3,18,258,0,258,1910-3-18,-258
1910,3,19,199,0,199,1910-3-19,-199
1910,3,20,158,0,158,1910-3-20,-158
1910,3,21,239,0,239,1910-3-21,-239
1910,3,22,13,0,13,1910-3-22,-13
1910,3,23,151,133,18,1910-3-23,115
1910,3,24,222,174,48,1910-3-24,126
1910,3,25,297,241,56,1910-3-25,185
1910,3,26,279,174,105,1910-3-26,69
1910,3,27,161,161,0,1910-3-27,161
1910,3,28,139,139,0,1910-3-28,139
1910,3,29,118,118,0,1910-3-29,118
1910,3,30,108,108,0,1910-3-30,108
1910,3,31,77,77,0,1910-3-31,77
1910,4,1,72,72,0,1910-4-1,72
1910,4,2,62,62,0,1910-4-2,62
1910,4,3,29,29,0,1910-4-3,29
1910,4,4,0,0,0,1910-4-4,0
1910,4,5,0,0,0,1910-4-5,0
1910,4,6,0,0,0,1910-4-6,0
1910,4,7,0,0,0,1910-4-7,0
1910,4,8,0,0,0,1910-4-8,0
1910,4,9,149,0,149,1910-4-9,-149
1910,4,10,143,0,143,1910-4-10,-143
1910,4,11,176,0,176,1910-4-11,-176
1910,4,12,145,0,145,1910-4-12,-145
1910,4,13,43,0,43,1910-4-13,-43
1910,4,14,49,0,49,1910-4-14,-49
1910,4,15,76,30,46,1910-4-15,-16
1910,4,16,184,32,152,1910-4-16,-120
1910,4,17,86,25,61,1910-4-17,-36
1910,4,18,73,21,52,1910-4-18,-31
1910,4,19,17,0,17,1910-4-19,-17
1910,4,20,46,36,10,1910-4-20,26
1910,4,21,26,26,0,1910-4-21,26
1910,4,22,0,0,0,1910-4-22,0
1910,4,23,17,17,0,1910-4-23,17
1910,4,24,7,7,0,1910-4-24,7
1910,4,25,0,0,0,1910-4-25,0
1910,4,26,9,0,9,1910-4-26,-9
1910,4,27,0,0,0,1910-4-27,0
1910,4,28,0,0,0,1910-4-28,0
1910,4,29,435,435,0,1910-4-29,435
1910,4,30,255,255,0,1910-4-30,255
1910,5,1,294,294,0,1910-5-1,294
1910,5,2,211,211,0,1910-5-2,211
1910,5,3,201,201,0,1910-5-3,201
1910,5,4,196,196,0,1910-5-4,196
1910,5,5,151,151,0,1910-5-5,151
1910,5,6,96,96,0,1910-5-6,96
1910,5,7,42,42,0,1910-5-7,42
1910,5,8,116,74,42,1910-5-8,32
1910,5,9,282,217,65,1910-5-9,152
1910,5,10,241,155,86,1910-5-10,69
1910,5,11,91,0,91,1910-5-11,-91
1910,5,12,353,0,353,1910-5-12,-353
1910,5,13,358,10,348,1910-5-13,-338
1910,5,14,459,0,459,1910-5-14,-459
1910,5,15,752,0,752,1910-5-15,-752
1910,5,16,729,0,729,1910-5-16,-729
1910,5,17,685,0,685,1910-5-17,-685
1910,5,18,786,0,786,1910-5-18,-786
1910,5,19,676,0,676,1910-5-19,-676
1910,5,20,650,24,626,1910-5-20,-602
1910,5,21,568,56,512,1910-5-21,-456
1910,5,22,554,20,534,1910-5-22,-514
1910,5,23,440,7,433,1910-5-23,-426
1910,5,24,465,0,465,1910-5-24,-465
1910,5,25,410,148,262,1910-5-25,-114
1910,5,26,91,91,0,1910-5-26,91
1910,5,27,55,55,0,1910-5-27,55
1910,5,28,60,49,11,1910-5-28,38
1910,5,29,29,29,0,1910-5-29,29
1910,5,30,44,44,0,1910-5-30,44
1910,5,31,45,45,0,1910-5-31,45
1910,6,1,147,128,19,1910-6-1,109
1910,6,2,144,144,0,1910-6-2,144
1910,6,3,172,159,13,1910-6-3,146
1910,6,4,199,189,10,1910-6-4,179
1910,6,5,57,41,16,1910-6-5,25
1910,6,6,18,0,18,1910-6-6,-18
1910,6,7,23,0,23,1910-6-7,-23
1910,6,8,6,0,6,1910-6-8,-6
1910,6,9,78,0,78,1910-6-9,-78
1910,6,10,87,0,87,1910-6-10,-87
1910,6,11,65,0,65,1910-6-11,-65
1910,6,12,35,0,35,1910-6-12,-35
1910,6,13,28,0,28,1910-6-13,-28
1910,6,14,15,0,15,1910-6-14,-15
1910,6,15,5,0,5,1910-6-15,-5
1910,6,16,0,0,0,1910-6-16,0
1910,6,17,27,0,27,1910-6-17,-27
1910,6,18,10,0,10,1910-6-18,-10
1910,6,19,0,0,0,1910-6-19,0
1910,6,20,0,0,0,1910-6-20,0
1910,6,21,0,0,0,1910-6-21,0
1910,6,22,0,0,0,1910-6-22,0
1910,6,23,134,0,134,1910-6-23,-134
1910,6,24,104,0,104,1910-6-24,-104
1910,6,25,54,0,54,1910-6-25,-54
1910,6,26,388,0,388,1910-6-26,-388
1910,6,27,860,0,860,1910-6-27,-860
1910,6,28,689,0,689,1910-6-28,-689
1910,6,29,48,0,48,1910-6-29,-48
1910,6,30,157,130,27,1910-6-30,103
1910,7,1,434,370,64,1910-7-1,306
1910,7,2,480,422,58,1910-7-2,364
1910,7,3,430,405,25,1910-7-3,380
1910,7,4,420,326,94,1910-7-4,232
1910,7,5,357,297,60,1910-7-5,237
1910,7,6,343,304,39,1910-7-6,265
1910,7,7,394,394,0,1910-7-7,394
1910,7,8,368,368,0,1910-7-8,368
1910,7,9,339,339,0,1910-7-9,339
1910,7,10,234,234,0,1910-7-10,234
1910,7,11,206,206,0,1910-7-11,206
1910,7,12,380,252,128,1910-7-12,124
1910,7,13,126,16,110,1910-7-13,-94
1910,7,14,120,0,120,1910-7-14,-120
1910,7,15,101,0,101,1910-7-15,-101
1910,7,16,85,11,74,1910-7-16,-63
1910,7,17,78,9,69,1910-7-17,-60
1910,7,18,23,0,23,1910-7-18,-23
1910,7,19,13,0,13,1910-7-19,-13
1910,7,20,5,0,5,1910-7-20,-5
1910,7,21,29,0,29,1910-7-21,-29
1910,7,22,0,0,0,1910-7-22,0
1910,7,23,0,0,0,1910-7-23,0
1910,7,24,0,0,0,1910-7-24,0
1910,7,25,0,0,0,1910-7-25,0
1910,7,26,9,0,9,1910-7-26,-9
1910,7,27,327,16,311,1910-7-27,-295
1910,7,28,161,15,146,1910-7-28,-131
1910,7,29,100,0,100,1910-7-29,-100
1910,7,30,86,0,86,1910-7-30,-86
1910,7,31,132,0,132,1910-7-31,-132
1910,8,1,31,0,31,1910-8-1,-31
1910,8,2,110,0,110,1910-8-2,-110
1910,8,3,373,0,373,1910-8-3,-373
1910,8,4,408,0,408,1910-8-4,-408
1910,8,5,378,0,378,1910-8-5,-378
1910,8,6,389,0,389,1910-8-6,-389
1910,8,7,377,0,377,1910-8-7,-377
1910,8,8,449,0,449,1910-8-8,-449
1910,8,9,439,0,439,1910-8-9,-439
1910,8,10,448,0,448,1910-8-10,-448
1910,8,11,424,0,424,1910-8-11,-424
1910,8,12,368,0,368,1910-8-12,-368
1910,8,13,331,0,331,1910-8-13,-331
1910,8,14,367,0,367,1910-8-14,-367
1910,8,15,304,0,304,1910-8-15,-304
1910,8,16,35,0,35,1910-8-16,-35
1910,8,17,75,0,75,1910-8-17,-75
1910,8,18,37,0,37,1910-8-18,-37
1910,8,19,41,0,41,1910-8-19,-41
1910,8,20,0,0,0,1910-8-20,0
1910,8,21,0,0,0,1910-8-21,0
1910,8,22,0,0,0,1910-8-22,0
1910,8,23,0,0,0,1910-8-23,0
1910,8,24,0,0,0,1910-8-24,0
1910,8,25,0,0,0,1910-8-25,0
1910,8,26,10,0,10,1910-8-26,-10
1910,8,27,10,0,10,1910-8-27,-10
1910,8,28,0,0,0,1910-8-28,0
1910,8,29,0,0,0,1910-8-29,0
1910,8,30,5,0,5,1910-8-30,-5
1910,8,31,225,0,225,1910-8-31,-225
1910,9,1,225,0,225,1910-9-1,-225
1910,9,2,226,0,226,1910-9-2,-226
1910,9,3,301,0,301,1910-9-3,-301
1910,9,4,295,0,295,1910-9-4,-295
1910,9,5,649,0,649,1910-9-5,-649
1910,9,6,831,0,831,1910-9-6,-831
1910,9,7,276,0,276,1910-9-7,-276
1910,9,8,259,0,259,1910-9-8,-259
1910,9,9,208,0,208,1910-9-9,-208
1910,9,10,174,0,174,1910-9-10,-174
1910,9,11,166,0,166,1910-9-11,-166
1910,9,12,14,0,14,1910-9-12,-14
1910,9,13,23,0,23,1910-9-13,-23
1910,9,14,4,0,4,1910-9-14,-4
1910,9,15,0,0,0,1910-9-15,0
1910,9,16,0,0,0,1910-9-16,0
1910,9,17,2,0,2,1910-9-17,-2
1910,9,18,35,12,23,1910-9-18,-11
1910,9,19,73,10,63,1910-9-19,-53
1910,9,20,78,11,67,1910-9-20,-56
1910,9,21,440,0,440,1910-9-21,-440
1910,9,22,413,11,402,1910-9-22,-391
1910,9,23,418,0,418,1910-9-23,-418
1910,9,24,497,0,497,1910-9-24,-497
1910,9,25,593,0,593,1910-9-25,-593
1910,9,26,536,0,536,1910-9-26,-536
1910,9,27,1741,0,1741,1910-9-27,-1741
1910,9,28,1636,0,1636,1910-9-28,-1636
1910,9,29,1395,0,1395,1910-9-29,-1395
1910,9,30,1525,3,1522,1910-9-30,-1519
1910,10,1,1444,0,1444,1910-10-1,-1444
1910,10,2,1213,0,1213,1910-10-2,-1213
1910,10,3,857,0,857,1910-10-3,-857
1910,10,4,689,0,689,1910-10-4,-689
1910,10,5,672,0,672,1910-10-5,-672
1910,10,6,498,0,498,1910-10-6,-498
1910,10,7,531,26,505,1910-10-7,-479
1910,10,8,525,56,469,1910-10-8,-413
1910,10,9,349,73,276,1910-10-9,-203
1910,10,10,70,70,0,1910-10-10,70
1910,10,11,80,80,0,1910-10-11,80
1910,10,12,100,100,0,1910-10-12,100
1910,10,13,97,97,0,1910-10-13,97
1910,10,14,42,42,0,1910-10-14,42
1910,10,15,0,0,0,1910-10-15,0
1910,10,16,113,113,0,1910-10-16,113
1910,10,17,321,226,95,1910-10-17,131
1910,10,18,466,276,190,1910-10-18,86
1910,10,19,699,570,129,1910-10-19,441
1910,10,20,768,704,64,1910-10-20,640
1910,10,21,801,588,213,1910-10-21,375
1910,10,22,778,565,213,1910-10-22,352
1910,10,23,684,504,180,1910-10-23,324
1910,10,24,738,440,298,1910-10-24,142
1910,10,25,1105,699,406,1910-10-25,293
1910,10,26,1024,773,251,1910-10-26,522
1910,10,27,867,648,219,1910-10-27,429
1910,10,28,120,0,120,1910-10-28,-120
1910,10,29,77,0,77,1910-10-29,-77
1910,10,30,69,0,69,1910-10-30,-69
1910,10,31,67,0,67,1910-10-31,-67
1910,11,1,68,0,68,1910-11-1,-68
1910,11,2,25,0,25,1910-11-2,-25
1910,11,3,31,13,18,1910-11-3,-5
1910,11,4,20,12,8,1910-11-4,4
1910,11,5,0,0,0,1910-11-5,0
1910,11,6,0,0,0,1910-11-6,0
1910,11,7,11,11,0,1910-11-7,11
1910,11,8,0,0,0,1910-11-8,0
1910,11,9,0,0,0,1910-11-9,0
1910,11,10,0,0,0,1910-11-10,0
1910,11,11,0,0,0,1910-11-11,0
1910,11,12,0,0,0,1910-11-12,0
1910,11,13,0,0,0,1910-11-13,0
1910,11,14,6,6,0,1910-11-14,6
1910,11,15,0,0,0,1910-11-15,0
1910,11,16,161,161,0,1910-11-16,161
1910,11,17,124,96,28,1910-11-17,68
1910,11,18,88,73,15,1910-11-18,58
1910,11,19,81,54,27,1910-11-19,27
1910,11,20,27,6,21,1910-11-20,-15
1910,11,21,11,0,11,1910-11-21,-11
1910,11,22,9,0,9,1910-11-22,-9
1910,11,23,23,0,23,1910-11-23,-23
1910,11,24,14,0,14,1910-11-24,-14
1910,11,25,6,0,6,1910-11-25,-6
1910,11,26,7,0,7,1910-11-26,-7
1910,11,27,0,0,0,1910-11-27,0
1910,11,28,0,0,0,1910-11-28,0
1910,11,29,0,0,0,1910-11-29,0
1910,11,30,0,0,0,1910-11-30,0
1910,12,1,0,0,0,1910-12-1,0
1910,12,2,0,0,0,1910-12-2,0
1910,12,3,0,0,0,1910-12-3,0
1910,12,4,0,0,0,1910-12-4,0
1910,12,5,0,0,0,1910-12-5,0
1910,12,6,0,0,0,1910-12-6,0
1910,12,7,0,0,0,1910-12-7,0
1910,12,8,0,0,0,1910-12-8,0
1910,12,9,168,0,168,1910-12-9,-168
1910,12,10,114,0,114,1910-12-10,-114
1910,12,11,210,0,210,1910-12-11,-210
1910,12,12,140,0,140,1910-12-12,-140
1910,12,13,132,0,132,1910-12-13,-132
1910,12,14,88,0,88,1910-12-14,-88
1910,12,15,34,0,34,1910-12-15,-34
1910,12,16,0,0,0,1910-12-16,0
1910,12,17,7,0,7,1910-12-17,-7
1910,12,18,77,0,77,1910-12-18,-77
1910,12,19,73,0,73,1910-12-19,-73
1910,12,20,48,0,48,1910-12-20,-48
1910,12,21,15,0,15,1910-12-21,-15
1910,12,22,18,0,18,1910-12-22,-18
1910,12,23,0,0,0,1910-12-23,0
1910,12,24,0,0,0,1910-12-24,0
1910,12,25,0,0,0,1910-12-25,0
1910,12,26,0,0,0,1910-12-26,0
1910,12,27,0,0,0,1910-12-27,0
1910,12,28,17,0,17,1910-12-28,-17
1910,12,29,0,0,0,1910-12-29,0
1910,12,30,7,0,7,1910-12-30,-7
1910,12,31,0,0,0,1910-12-31,0
1911,1,1,0,0,0,1911-1-1,0
1911,1,2,0,0,0,1911-1-2,0
1911,1,3,139,0,139,1911-1-3,-139
1911,1,4,179,0,179,1911-1-4,-179
1911,1,5,150,0,150,1911-1-5,-150
1911,1,6,86,0,86,1911-1-6,-86
1911,1,7,129,0,129,1911-1-7,-129
1911,1,8,98,0,98,1911-1-8,-98
1911,1,9,103,0,103,1911-1-9,-103
1911,1,10,96,0,96,1911-1-10,-96
1911,1,11,73,0,73,1911-1-11,-73
1911,1,12,57,0,57,1911-1-12,-57
1911,1,13,61,0,61,1911-1-13,-61
1911,1,14,32,0,32,1911-1-14,-32
1911,1,15,0,0,0,1911-1-15,0
1911,1,16,0,0,0,1911-1-16,0
1911,1,17,0,0,0,1911-1-17,0
1911,1,18,0,0,0,1911-1-18,0
1911,1,19,0,0,0,1911-1-19,0
1911,1,20,0,0,0,1911-1-20,0
1911,1,21,0,0,0,1911-1-21,0
1911,1,22,0,0,0,1911-1-22,0
1911,1,23,0,0,0,1911-1-23,0
1911,1,24,0,0,0,1911-1-24,0
1911,1,25,0,0,0,1911-1-25,0
1911,1,26,0,0,0,1911-1-26,0
1911,1,27,0,0,0,1911-1-27,0
1911,1,28,0,0,0,1911-1-28,0
1911,1,29,0,0,0,1911-1-29,0
1911,1,30,14,0,14,1911-1-30,-14
1911,1,31,0,0,0,1911-1-31,0
1911,2,1,9,0,9,1911-2-1,-9
1911,2,2,0,0,0,1911-2-2,0
1911,2,3,0,0,0,1911-2-3,0
1911,2,4,0,0,0,1911-2-4,0
1911,2,5,0,0,0,1911-2-5,0
1911,2,6,0,0,0,1911-2-6,0
1911,2,7,0,0,0,1911-2-7,0
1911,2,8,0,0,0,1911-2-8,0
1911,2,9,79,0,79,1911-2-9,-79
1911,2,10,157,0,157,1911-2-10,-157
1911,2,11,190,0,190,1911-2-11,-190
1911,2,12,249,0,249,1911-2-12,-249
1911,2,13,147,0,147,1911-2-13,-147
1911,2,14,200,0,200,1911-2-14,-200
1911,2,15,155,0,155,1911-2-15,-155
1911,2,16,182,0,182,1911-2-16,-182
1911,2,17,124,0,124,1911-2-17,-124
1911,2,18,105,0,105,1911-2-18,-105
1911,2,19,47,0,47,1911-2-19,-47
1911,2,20,40,7,33,1911-2-20,-26
1911,2,21,0,0,0,1911-2-21,0
1911,2,22,0,0,0,1911-2-22,0
1911,2,23,0,0,0,1911-2-23,0
1911,2,24,0,0,0,1911-2-24,0
1911,2,25,0,0,0,1911-2-25,0
1911,2,26,194,194,0,1911-2-26,194
1911,2,27,295,295,0,1911-2-27,295
1911,2,28,306,306,0,1911-2-28,306
1911,3,1,332,332,0,1911-3-1,332
1911,3,2,322,279,43,1911-3-2,236
1911,3,3,275,227,48,1911-3-3,179
1911,3,4,176,0,176,1911-3-4,-176
1911,3,5,123,0,123,1911-3-5,-123
1911,3,6,105,0,105,1911-3-6,-105
1911,3,7,46,10,36,1911-3-7,-26
1911,3,8,33,0,33,1911-3-8,-33
1911,3,9,62,0,62,1911-3-9,-62
1911,3,10,78,0,78,1911-3-10,-78
1911,3,11,159,0,159,1911-3-11,-159
1911,3,12,13,0,13,1911-3-12,-13
1911,3,13,31,31,0,1911-3-13,31
1911,3,14,0,0,0,1911-3-14,0
1911,3,15,6,0,6,1911-3-15,-6
1911,3,16,6,0,6,1911-3-16,-6
1911,3,17,0,0,0,1911-3-17,0
1911,3,18,0,0,0,1911-3-18,0
1911,3,19,0,0,0,1911-3-19,0
1911,3,20,0,0,0,1911-3-20,0
1911,3,21,0,0,0,1911-3-21,0
1911,3,22,0,0,0,1911-3-22,0
1911,3,23,0,0,0,1911-3-23,0
1911,3,24,20,0,20,1911-3-24,-20
1911,3,25,23,0,23,1911-3-25,-23
1911,3,26,0,0,0,1911-3-26,0
1911,3,27,0,0,0,1911-3-27,0
1911,3,28,27,0,27,1911-3-28,-27
1911,3,29,36,0,36,1911-3-29,-36
1911,3,30,134,0,134,1911-3-30,-134
1911,3,31,179,0,179,1911-3-31,-179
1911,4,1,477,273,204,1911-4-1,69
1911,4,2,487,331,156,1911-4-2,175
1911,4,3,548,274,274,1911-4-3,0
1911,4,4,551,206,345,1911-4-4,-139
1911,4,5,565,145,420,1911-4-5,-275
1911,4,6,454,59,395,1911-4-6,-336
1911,4,7,179,17,162,1911-4-7,-145
1911,4,8,181,43,138,1911-4-8,-95
1911,4,9,172,22,150,1911-4-9,-128
1911,4,10,138,18,120,1911-4-10,-102
1911,4,11,114,0,114,1911-4-11,-114
1911,4,12,113,0,113,1911-4-12,-113
1911,4,13,144,0,144,1911-4-13,-144
1911,4,14,127,0,127,1911-4-14,-127
1911,4,15,175,0,175,1911-4-15,-175
1911,4,16,0,0,0,1911-4-16,0
1911,4,17,0,0,0,1911-4-17,0
1911,4,18,0,0,0,1911-4-18,0
1911,4,19,0,0,0,1911-4-19,0
1911,4,20,0,0,0,1911-4-20,0
1911,4,21,136,0,136,1911-4-21,-136
1911,4,22,166,0,166,1911-4-22,-166
1911,4,23,375,0,375,1911-4-23,-375
1911,4,24,466,0,466,1911-4-24,-466
1911,4,25,411,0,411,1911-4-25,-411
1911,4,26,407,0,407,1911-4-26,-407
1911,4,27,367,0,367,1911-4-27,-367
1911,4,28,359,0,359,1911-4-28,-359
1911,4,29,333,0,333,1911-4-29,-333
1911,4,30,354,0,354,1911-4-30,-354
1911,5,1,299,0,299,1911-5-1,-299
1911,5,2,304,0,304,1911-5-2,-304
1911,5,3,330,0,330,1911-5-3,-330
1911,5,4,185,0,185,1911-5-4,-185
1911,5,5,149,0,149,1911-5-5,-149
1911,5,6,175,0,175,1911-5-6,-175
1911,5,7,170,0,170,1911-5-7,-170
1911,5,8,160,0,160,1911-5-8,-160
1911,5,9,101,0,101,1911-5-9,-101
1911,5,10,0,0,0,1911-5-10,0
1911,5,11,0,0,0,1911-5-11,0
1911,5,12,0,0,0,1911-5-12,0
1911,5,13,0,0,0,1911-5-13,0
1911,5,14,0,0,0,1911-5-14,0
1911,5,15,0,0,0,1911-5-15,0
1911,5,16,0,0,0,1911-5-16,0
1911,5,17,0,0,0,1911-5-17,0
1911,5,18,0,0,0,1911-5-18,0
1911,5,19,0,0,0,1911-5-19,0
1911,5,20,64,0,64,1911-5-20,-64
1911,5,21,28,0,28,1911-5-21,-28
1911,5,22,32,0,32,1911-5-22,-32
1911,5,23,14,0,14,1911-5-23,-14
1911,5,24,0,0,0,1911-5-24,0
1911,5,25,23,23,0,1911-5-25,23
1911,5,26,199,199,0,1911-5-26,199
1911,5,27,204,204,0,1911-5-27,204
1911,5,28,190,190,0,1911-5-28,190
1911,5,29,197,197,0,1911-5-29,197
1911,5,30,162,162,0,1911-5-30,162
1911,5,31,170,170,0,1911-5-31,170
1911,6,1,149,149,0,1911-6-1,149
1911,6,2,175,175,0,1911-6-2,175
1911,6,3,172,172,0,1911-6-3,172
1911,6,4,152,152,0,1911-6-4,152
1911,6,5,176,176,0,1911-6-5,176
1911,6,6,0,0,0,1911-6-6,0
1911,6,7,0,0,0,1911-6-7,0
1911,6,8,0,0,0,1911-6-8,0
1911,6,9,0,0,0,1911-6-9,0
1911,6,10,0,0,0,1911-6-10,0
1911,6,11,0,0,0,1911-6-11,0
1911,6,12,0,0,0,1911-6-12,0
1911,6,13,0,0,0,1911-6-13,0
1911,6,14,0,0,0,1911-6-14,0
1911,6,15,0,0,0,1911-6-15,0
1911,6,16,0,0,0,1911-6-16,0
1911,6,17,0,0,0,1911-6-17,0
1911,6,18,0,0,0,1911-6-18,0
1911,6,19,0,0,0,1911-6-19,0
1911,6,20,0,0,0,1911-6-20,0
1911,6,21,4,0,4,1911-6-21,-4
1911,6,22,6,0,6,1911-6-22,-6
1911,6,23,14,14,0,1911-6-23,14
1911,6,24,0,0,0,1911-6-24,0
1911,6,25,0,0,0,1911-6-25,0
1911,6,26,0,0,0,1911-6-26,0
1911,6,27,0,0,0,1911-6-27,0
1911,6,28,0,0,0,1911-6-28,0
1911,6,29,14,0,14,1911-6-29,-14
1911,6,30,38,19,19,1911-6-30,0
1911,7,1,21,16,5,1911-7-1,11
1911,7,2,50,25,25,1911-7-2,0
1911,7,3,13,13,0,1911-7-3,13
1911,7,4,19,19,0,1911-7-4,19
1911,7,5,0,0,0,1911-7-5,0
1911,7,6,0,0,0,1911-7-6,0
1911,7,7,0,0,0,1911-7-7,0
1911,7,8,0,0,0,1911-7-8,0
1911,7,9,0,0,0,1911-7-9,0
1911,7,10,0,0,0,1911-7-10,0
1911,7,11,0,0,0,1911-7-11,0
1911,7,12,22,22,0,1911-7-12,22
1911,7,13,50,50,0,1911-7-13,50
1911,7,14,73,73,0,1911-7-14,73
1911,7,15,48,48,0,1911-7-15,48
1911,7,16,34,34,0,1911-7-16,34
1911,7,17,0,0,0,1911-7-17,0
1911,7,18,0,0,0,1911-7-18,0
1911,7,19,0,0,0,1911-7-19,0
1911,7,20,0,0,0,1911-7-20,0
1911,7,21,0,0,0,1911-7-21,0
1911,7,22,0,0,0,1911-7-22,0
1911,7,23,0,0,0,1911-7-23,0
1911,7,24,0,0,0,1911-7-24,0
1911,7,25,15,0,15,1911-7-25,-15
1911,7,26,5,0,5,1911-7-26,-5
1911,7,27,0,0,0,1911-7-27,0
1911,7,28,0,0,0,1911-7-28,0
1911,7,29,7,7,0,1911-7-29,7
1911,7,30,0,0,0,1911-7-30,0
1911,7,31,0,0,0,1911-7-31,0
1911,8,1,12,0,12,1911-8-1,-12
1911,8,2,0,0,0,1911-8-2,0
1911,8,3,0,0,0,1911-8-3,0
1911,8,4,0,0,0,1911-8-4,0
1911,8,5,64,0,64,1911-8-5,-64
1911,8,6,53,0,53,1911-8-6,-53
1911,8,7,107,0,107,1911-8-7,-107
1911,8,8,91,0,91,1911-8-8,-91
1911,8,9,135,0,135,1911-8-9,-135
1911,8,10,115,0,115,1911-8-10,-115
1911,8,11,42,0,42,1911-8-11,-42
1911,8,12,37,0,37,1911-8-12,-37
1911,8,13,23,0,23,1911-8-13,-23
1911,8,14,65,51,14,1911-8-14,37
1911,8,15,68,68,0,1911-8-15,68
1911,8,16,24,24,0,1911-8-16,24
1911,8,17,21,21,0,1911-8-17,21
1911,8,18,0,0,0,1911-8-18,0
1911,8,19,0,0,0,1911-8-19,0
1911,8,20,0,0,0,1911-8-20,0
1911,8,21,0,0,0,1911-8-21,0
1911,8,22,0,0,0,1911-8-22,0
1911,8,23,0,0,0,1911-8-23,0
1911,8,24,0,0,0,1911-8-24,0
1911,8,25,0,0,0,1911-8-25,0
1911,8,26,0,0,0,1911-8-26,0
1911,8,27,0,0,0,1911-8-27,0
1911,8,28,0,0,0,1911-8-28,0
1911,8,29,0,0,0,1911-8-29,0
1911,8,30,0,0,0,1911-8-30,0
1911,8,31,0,0,0,1911-8-31,0
1911,9,1,174,174,0,1911-9-1,174
1911,9,2,267,267,0,1911-9-2,267
1911,9,3,185,185,0,1911-9-3,185
1911,9,4,219,196,23,1911-9-4,173
1911,9,5,212,207,5,1911-9-5,202
1911,9,6,170,170,0,1911-9-6,170
1911,9,7,149,149,0,1911-9-7,149
1911,9,8,111,111,0,1911-9-8,111
1911,9,9,82,82,0,1911-9-9,82
1911,9,10,19,19,0,1911-9-10,19
1911,9,11,0,0,0,1911-9-11,0
1911,9,12,0,0,0,1911-9-12,0
1911,9,13,0,0,0,1911-9-13,0
1911,9,14,0,0,0,1911-9-14,0
1911,9,15,0,0,0,1911-9-15,0
1911,9,16,0,0,0,1911-9-16,0
1911,9,17,0,0,0,1911-9-17,0
1911,9,18,0,0,0,1911-9-18,0
1911,9,19,0,0,0,1911-9-19,0
1911,9,20,0,0,0,1911-9-20,0
1911,9,21,0,0,0,1911-9-21,0
1911,9,22,5,5,0,1911-9-22,5
1911,9,23,0,0,0,1911-9-23,0
1911,9,24,0,0,0,1911-9-24,0
1911,9,25,0,0,0,1911-9-25,0
1911,9,26,0,0,0,1911-9-26,0
1911,9,27,0,0,0,1911-9-27,0
1911,9,28,0,0,0,1911-9-28,0
1911,9,29,0,0,0,1911-9-29,0
1911,9,30,0,0,0,1911-9-30,0
1911,10,1,0,0,0,1911-10-1,0
1911,10,2,50,50,0,1911-10-2,50
1911,10,3,176,176,0,1911-10-3,176
1911,10,4,105,105,0,1911-10-4,105
1911,10,5,81,81,0,1911-10-5,81
1911,10,6,64,64,0,1911-10-6,64
1911,10,7,56,56,0,1911-10-7,56
1911,10,8,17,17,0,1911-10-8,17
1911,10,9,0,0,0,1911-10-9,0
1911,10,10,0,0,0,1911-10-10,0
1911,10,11,6,6,0,1911-10-11,6
1911,10,12,0,0,0,1911-10-12,0
1911,10,13,0,0,0,1911-10-13,0
1911,10,14,0,0,0,1911-10-14,0
1911,10,15,0,0,0,1911-10-15,0
1911,10,16,0,0,0,1911-10-16,0
1911,10,17,0,0,0,1911-10-17,0
1911,10,18,0,0,0,1911-10-18,0
1911,10,19,0,0,0,1911-10-19,0
1911,10,20,0,0,0,1911-10-20,0
1911,10,21,0,0,0,1911-10-21,0
1911,10,22,0,0,0,1911-10-22,0
1911,10,23,0,0,0,1911-10-23,0
1911,10,24,0,0,0,1911-10-24,0
1911,10,25,0,0,0,1911-10-25,0
1911,10,26,0,0,0,1911-10-26,0
1911,10,27,0,0,0,1911-10-27,0
1911,10,28,0,0,0,1911-10-28,0
1911,10,29,0,0,0,1911-10-29,0
1911,10,30,0,0,0,1911-10-30,0
1911,10,31,0,0,0,1911-10-31,0
1911,11,1,60,0,60,1911-11-1,-60
1911,11,2,23,0,23,1911-11-2,-23
1911,11,3,15,0,15,1911-11-3,-15
1911,11,4,17,0,17,1911-11-4,-17
1911,11,5,0,0,0,1911-11-5,0
1911,11,6,0,0,0,1911-11-6,0
1911,11,7,0,0,0,1911-11-7,0
1911,11,8,0,0,0,1911-11-8,0
1911,11,9,8,0,8,1911-11-9,-8
1911,11,10,13,0,13,1911-11-10,-13
1911,11,11,6,0,6,1911-11-11,-6
1911,11,12,6,0,6,1911-11-12,-6
1911,11,13,0,0,0,1911-11-13,0
1911,11,14,11,11,0,1911-11-14,11
1911,11,15,0,0,0,1911-11-15,0
1911,11,16,0,0,0,1911-11-16,0
1911,11,17,0,0,0,1911-11-17,0
1911,11,18,0,0,0,1911-11-18,0
1911,11,19,0,0,0,1911-11-19,0
1911,11,20,0,0,0,1911-11-20,0
1911,11,21,210,0,210,1911-11-21,-210
1911,11,22,161,0,161,1911-11-22,-161
1911,11,23,196,0,196,1911-11-23,-196
1911,11,24,197,0,197,1911-11-24,-197
1911,11,25,162,0,162,1911-11-25,-162
1911,11,26,155,0,155,1911-11-26,-155
1911,11,27,129,0,129,1911-11-27,-129
1911,11,28,119,0,119,1911-11-28,-119
1911,11,29,128,0,128,1911-11-29,-128
1911,11,30,101,0,101,1911-11-30,-101
1911,12,1,93,0,93,1911-12-1,-93
1911,12,2,39,0,39,1911-12-2,-39
1911,12,3,0,0,0,1911-12-3,0
1911,12,4,0,0,0,1911-12-4,0
1911,12,5,0,0,0,1911-12-5,0
1911,12,6,0,0,0,1911-12-6,0
1911,12,7,0,0,0,1911-12-7,0
1911,12,8,0,0,0,1911-12-8,0
1911,12,9,0,0,0,1911-12-9,0
1911,12,10,0,0,0,1911-12-10,0
1911,12,11,0,0,0,1911-12-11,0
1911,12,12,0,0,0,1911-12-12,0
1911,12,13,0,0,0,1911-12-13,0
1911,12,14,0,0,0,1911-12-14,0
1911,12,15,0,0,0,1911-12-15,0
1911,12,16,0,0,0,1911-12-16,0
1911,12,17,0,0,0,1911-12-17,0
1911,12,18,22,22,0,1911-12-18,22
1911,12,19,16,8,8,1911-12-19,0
1911,12,20,69,0,69,1911-12-20,-69
1911,12,21,60,0,60,1911-12-21,-60
1911,12,22,41,0,41,1911-12-22,-41
1911,12,23,10,0,10,1911-12-23,-10
1911,12,24,7,0,7,1911-12-24,-7
1911,12,25,0,0,0,1911-12-25,0
1911,12,26,0,0,0,1911-12-26,0
1911,12,27,24,24,0,1911-12-27,24
1911,12,28,33,33,0,1911-12-28,33
1911,12,29,40,40,0,1911-12-29,40
1911,12,30,25,25,0,1911-12-30,25
1911,12,31,0,0,0,1911-12-31,0
1912,1,1,0,0,0,1912-1-1,0
1912,1,2,0,0,0,1912-1-2,0
1912,1,3,0,0,0,1912-1-3,0
1912,1,4,0,0,0,1912-1-4,0
1912,1,5,0,0,0,1912-1-5,0
1912,1,6,0,0,0,1912-1-6,0
1912,1,7,0,0,0,1912-1-7,0
1912,1,8,0,0,0,1912-1-8,0
1912,1,9,0,0,0,1912-1-9,0
1912,1,10,0,0,0,1912-1-10,0
1912,1,11,0,0,0,1912-1-11,0
1912,1,12,0,0,0,1912-1-12,0
1912,1,13,0,0,0,1912-1-13,0
1912,1,14,0,0,0,1912-1-14,0
1912,1,15,0,0,0,1912-1-15,0
1912,1,16,0,0,0,1912-1-16,0
1912,1,17,0,0,0,1912-1-17,0
1912,1,18,0,0,0,1912-1-18,0
1912,1,19,0,0,0,1912-1-19,0
1912,1,20,0,0,0,1912-1-20,0
1912,1,21,0,0,0,1912-1-21,0
1912,1,22,0,0,0,1912-1-22,0
1912,1,23,0,0,0,1912-1-23,0
1912,1,24,0,0,0,1912-1-24,0
1912,1,25,0,0,0,1912-1-25,0
1912,1,26,0,0,0,1912-1-26,0
1912,1,27,0,0,0,1912-1-27,0
1912,1,28,0,0,0,1912-1-28,0
1912,1,29,0,0,0,1912-1-29,0
1912,1,30,0,0,0,1912-1-30,0
1912,1,31,0,0,0,1912-1-31,0
1912,2,1,0,0,0,1912-2-1,0
1912,2,2,0,0,0,1912-2-2,0
1912,2,3,0,0,0,1912-2-3,0
1912,2,4,0,0,0,1912-2-4,0
1912,2,5,0,0,0,1912-2-5,0
1912,2,6,0,0,0,1912-2-6,0
1912,2,7,0,0,0,1912-2-7,0
1912,2,8,0,0,0,1912-2-8,0
1912,2,9,0,0,0,1912-2-9,0
1912,2,10,0,0,0,1912-2-10,0
1912,2,11,0,0,0,1912-2-11,0
1912,2,12,0,0,0,1912-2-12,0
1912,2,13,0,0,0,1912-2-13,0
1912,2,14,0,0,0,1912-2-14,0
1912,2,15,0,0,0,1912-2-15,0
1912,2,16,0,0,0,1912-2-16,0
1912,2,17,0,0,0,1912-2-17,0
1912,2,18,0,0,0,1912-2-18,0
1912,2,19,0,0,0,1912-2-19,0
1912,2,20,0,0,0,1912-2-20,0
1912,2,21,0,0,0,1912-2-21,0
1912,2,22,0,0,0,1912-2-22,0
1912,2,23,0,0,0,1912-2-23,0
1912,2,24,0,0,0,1912-2-24,0
1912,2,25,0,0,0,1912-2-25,0
1912,2,26,0,0,0,1912-2-26,0
1912,2,27,0,0,0,1912-2-27,0
1912,2,28,0,0,0,1912-2-28,0
1912,2,29,0,0,0,1912-2-29,0
1912,3,1,0,0,0,1912-3-1,0
1912,3,2,0,0,0,1912-3-2,0
1912,3,3,0,0,0,1912-3-3,0
1912,3,4,3,0,3,1912-3-4,-3
1912,3,5,0,0,0,1912-3-5,0
1912,3,6,0,0,0,1912-3-6,0
1912,3,7,188,0,188,1912-3-7,-188
1912,3,8,292,0,292,1912-3-8,-292
1912,3,9,193,0,193,1912-3-9,-193
1912,3,10,199,0,199,1912-3-10,-199
1912,3,11,175,0,175,1912-3-11,-175
1912,3,12,140,0,140,1912-3-12,-140
1912,3,13,135,0,135,1912-3-13,-135
1912,3,14,101,0,101,1912-3-14,-101
1912,3,15,123,0,123,1912-3-15,-123
1912,3,16,113,0,113,1912-3-16,-113
1912,3,17,70,0,70,1912-3-17,-70
1912,3,18,47,0,47,1912-3-18,-47
1912,3,19,0,0,0,1912-3-19,0
1912,3,20,0,0,0,1912-3-20,0
1912,3,21,0,0,0,1912-3-21,0
1912,3,22,0,0,0,1912-3-22,0
1912,3,23,0,0,0,1912-3-23,0
1912,3,24,0,0,0,1912-3-24,0
1912,3,25,0,0,0,1912-3-25,0
1912,3,26,0,0,0,1912-3-26,0
1912,3,27,0,0,0,1912-3-27,0
1912,3,28,0,0,0,1912-3-28,0
1912,3,29,0,0,0,1912-3-29,0
1912,3,30,0,0,0,1912-3-30,0
1912,3,31,0,0,0,1912-3-31,0
1912,4,1,5,5,0,1912-4-1,5
1912,4,2,0,0,0,1912-4-2,0
1912,4,3,0,0,0,1912-4-3,0
1912,4,4,0,0,0,1912-4-4,0
1912,4,5,0,0,0,1912-4-5,0
1912,4,6,0,0,0,1912-4-6,0
1912,4,7,5,0,5,1912-4-7,-5
1912,4,8,48,0,48,1912-4-8,-48
1912,4,9,93,0,93,1912-4-9,-93
1912,4,10,293,0,293,1912-4-10,-293
1912,4,11,325,0,325,1912-4-11,-325
1912,4,12,518,0,518,1912-4-12,-518
1912,4,13,596,0,596,1912-4-13,-596
1912,4,14,685,0,685,1912-4-14,-685
1912,4,15,0,0,0,1912-4-15,0
1912,4,16,0,0,0,1912-4-16,0
1912,4,17,0,0,0,1912-4-17,0
1912,4,18,0,0,0,1912-4-18,0
1912,4,19,0,0,0,1912-4-19,0
1912,4,20,0,0,0,1912-4-20,0
1912,4,21,18,18,0,1912-4-21,18
1912,4,22,0,0,0,1912-4-22,0
1912,4,23,0,0,0,1912-4-23,0
1912,4,24,0,0,0,1912-4-24,0
1912,4,25,0,0,0,1912-4-25,0
1912,4,26,0,0,0,1912-4-26,0
1912,4,27,0,0,0,1912-4-27,0
1912,4,28,0,0,0,1912-4-28,0
1912,4,29,0,0,0,1912-4-29,0
1912,4,30,61,0,61,1912-4-30,-61
1912,5,1,62,0,62,1912-5-1,-62
1912,5,2,98,0,98,1912-5-2,-98
1912,5,3,52,0,52,1912-5-3,-52
1912,5,4,49,0,49,1912-5-4,-49
1912,5,5,35,0,35,1912-5-5,-35
1912,5,6,11,0,11,1912-5-6,-11
1912,5,7,44,0,44,1912-5-7,-44
1912,5,8,26,0,26,1912-5-8,-26
1912,5,9,14,0,14,1912-5-9,-14
1912,5,10,5,0,5,1912-5-10,-5
1912,5,11,0,0,0,1912-5-11,0
1912,5,12,0,0,0,1912-5-12,0
1912,5,13,15,8,7,1912-5-13,1
1912,5,14,5,5,0,1912-5-14,5
1912,5,15,0,0,0,1912-5-15,0
1912,5,16,0,0,0,1912-5-16,0
1912,5,17,0,0,0,1912-5-17,0
1912,5,18,0,0,0,1912-5-18,0
1912,5,19,0,0,0,1912-5-19,0
1912,5,20,0,0,0,1912-5-20,0
1912,5,21,0,0,0,1912-5-21,0
1912,5,22,0,0,0,1912-5-22,0
1912,5,23,0,0,0,1912-5-23,0
1912,5,24,0,0,0,1912-5-24,0
1912,5,25,0,0,0,1912-5-25,0
1912,5,26,12,0,12,1912-5-26,-12
1912,5,27,49,0,49,1912-5-27,-49
1912,5,28,54,0,54,1912-5-28,-54
1912,5,29,43,0,43,1912-5-29,-43
1912,5,30,14,0,14,1912-5-30,-14
1912,5,31,75,0,75,1912-5-31,-75
1912,6,1,166,0,166,1912-6-1,-166
1912,6,2,283,0,283,1912-6-2,-283
1912,6,3,71,0,71,1912-6-3,-71
1912,6,4,0,0,0,1912-6-4,0
1912,6,5,0,0,0,1912-6-5,0
1912,6,6,0,0,0,1912-6-6,0
1912,6,7,0,0,0,1912-6-7,0
1912,6,8,0,0,0,1912-6-8,0
1912,6,9,0,0,0,1912-6-9,0
1912,6,10,0,0,0,1912-6-10,0
1912,6,11,0,0,0,1912-6-11,0
1912,6,12,0,0,0,1912-6-12,0
1912,6,13,0,0,0,1912-6-13,0
1912,6,14,0,0,0,1912-6-14,0
1912,6,15,0,0,0,1912-6-15,0
1912,6,16,5,0,5,1912-6-16,-5
1912,6,17,204,0,204,1912-6-17,-204
1912,6,18,196,24,172,1912-6-18,-148
1912,6,19,189,0,189,1912-6-19,-189
1912,6,20,183,0,183,1912-6-20,-183
1912,6,21,169,0,169,1912-6-21,-169
1912,6,22,155,0,155,1912-6-22,-155
1912,6,23,162,0,162,1912-6-23,-162
1912,6,24,154,0,154,1912-6-24,-154
1912,6,25,156,0,156,1912-6-25,-156
1912,6,26,150,0,150,1912-6-26,-150
1912,6,27,142,0,142,1912-6-27,-142
1912,6,28,146,0,146,1912-6-28,-146
1912,6,29,0,0,0,1912-6-29,0
1912,6,30,0,0,0,1912-6-30,0
1912,7,1,0,0,0,1912-7-1,0
1912,7,2,13,0,13,1912-7-2,-13
1912,7,3,8,0,8,1912-7-3,-8
1912,7,4,19,0,19,1912-7-4,-19
1912,7,5,20,0,20,1912-7-5,-20
1912,7,6,21,0,21,1912-7-6,-21
1912,7,7,40,0,40,1912-7-7,-40
1912,7,8,40,0,40,1912-7-8,-40
1912,7,9,54,0,54,1912-7-9,-54
1912,7,10,29,0,29,1912-7-10,-29
1912,7,11,26,0,26,1912-7-11,-26
1912,7,12,5,0,5,1912-7-12,-5
1912,7,13,6,0,6,1912-7-13,-6
1912,7,14,0,0,0,1912-7-14,0
1912,7,15,0,0,0,1912-7-15,0
1912,7,16,0,0,0,1912-7-16,0
1912,7,17,5,0,5,1912-7-17,-5
1912,7,18,9,0,9,1912-7-18,-9
1912,7,19,0,0,0,1912-7-19,0
1912,7,20,0,0,0,1912-7-20,0
1912,7,21,0,0,0,1912-7-21,0
1912,7,22,0,0,0,1912-7-22,0
1912,7,23,0,0,0,1912-7-23,0
1912,7,24,0,0,0,1912-7-24,0
1912,7,25,0,0,0,1912-7-25,0
1912,7,26,0,0,0,1912-7-26,0
1912,7,27,0,0,0,1912-7-27,0
1912,7,28,0,0,0,1912-7-28,0
1912,7,29,0,0,0,1912-7-29,0
1912,7,30,0,0,0,1912-7-30,0
1912,7,31,0,0,0,1912-7-31,0
1912,8,1,0,0,0,1912-8-1,0
1912,8,2,0,0,0,1912-8-2,0
1912,8,3,0,0,0,1912-8-3,0
1912,8,4,0,0,0,1912-8-4,0
1912,8,5,0,0,0,1912-8-5,0
1912,8,6,0,0,0,1912-8-6,0
1912,8,7,0,0,0,1912-8-7,0
1912,8,8,0,0,0,1912-8-8,0
1912,8,9,0,0,0,1912-8-9,0
1912,8,10,0,0,0,1912-8-10,0
1912,8,11,0,0,0,1912-8-11,0
1912,8,12,0,0,0,1912-8-12,0
1912,8,13,0,0,0,1912-8-13,0
1912,8,14,0,0,0,1912-8-14,0
1912,8,15,0,0,0,1912-8-15,0
1912,8,16,0,0,0,1912-8-16,0
1912,8,17,0,0,0,1912-8-17,0
1912,8,18,0,0,0,1912-8-18,0
1912,8,19,0,0,0,1912-8-19,0
1912,8,20,0,0,0,1912-8-20,0
1912,8,21,0,0,0,1912-8-21,0
1912,8,22,0,0,0,1912-8-22,0
1912,8,23,0,0,0,1912-8-23,0
1912,8,24,0,0,0,1912-8-24,0
1912,8,25,0,0,0,1912-8-25,0
1912,8,26,0,0,0,1912-8-26,0
1912,8,27,0,0,0,1912-8-27,0
1912,8,28,8,0,8,1912-8-28,-8
1912,8,29,0,0,0,1912-8-29,0
1912,8,30,0,0,0,1912-8-30,0
1912,8,31,0,0,0,1912-8-31,0
1912,9,1,0,0,0,1912-9-1,0
1912,9,2,0,0,0,1912-9-2,0
1912,9,3,0,0,0,1912-9-3,0
1912,9,4,0,0,0,1912-9-4,0
1912,9,5,0,0,0,1912-9-5,0
1912,9,6,13,0,13,1912-9-6,-13
1912,9,7,52,0,52,1912-9-7,-52
1912,9,8,85,0,85,1912-9-8,-85
1912,9,9,34,0,34,1912-9-9,-34
1912,9,10,32,0,32,1912-9-10,-32
1912,9,11,25,0,25,1912-9-11,-25
1912,9,12,42,0,42,1912-9-12,-42
1912,9,13,53,0,53,1912-9-13,-53
1912,9,14,113,0,113,1912-9-14,-113
1912,9,15,106,0,106,1912-9-15,-106
1912,9,16,98,0,98,1912-9-16,-98
1912,9,17,60,0,60,1912-9-17,-60
1912,9,18,163,0,163,1912-9-18,-163
1912,9,19,262,0,262,1912-9-19,-262
1912,9,20,159,0,159,1912-9-20,-159
1912,9,21,0,0,0,1912-9-21,0
1912,9,22,0,0,0,1912-9-22,0
1912,9,23,0,0,0,1912-9-23,0
1912,9,24,0,0,0,1912-9-24,0
1912,9,25,21,0,21,1912-9-25,-21
1912,9,26,65,0,65,1912-9-26,-65
1912,9,27,29,0,29,1912-9-27,-29
1912,9,28,6,0,6,1912-9-28,-6
1912,9,29,0,0,0,1912-9-29,0
1912,9,30,0,0,0,1912-9-30,0
1912,10,1,0,0,0,1912-10-1,0
1912,10,2,0,0,0,1912-10-2,0
1912,10,3,0,0,0,1912-10-3,0
1912,10,4,0,0,0,1912-10-4,0
1912,10,5,71,0,71,1912-10-5,-71
1912,10,6,230,0,230,1912-10-6,-230
1912,10,7,362,0,362,1912-10-7,-362
1912,10,8,386,0,386,1912-10-8,-386
1912,10,9,273,0,273,1912-10-9,-273
1912,10,10,181,0,181,1912-10-10,-181
1912,10,11,164,0,164,1912-10-11,-164
1912,10,12,0,0,0,1912-10-12,0
1912,10,13,0,0,0,1912-10-13,0
1912,10,14,0,0,0,1912-10-14,0
1912,10,15,0,0,0,1912-10-15,0
1912,10,16,0,0,0,1912-10-16,0
1912,10,17,0,0,0,1912-10-17,0
1912,10,18,20,0,20,1912-10-18,-20
1912,10,19,9,0,9,1912-10-19,-9
1912,10,20,8,0,8,1912-10-20,-8
1912,10,21,0,0,0,1912-10-21,0
1912,10,22,0,0,0,1912-10-22,0
1912,10,23,0,0,0,1912-10-23,0
1912,10,24,0,0,0,1912-10-24,0
1912,10,25,0,0,0,1912-10-25,0
1912,10,26,0,0,0,1912-10-26,0
1912,10,27,0,0,0,1912-10-27,0
1912,10,28,0,0,0,1912-10-28,0
1912,10,29,0,0,0,1912-10-29,0
1912,10,30,0,0,0,1912-10-30,0
1912,10,31,0,0,0,1912-10-31,0
1912,11,1,0,0,0,1912-11-1,0
1912,11,2,0,0,0,1912-11-2,0
1912,11,3,0,0,0,1912-11-3,0
1912,11,4,0,0,0,1912-11-4,0
1912,11,5,0,0,0,1912-11-5,0
1912,11,6,0,0,0,1912-11-6,0
1912,11,7,0,0,0,1912-11-7,0
1912,11,8,0,0,0,1912-11-8,0
1912,11,9,0,0,0,1912-11-9,0
1912,11,10,0,0,0,1912-11-10,0
1912,11,11,0,0,0,1912-11-11,0
1912,11,12,0,0,0,1912-11-12,0
1912,11,13,0,0,0,1912-11-13,0
1912,11,14,0,0,0,1912-11-14,0
1912,11,15,0,0,0,1912-11-15,0
1912,11,16,8,0,8,1912-11-16,-8
1912,11,17,27,0,27,1912-11-17,-27
1912,11,18,20,0,20,1912-11-18,-20
1912,11,19,31,0,31,1912-11-19,-31
1912,11,20,0,0,0,1912-11-20,0
1912,11,21,0,0,0,1912-11-21,0
1912,11,22,0,0,0,1912-11-22,0
1912,11,23,0,0,0,1912-11-23,0
1912,11,24,0,0,0,1912-11-24,0
1912,11,25,0,0,0,1912-11-25,0
1912,11,26,0,0,0,1912-11-26,0
1912,11,27,0,0,0,1912-11-27,0
1912,11,28,0,0,0,1912-11-28,0
1912,11,29,0,0,0,1912-11-29,0
1912,11,30,0,0,0,1912-11-30,0
1912,12,1,0,0,0,1912-12-1,0
1912,12,2,0,0,0,1912-12-2,0
1912,12,3,0,0,0,1912-12-3,0
1912,12,4,0,0,0,1912-12-4,0
1912,12,5,0,0,0,1912-12-5,0
1912,12,6,0,0,0,1912-12-6,0
1912,12,7,0,0,0,1912-12-7,0
1912,12,8,0,0,0,1912-12-8,0
1912,12,9,0,0,0,1912-12-9,0
1912,12,10,0,0,0,1912-12-10,0
1912,12,11,0,0,0,1912-12-11,0
1912,12,12,62,0,62,1912-12-12,-62
1912,12,13,212,0,212,1912-12-13,-212
1912,12,14,248,0,248,1912-12-14,-248
1912,12,15,273,0,273,1912-12-15,-273
1912,12,16,225,17,208,1912-12-16,-191
1912,12,17,228,69,159,1912-12-17,-90
1912,12,18,187,34,153,1912-12-18,-119
1912,12,19,279,0,279,1912-12-19,-279
1912,12,20,318,0,318,1912-12-20,-318
1912,12,21,250,0,250,1912-12-21,-250
1912,12,22,136,0,136,1912-12-22,-136
1912,12,23,0,0,0,1912-12-23,0
1912,12,24,0,0,0,1912-12-24,0
1912,12,25,0,0,0,1912-12-25,0
1912,12,26,0,0,0,1912-12-26,0
1912,12,27,0,0,0,1912-12-27,0
1912,12,28,0,0,0,1912-12-28,0
1912,12,29,37,37,0,1912-12-29,37
1912,12,30,31,31,0,1912-12-30,31
1912,12,31,43,43,0,1912-12-31,43
1913,1,1,68,68,0,1913-1-1,68
1913,1,2,138,138,0,1913-1-2,138
1913,1,3,0,0,0,1913-1-3,0
1913,1,4,0,0,0,1913-1-4,0
1913,1,5,0,0,0,1913-1-5,0
1913,1,6,0,0,0,1913-1-6,0
1913,1,7,0,0,0,1913-1-7,0
1913,1,8,0,0,0,1913-1-8,0
1913,1,9,0,0,0,1913-1-9,0
1913,1,10,0,0,0,1913-1-10,0
1913,1,11,0,0,0,1913-1-11,0
1913,1,12,0,0,0,1913-1-12,0
1913,1,13,45,0,45,1913-1-13,-45
1913,1,14,95,0,95,1913-1-14,-95
1913,1,15,22,0,22,1913-1-15,-22
1913,1,16,20,20,0,1913-1-16,20
1913,1,17,14,14,0,1913-1-17,14
1913,1,18,18,18,0,1913-1-18,18
1913,1,19,0,0,0,1913-1-19,0
1913,1,20,0,0,0,1913-1-20,0
1913,1,21,0,0,0,1913-1-21,0
1913,1,22,0,0,0,1913-1-22,0
1913,1,23,0,0,0,1913-1-23,0
1913,1,24,0,0,0,1913-1-24,0
1913,1,25,8,0,8,1913-1-25,-8
1913,1,26,24,0,24,1913-1-26,-24
1913,1,27,6,0,6,1913-1-27,-6
1913,1,28,0,0,0,1913-1-28,0
1913,1,29,0,0,0,1913-1-29,0
1913,1,30,0,0,0,1913-1-30,0
1913,1,31,0,0,0,1913-1-31,0
1913,2,1,0,0,0,1913-2-1,0
1913,2,2,0,0,0,1913-2-2,0
1913,2,3,0,0,0,1913-2-3,0
1913,2,4,0,0,0,1913-2-4,0
1913,2,5,0,0,0,1913-2-5,0
1913,2,6,0,0,0,1913-2-6,0
1913,2,7,0,0,0,1913-2-7,0
1913,2,8,0,0,0,1913-2-8,0
1913,2,9,0,0,0,1913-2-9,0
1913,2,10,0,0,0,1913-2-10,0
1913,2,11,0,0,0,1913-2-11,0
1913,2,12,0,0,0,1913-2-12,0
1913,2,13,0,0,0,1913-2-13,0
1913,2,14,0,0,0,1913-2-14,0
1913,2,15,0,0,0,1913-2-15,0
1913,2,16,0,0,0,1913-2-16,0
1913,2,17,0,0,0,1913-2-17,0
1913,2,18,0,0,0,1913-2-18,0
1913,2,19,36,36,0,1913-2-19,36
1913,2,20,104,104,0,1913-2-20,104
1913,2,21,125,125,0,1913-2-21,125
1913,2,22,120,120,0,1913-2-22,120
1913,2,23,98,98,0,1913-2-23,98
1913,2,24,61,61,0,1913-2-24,61
1913,2,25,50,50,0,1913-2-25,50
1913,2,26,25,25,0,1913-2-26,25
1913,2,27,32,32,0,1913-2-27,32
1913,2,28,0,0,0,1913-2-28,0
1913,3,1,0,0,0,1913-3-1,0
1913,3,2,0,0,0,1913-3-2,0
1913,3,3,0,0,0,1913-3-3,0
1913,3,4,0,0,0,1913-3-4,0
1913,3,5,0,0,0,1913-3-5,0
1913,3,6,0,0,0,1913-3-6,0
1913,3,7,0,0,0,1913-3-7,0
1913,3,8,0,0,0,1913-3-8,0
1913,3,9,0,0,0,1913-3-9,0
1913,3,10,0,0,0,1913-3-10,0
1913,3,11,0,0,0,1913-3-11,0
1913,3,12,0,0,0,1913-3-12,0
1913,3,13,17,0,17,1913-3-13,-17
1913,3,14,8,0,8,1913-3-14,-8
1913,3,15,0,0,0,1913-3-15,0
1913,3,16,0,0,0,1913-3-16,0
1913,3,17,0,0,0,1913-3-17,0
1913,3,18,0,0,0,1913-3-18,0
1913,3,19,0,0,0,1913-3-19,0
1913,3,20,0,0,0,1913-3-20,0
1913,3,21,0,0,0,1913-3-21,0
1913,3,22,0,0,0,1913-3-22,0
1913,3,23,0,0,0,1913-3-23,0
1913,3,24,0,0,0,1913-3-24,0
1913,3,25,0,0,0,1913-3-25,0
1913,3,26,0,0,0,1913-3-26,0
1913,3,27,0,0,0,1913-3-27,0
1913,3,28,0,0,0,1913-3-28,0
1913,3,29,0,0,0,1913-3-29,0
1913,3,30,0,0,0,1913-3-30,0
1913,3,31,0,0,0,1913-3-31,0
1913,4,1,0,0,0,1913-4-1,0
1913,4,2,0,0,0,1913-4-2,0
1913,4,3,0,0,0,1913-4-3,0
1913,4,4,0,0,0,1913-4-4,0
1913,4,5,42,0,42,1913-4-5,-42
1913,4,6,44,0,44,1913-4-6,-44
1913,4,7,12,0,12,1913-4-7,-12
1913,4,8,0,0,0,1913-4-8,0
1913,4,9,0,0,0,1913-4-9,0
1913,4,10,0,0,0,1913-4-10,0
1913,4,11,0,0,0,1913-4-11,0
1913,4,12,0,0,0,1913-4-12,0
1913,4,13,0,0,0,1913-4-13,0
1913,4,14,0,0,0,1913-4-14,0
1913,4,15,0,0,0,1913-4-15,0
1913,4,16,0,0,0,1913-4-16,0
1913,4,17,0,0,0,1913-4-17,0
1913,4,18,0,0,0,1913-4-18,0
1913,4,19,0,0,0,1913-4-19,0
1913,4,20,0,0,0,1913-4-20,0
1913,4,21,0,0,0,1913-4-21,0
1913,4,22,0,0,0,1913-4-22,0
1913,4,23,0,0,0,1913-4-23,0
1913,4,24,0,0,0,1913-4-24,0
1913,4,25,0,0,0,1913-4-25,0
1913,4,26,0,0,0,1913-4-26,0
1913,4,27,0,0,0,1913-4-27,0
1913,4,28,0,0,0,1913-4-28,0
1913,4,29,0,0,0,1913-4-29,0
1913,4,30,0,0,0,1913-4-30,0
1913,5,1,0,0,0,1913-5-1,0
1913,5,2,0,0,0,1913-5-2,0
1913,5,3,0,0,0,1913-5-3,0
1913,5,4,0,0,0,1913-5-4,0
1913,5,5,0,0,0,1913-5-5,0
1913,5,6,0,0,0,1913-5-6,0
1913,5,7,0,0,0,1913-5-7,0
1913,5,8,0,0,0,1913-5-8,0
1913,5,9,0,0,0,1913-5-9,0
1913,5,10,0,0,0,1913-5-10,0
1913,5,11,0,0,0,1913-5-11,0
1913,5,12,0,0,0,1913-5-12,0
1913,5,13,0,0,0,1913-5-13,0
1913,5,14,0,0,0,1913-5-14,0
1913,5,15,0,0,0,1913-5-15,0
1913,5,16,0,0,0,1913-5-16,0
1913,5,17,0,0,0,1913-5-17,0
1913,5,18,0,0,0,1913-5-18,0
1913,5,19,0,0,0,1913-5-19,0
1913,5,20,0,0,0,1913-5-20,0
1913,5,21,0,0,0,1913-5-21,0
1913,5,22,0,0,0,1913-5-22,0
1913,5,23,0,0,0,1913-5-23,0
1913,5,24,0,0,0,1913-5-24,0
1913,5,25,0,0,0,1913-5-25,0
1913,5,26,0,0,0,1913-5-26,0
1913,5,27,0,0,0,1913-5-27,0
1913,5,28,0,0,0,1913-5-28,0
1913,5,29,0,0,0,1913-5-29,0
1913,5,30,0,0,0,1913-5-30,0
1913,5,31,0,0,0,1913-5-31,0
1913,6,1,0,0,0,1913-6-1,0
1913,6,2,0,0,0,1913-6-2,0
1913,6,3,0,0,0,1913-6-3,0
1913,6,4,0,0,0,1913-6-4,0
1913,6,5,0,0,0,1913-6-5,0
1913,6,6,0,0,0,1913-6-6,0
1913,6,7,0,0,0,1913-6-7,0
1913,6,8,0,0,0,1913-6-8,0
1913,6,9,0,0,0,1913-6-9,0
1913,6,10,0,0,0,1913-6-10,0
1913,6,11,0,0,0,1913-6-11,0
1913,6,12,0,0,0,1913-6-12,0
1913,6,13,0,0,0,1913-6-13,0
1913,6,14,0,0,0,1913-6-14,0
1913,6,15,0,0,0,1913-6-15,0
1913,6,16,0,0,0,1913-6-16,0
1913,6,17,0,0,0,1913-6-17,0
1913,6,18,0,0,0,1913-6-18,0
1913,6,19,0,0,0,1913-6-19,0
1913,6,20,0,0,0,1913-6-20,0
1913,6,21,0,0,0,1913-6-21,0
1913,6,22,0,0,0,1913-6-22,0
1913,6,23,0,0,0,1913-6-23,0
1913,6,24,0,0,0,1913-6-24,0
1913,6,25,0,0,0,1913-6-25,0
1913,6,26,0,0,0,1913-6-26,0
1913,6,27,0,0,0,1913-6-27,0
1913,6,28,0,0,0,1913-6-28,0
1913,6,29,0,0,0,1913-6-29,0
1913,6,30,0,0,0,1913-6-30,0
1913,7,1,0,0,0,1913-7-1,0
1913,7,2,0,0,0,1913-7-2,0
1913,7,3,0,0,0,1913-7-3,0
1913,7,4,0,0,0,1913-7-4,0
1913,7,5,0,0,0,1913-7-5,0
1913,7,6,0,0,0,1913-7-6,0
1913,7,7,0,0,0,1913-7-7,0
1913,7,8,0,0,0,1913-7-8,0
1913,7,9,6,6,0,1913-7-9,6
1913,7,10,45,45,0,1913-7-10,45
1913,7,11,66,66,0,1913-7-11,66
1913,7,12,53,53,0,1913-7-12,53
1913,7,13,33,33,0,1913-7-13,33
1913,7,14,7,7,0,1913-7-14,7
1913,7,15,0,0,0,1913-7-15,0
1913,7,16,0,0,0,1913-7-16,0
1913,7,17,0,0,0,1913-7-17,0
1913,7,18,0,0,0,1913-7-18,0
1913,7,19,0,0,0,1913-7-19,0
1913,7,20,0,0,0,1913-7-20,0
1913,7,21,0,0,0,1913-7-21,0
1913,7,22,0,0,0,1913-7-22,0
1913,7,23,0,0,0,1913-7-23,0
1913,7,24,0,0,0,1913-7-24,0
1913,7,25,0,0,0,1913-7-25,0
1913,7,26,0,0,0,1913-7-26,0
1913,7,27,0,0,0,1913-7-27,0
1913,7,28,0,0,0,1913-7-28,0
1913,7,29,0,0,0,1913-7-29,0
1913,7,30,0,0,0,1913-7-30,0
1913,7,31,0,0,0,1913-7-31,0
1913,8,1,0,0,0,1913-8-1,0
1913,8,2,0,0,0,1913-8-2,0
1913,8,3,0,0,0,1913-8-3,0
1913,8,4,0,0,0,1913-8-4,0
1913,8,5,0,0,0,1913-8-5,0
1913,8,6,0,0,0,1913-8-6,0
1913,8,7,0,0,0,1913-8-7,0
1913,8,8,0,0,0,1913-8-8,0
1913,8,9,0,0,0,1913-8-9,0
1913,8,10,0,0,0,1913-8-10,0
1913,8,11,0,0,0,1913-8-11,0
1913,8,12,0,0,0,1913-8-12,0
1913,8,13,0,0,0,1913-8-13,0
1913,8,14,0,0,0,1913-8-14,0
1913,8,15,0,0,0,1913-8-15,0
1913,8,16,0,0,0,1913-8-16,0
1913,8,17,0,0,0,1913-8-17,0
1913,8,18,0,0,0,1913-8-18,0
1913,8,19,0,0,0,1913-8-19,0
1913,8,20,0,0,0,1913-8-20,0
1913,8,21,0,0,0,1913-8-21,0
1913,8,22,0,0,0,1913-8-22,0
1913,8,23,0,0,0,1913-8-23,0
1913,8,24,0,0,0,1913-8-24,0
1913,8,25,0,0,0,1913-8-25,0
1913,8,26,0,0,0,1913-8-26,0
1913,8,27,0,0,0,1913-8-27,0
1913,8,28,0,0,0,1913-8-28,0
1913,8,29,0,0,0,1913-8-29,0
1913,8,30,0,0,0,1913-8-30,0
1913,8,31,0,0,0,1913-8-31,0
1913,9,1,0,0,0,1913-9-1,0
1913,9,2,0,0,0,1913-9-2,0
1913,9,3,0,0,0,1913-9-3,0
1913,9,4,0,0,0,1913-9-4,0
1913,9,5,0,0,0,1913-9-5,0
1913,9,6,0,0,0,1913-9-6,0
1913,9,7,32,32,0,1913-9-7,32
1913,9,8,45,45,0,1913-9-8,45
1913,9,9,31,31,0,1913-9-9,31
1913,9,10,0,0,0,1913-9-10,0
1913,9,11,0,0,0,1913-9-11,0
1913,9,12,0,0,0,1913-9-12,0
1913,9,13,0,0,0,1913-9-13,0
1913,9,14,0,0,0,1913-9-14,0
1913,9,15,0,0,0,1913-9-15,0
1913,9,16,0,0,0,1913-9-16,0
1913,9,17,0,0,0,1913-9-17,0
1913,9,18,0,0,0,1913-9-18,0
1913,9,19,0,0,0,1913-9-19,0
1913,9,20,0,0,0,1913-9-20,0
1913,9,21,0,0,0,1913-9-21,0
1913,9,22,0,0,0,1913-9-22,0
1913,9,23,0,0,0,1913-9-23,0
1913,9,24,0,0,0,1913-9-24,0
1913,9,25,0,0,0,1913-9-25,0
1913,9,26,0,0,0,1913-9-26,0
1913,9,27,0,0,0,1913-9-27,0
1913,9,28,0,0,0,1913-9-28,0
1913,9,29,0,0,0,1913-9-29,0
1913,9,30,0,0,0,1913-9-30,0
1913,10,1,0,0,0,1913-10-1,0
1913,10,2,0,0,0,1913-10-2,0
1913,10,3,0,0,0,1913-10-3,0
1913,10,4,0,0,0,1913-10-4,0
1913,10,5,0,0,0,1913-10-5,0
1913,10,6,35,35,0,1913-10-6,35
1913,10,7,22,22,0,1913-10-7,22
1913,10,8,12,12,0,1913-10-8,12
1913,10,9,0,0,0,1913-10-9,0
1913,10,10,0,0,0,1913-10-10,0
1913,10,11,0,0,0,1913-10-11,0
1913,10,12,0,0,0,1913-10-12,0
1913,10,13,0,0,0,1913-10-13,0
1913,10,14,0,0,0,1913-10-14,0
1913,10,15,0,0,0,1913-10-15,0
1913,10,16,0,0,0,1913-10-16,0
1913,10,17,0,0,0,1913-10-17,0
1913,10,18,0,0,0,1913-10-18,0
1913,10,19,0,0,0,1913-10-19,0
1913,10,20,0,0,0,1913-10-20,0
1913,10,21,0,0,0,1913-10-21,0
1913,10,22,0,0,0,1913-10-22,0
1913,10,23,0,0,0,1913-10-23,0
1913,10,24,0,0,0,1913-10-24,0
1913,10,25,87,87,0,1913-10-25,87
1913,10,26,55,55,0,1913-10-26,55
1913,10,27,70,70,0,1913-10-27,70
1913,10,28,54,54,0,1913-10-28,54
1913,10,29,61,61,0,1913-10-29,61
1913,10,30,48,48,0,1913-10-30,48
1913,10,31,16,16,0,1913-10-31,16
1913,11,1,0,0,0,1913-11-1,0
1913,11,2,0,0,0,1913-11-2,0
1913,11,3,0,0,0,1913-11-3,0
1913,11,4,0,0,0,1913-11-4,0
1913,11,5,0,0,0,1913-11-5,0
1913,11,6,0,0,0,1913-11-6,0
1913,11,7,0,0,0,1913-11-7,0
1913,11,8,0,0,0,1913-11-8,0
1913,11,9,0,0,0,1913-11-9,0
1913,11,10,0,0,0,1913-11-10,0
1913,11,11,0,0,0,1913-11-11,0
1913,11,12,0,0,0,1913-11-12,0
1913,11,13,0,0,0,1913-11-13,0
1913,11,14,0,0,0,1913-11-14,0
1913,11,15,0,0,0,1913-11-15,0
1913,11,16,0,0,0,1913-11-16,0
1913,11,17,0,0,0,1913-11-17,0
1913,11,18,0,0,0,1913-11-18,0
1913,11,19,0,0,0,1913-11-19,0
1913,11,20,0,0,0,1913-11-20,0
1913,11,21,0,0,0,1913-11-21,0
1913,11,22,0,0,0,1913-11-22,0
1913,11,23,0,0,0,1913-11-23,0
1913,11,24,60,0,60,1913-11-24,-60
1913,11,25,97,0,97,1913-11-25,-97
1913,11,26,0,0,0,1913-11-26,0
1913,11,27,0,0,0,1913-11-27,0
1913,11,28,0,0,0,1913-11-28,0
1913,11,29,0,0,0,1913-11-29,0
1913,11,30,0,0,0,1913-11-30,0
1913,12,1,0,0,0,1913-12-1,0
1913,12,2,0,0,0,1913-12-2,0
1913,12,3,0,0,0,1913-12-3,0
1913,12,4,0,0,0,1913-12-4,0
1913,12,5,0,0,0,1913-12-5,0
1913,12,6,0,0,0,1913-12-6,0
1913,12,7,0,0,0,1913-12-7,0
1913,12,8,0,0,0,1913-12-8,0
1913,12,9,49,0,49,1913-12-9,-49
1913,12,10,131,0,131,1913-12-10,-131
1913,12,11,131,0,131,1913-12-11,-131
1913,12,12,58,0,58,1913-12-12,-58
1913,12,13,51,0,51,1913-12-13,-51
1913,12,14,8,0,8,1913-12-14,-8
1913,12,15,0,0,0,1913-12-15,0
1913,12,16,0,0,0,1913-12-16,0
1913,12,17,0,0,0,1913-12-17,0
1913,12,18,0,0,0,1913-12-18,0
1913,12,19,0,0,0,1913-12-19,0
1913,12,20,0,0,0,1913-12-20,0
1913,12,21,0,0,0,1913-12-21,0
1913,12,22,0,0,0,1913-12-22,0
1913,12,23,0,0,0,1913-12-23,0
1913,12,24,0,0,0,1913-12-24,0
1913,12,25,0,0,0,1913-12-25,0
1913,12,26,0,0,0,1913-12-26,0
1913,12,27,0,0,0,1913-12-27,0
1913,12,28,0,0,0,1913-12-28,0
1913,12,29,0,0,0,1913-12-29,0
1913,12,30,72,72,0,1913-12-30,72
1913,12,31,51,51,0,1913-12-31,51
1914,1,1,196,54,142,1914-1-1,-88
1914,1,2,118,79,39,1914-1-2,40
1914,1,3,41,41,0,1914-1-3,41
1914,1,4,8,8,0,1914-1-4,8
1914,1,5,20,20,0,1914-1-5,20
1914,1,6,10,0,10,1914-1-6,-10
1914,1,7,0,0,0,1914-1-7,0
1914,1,8,0,0,0,1914-1-8,0
1914,1,9,11,0,11,1914-1-9,-11
1914,1,10,0,0,0,1914-1-10,0
1914,1,11,0,0,0,1914-1-11,0
1914,1,12,0,0,0,1914-1-12,0
1914,1,13,0,0,0,1914-1-13,0
1914,1,14,0,0,0,1914-1-14,0
1914,1,15,0,0,0,1914-1-15,0
1914,1,16,0,0,0,1914-1-16,0
1914,1,17,0,0,0,1914-1-17,0
1914,1,18,0,0,0,1914-1-18,0
1914,1,19,0,0,0,1914-1-19,0
1914,1,20,0,0,0,1914-1-20,0
1914,1,21,0,0,0,1914-1-21,0
1914,1,22,0,0,0,1914-1-22,0
1914,1,23,0,0,0,1914-1-23,0
1914,1,24,0,0,0,1914-1-24,0
1914,1,25,0,0,0,1914-1-25,0
1914,1,26,0,0,0,1914-1-26,0
1914,1,27,0,0,0,1914-1-27,0
1914,1,28,0,0,0,1914-1-28,0
1914,1,29,0,0,0,1914-1-29,0
1914,1,30,0,0,0,1914-1-30,0
1914,1,31,0,0,0,1914-1-31,0
1914,2,1,0,0,0,1914-2-1,0
1914,2,2,44,0,44,1914-2-2,-44
1914,2,3,57,0,57,1914-2-3,-57
1914,2,4,91,13,78,1914-2-4,-65
1914,2,5,61,0,61,1914-2-5,-61
1914,2,6,33,0,33,1914-2-6,-33
1914,2,7,0,0,0,1914-2-7,0
1914,2,8,0,0,0,1914-2-8,0
1914,2,9,0,0,0,1914-2-9,0
1914,2,10,0,0,0,1914-2-10,0
1914,2,11,0,0,0,1914-2-11,0
1914,2,12,0,0,0,1914-2-12,0
1914,2,13,0,0,0,1914-2-13,0
1914,2,14,0,0,0,1914-2-14,0
1914,2,15,0,0,0,1914-2-15,0
1914,2,16,0,0,0,1914-2-16,0
1914,2,17,0,0,0,1914-2-17,0
1914,2,18,3,3,0,1914-2-18,3
1914,2,19,0,0,0,1914-2-19,0
1914,2,20,0,0,0,1914-2-20,0
1914,2,21,4,0,4,1914-2-21,-4
1914,2,22,0,0,0,1914-2-22,0
1914,2,23,0,0,0,1914-2-23,0
1914,2,24,0,0,0,1914-2-24,0
1914,2,25,0,0,0,1914-2-25,0
1914,2,26,0,0,0,1914-2-26,0
1914,2,27,6,0,6,1914-2-27,-6
1914,2,28,0,0,0,1914-2-28,0
1914,3,1,0,0,0,1914-3-1,0
1914,3,2,0,0,0,1914-3-2,0
1914,3,3,0,0,0,1914-3-3,0
1914,3,4,0,0,0,1914-3-4,0
1914,3,5,0,0,0,1914-3-5,0
1914,3,6,0,0,0,1914-3-6,0
1914,3,7,0,0,0,1914-3-7,0
1914,3,8,0,0,0,1914-3-8,0
1914,3,9,0,0,0,1914-3-9,0
1914,3,10,0,0,0,1914-3-10,0
1914,3,11,0,0,0,1914-3-11,0
1914,3,12,25,20,5,1914-3-12,15
1914,3,13,15,15,0,1914-3-13,15
1914,3,14,8,8,0,1914-3-14,8
1914,3,15,47,47,0,1914-3-15,47
1914,3,16,138,138,0,1914-3-16,138
1914,3,17,133,133,0,1914-3-17,133
1914,3,18,72,72,0,1914-3-18,72
1914,3,19,0,0,0,1914-3-19,0
1914,3,20,0,0,0,1914-3-20,0
1914,3,21,0,0,0,1914-3-21,0
1914,3,22,0,0,0,1914-3-22,0
1914,3,23,0,0,0,1914-3-23,0
1914,3,24,0,0,0,1914-3-24,0
1914,3,25,0,0,0,1914-3-25,0
1914,3,26,0,0,0,1914-3-26,0
1914,3,27,0,0,0,1914-3-27,0
1914,3,28,0,0,0,1914-3-28,0
1914,3,29,0,0,0,1914-3-29,0
1914,3,30,297,297,0,1914-3-30,297
1914,3,31,464,464,0,1914-3-31,464
1914,4,1,603,603,0,1914-4-1,603
1914,4,2,500,500,0,1914-4-2,500
1914,4,3,382,382,0,1914-4-3,382
1914,4,4,384,384,0,1914-4-4,384
1914,4,5,567,567,0,1914-4-5,567
1914,4,6,580,580,0,1914-4-6,580
1914,4,7,392,392,0,1914-4-7,392
1914,4,8,430,430,0,1914-4-8,430
1914,4,9,428,428,0,1914-4-9,428
1914,4,10,431,431,0,1914-4-10,431
1914,4,11,67,67,0,1914-4-11,67
1914,4,12,17,0,17,1914-4-12,-17
1914,4,13,39,0,39,1914-4-13,-39
1914,4,14,18,0,18,1914-4-14,-18
1914,4,15,0,0,0,1914-4-15,0
1914,4,16,37,0,37,1914-4-16,-37
1914,4,17,23,0,23,1914-4-17,-23
1914,4,18,31,0,31,1914-4-18,-31
1914,4,19,116,0,116,1914-4-19,-116
1914,4,20,117,0,117,1914-4-20,-117
1914,4,21,114,0,114,1914-4-21,-114
1914,4,22,130,0,130,1914-4-22,-130
1914,4,23,62,12,50,1914-4-23,-38
1914,4,24,44,0,44,1914-4-24,-44
1914,4,25,17,0,17,1914-4-25,-17
1914,4,26,85,85,0,1914-4-26,85
1914,4,27,417,417,0,1914-4-27,417
1914,4,28,882,882,0,1914-4-28,882
1914,4,29,884,884,0,1914-4-29,884
1914,4,30,808,808,0,1914-4-30,808
1914,5,1,703,703,0,1914-5-1,703
1914,5,2,574,563,11,1914-5-2,552
1914,5,3,526,505,21,1914-5-3,484
1914,5,4,18,11,7,1914-5-4,4
1914,5,5,16,16,0,1914-5-5,16
1914,5,6,13,0,13,1914-5-6,-13
1914,5,7,0,0,0,1914-5-7,0
1914,5,8,0,0,0,1914-5-8,0
1914,5,9,0,0,0,1914-5-9,0
1914,5,10,0,0,0,1914-5-10,0
1914,5,11,0,0,0,1914-5-11,0
1914,5,12,0,0,0,1914-5-12,0
1914,5,13,0,0,0,1914-5-13,0
1914,5,14,0,0,0,1914-5-14,0
1914,5,15,0,0,0,1914-5-15,0
1914,5,16,0,0,0,1914-5-16,0
1914,5,17,0,0,0,1914-5-17,0
1914,5,18,0,0,0,1914-5-18,0
1914,5,19,0,0,0,1914-5-19,0
1914,5,20,0,0,0,1914-5-20,0
1914,5,21,40,40,0,1914-5-21,40
1914,5,22,81,81,0,1914-5-22,81
1914,5,23,100,100,0,1914-5-23,100
1914,5,24,67,67,0,1914-5-24,67
1914,5,25,9,9,0,1914-5-25,9
1914,5,26,0,0,0,1914-5-26,0
1914,5,27,0,0,0,1914-5-27,0
1914,5,28,0,0,0,1914-5-28,0
1914,5,29,9,0,9,1914-5-29,-9
1914,5,30,12,0,12,1914-5-30,-12
1914,5,31,0,0,0,1914-5-31,0
1914,6,1,0,0,0,1914-6-1,0
1914,6,2,0,0,0,1914-6-2,0
1914,6,3,0,0,0,1914-6-3,0
1914,6,4,0,0,0,1914-6-4,0
1914,6,5,0,0,0,1914-6-5,0
1914,6,6,0,0,0,1914-6-6,0
1914,6,7,0,0,0,1914-6-7,0
1914,6,8,90,90,0,1914-6-8,90
1914,6,9,123,123,0,1914-6-9,123
1914,6,10,123,123,0,1914-6-10,123
1914,6,11,99,99,0,1914-6-11,99
1914,6,12,99,28,71,1914-6-12,-43
1914,6,13,215,25,190,1914-6-13,-165
1914,6,14,262,17,245,1914-6-14,-228
1914,6,15,342,14,328,1914-6-15,-314
1914,6,16,354,0,354,1914-6-16,-354
1914,6,17,632,0,632,1914-6-17,-632
1914,6,18,744,0,744,1914-6-18,-744
1914,6,19,597,0,597,1914-6-19,-597
1914,6,20,543,0,543,1914-6-20,-543
1914,6,21,507,0,507,1914-6-21,-507
1914,6,22,445,0,445,1914-6-22,-445
1914,6,23,0,0,0,1914-6-23,0
1914,6,24,0,0,0,1914-6-24,0
1914,6,25,0,0,0,1914-6-25,0
1914,6,26,0,0,0,1914-6-26,0
1914,6,27,0,0,0,1914-6-27,0
1914,6,28,0,0,0,1914-6-28,0
1914,6,29,0,0,0,1914-6-29,0
1914,6,30,0,0,0,1914-6-30,0
1914,7,1,44,0,44,1914-7-1,-44
1914,7,2,73,0,73,1914-7-2,-73
1914,7,3,181,0,181,1914-7-3,-181
1914,7,4,159,0,159,1914-7-4,-159
1914,7,5,159,0,159,1914-7-5,-159
1914,7,6,106,0,106,1914-7-6,-106
1914,7,7,111,0,111,1914-7-7,-111
1914,7,8,93,0,93,1914-7-8,-93
1914,7,9,76,0,76,1914-7-9,-76
1914,7,10,70,0,70,1914-7-10,-70
1914,7,11,80,0,80,1914-7-11,-80
1914,7,12,36,0,36,1914-7-12,-36
1914,7,13,18,2,16,1914-7-13,-14
1914,7,14,0,0,0,1914-7-14,0
1914,7,15,0,0,0,1914-7-15,0
1914,7,16,15,0,15,1914-7-16,-15
1914,7,17,95,0,95,1914-7-17,-95
1914,7,18,45,0,45,1914-7-18,-45
1914,7,19,5,0,5,1914-7-19,-5
1914,7,20,0,0,0,1914-7-20,0
1914,7,21,20,0,20,1914-7-21,-20
1914,7,22,13,0,13,1914-7-22,-13
1914,7,23,4,0,4,1914-7-23,-4
1914,7,24,0,0,0,1914-7-24,0
1914,7,25,0,0,0,1914-7-25,0
1914,7,26,0,0,0,1914-7-26,0
1914,7,27,0,0,0,1914-7-27,0
1914,7,28,0,0,0,1914-7-28,0
1914,7,29,14,0,14,1914-7-29,-14
1914,7,30,22,3,19,1914-7-30,-16
1914,7,31,8,0,8,1914-7-31,-8
1914,8,1,0,0,0,1914-8-1,0
1914,8,2,0,0,0,1914-8-2,0
1914,8,3,0,0,0,1914-8-3,0
1914,8,4,0,0,0,1914-8-4,0
1914,8,5,0,0,0,1914-8-5,0
1914,8,6,0,0,0,1914-8-6,0
1914,8,7,0,0,0,1914-8-7,0
1914,8,8,0,0,0,1914-8-8,0
1914,8,9,0,0,0,1914-8-9,0
1914,8,10,0,0,0,1914-8-10,0
1914,8,11,0,0,0,1914-8-11,0
1914,8,12,0,0,0,1914-8-12,0
1914,8,13,540,540,0,1914-8-13,540
1914,8,14,609,609,0,1914-8-14,609
1914,8,15,568,568,0,1914-8-15,568
1914,8,16,683,630,53,1914-8-16,577
1914,8,17,758,663,95,1914-8-17,568
1914,8,18,606,593,13,1914-8-18,580
1914,8,19,670,666,4,1914-8-19,662
1914,8,20,817,817,0,1914-8-20,817
1914,8,21,700,700,0,1914-8-21,700
1914,8,22,738,738,0,1914-8-22,738
1914,8,23,710,676,34,1914-8-23,642
1914,8,24,693,623,70,1914-8-24,553
1914,8,25,681,681,0,1914-8-25,681
1914,8,26,393,393,0,1914-8-26,393
1914,8,27,0,0,0,1914-8-27,0
1914,8,28,0,0,0,1914-8-28,0
1914,8,29,0,0,0,1914-8-29,0
1914,8,30,15,15,0,1914-8-30,15
1914,8,31,18,18,0,1914-8-31,18
1914,9,1,0,0,0,1914-9-1,0
1914,9,2,0,0,0,1914-9-2,0
1914,9,3,0,0,0,1914-9-3,0
1914,9,4,0,0,0,1914-9-4,0
1914,9,5,0,0,0,1914-9-5,0
1914,9,6,0,0,0,1914-9-6,0
1914,9,7,0,0,0,1914-9-7,0
1914,9,8,293,0,293,1914-9-8,-293
1914,9,9,281,0,281,1914-9-9,-281
1914,9,10,789,536,253,1914-9-10,283
1914,9,11,884,470,414,1914-9-11,56
1914,9,12,920,451,469,1914-9-12,-18
1914,9,13,860,434,426,1914-9-13,8
1914,9,14,836,460,376,1914-9-14,84
1914,9,15,831,449,382,1914-9-15,67
1914,9,16,753,461,292,1914-9-16,169
1914,9,17,707,496,211,1914-9-17,285
1914,9,18,704,501,203,1914-9-18,298
1914,9,19,638,436,202,1914-9-19,234
1914,9,20,580,431,149,1914-9-20,282
1914,9,21,446,432,14,1914-9-21,418
1914,9,22,270,270,0,1914-9-22,270
1914,9,23,0,0,0,1914-9-23,0
1914,9,24,65,65,0,1914-9-24,65
1914,9,25,79,79,0,1914-9-25,79
1914,9,26,76,76,0,1914-9-26,76
1914,9,27,78,78,0,1914-9-27,78
1914,9,28,91,91,0,1914-9-28,91
1914,9,29,71,71,0,1914-9-29,71
1914,9,30,68,68,0,1914-9-30,68
1914,10,1,31,31,0,1914-10-1,31
1914,10,2,30,23,7,1914-10-2,16
1914,10,3,3,0,3,1914-10-3,-3
1914,10,4,0,0,0,1914-10-4,0
1914,10,5,0,0,0,1914-10-5,0
1914,10,6,0,0,0,1914-10-6,0
1914,10,7,0,0,0,1914-10-7,0
1914,10,8,0,0,0,1914-10-8,0
1914,10,9,12,12,0,1914-10-9,12
1914,10,10,27,27,0,1914-10-10,27
1914,10,11,32,32,0,1914-10-11,32
1914,10,12,0,0,0,1914-10-12,0
1914,10,13,22,22,0,1914-10-13,22
1914,10,14,0,0,0,1914-10-14,0
1914,10,15,14,14,0,1914-10-15,14
1914,10,16,0,0,0,1914-10-16,0
1914,10,17,0,0,0,1914-10-17,0
1914,10,18,0,0,0,1914-10-18,0
1914,10,19,37,0,37,1914-10-19,-37
1914,10,20,79,0,79,1914-10-20,-79
1914,10,21,28,16,12,1914-10-21,4
1914,10,22,61,61,0,1914-10-22,61
1914,10,23,63,63,0,1914-10-23,63
1914,10,24,29,29,0,1914-10-24,29
1914,10,25,45,45,0,1914-10-25,45
1914,10,26,49,39,10,1914-10-26,29
1914,10,27,106,106,0,1914-10-27,106
1914,10,28,122,122,0,1914-10-28,122
1914,10,29,119,119,0,1914-10-29,119
1914,10,30,76,76,0,1914-10-30,76
1914,10,31,42,42,0,1914-10-31,42
1914,11,1,137,137,0,1914-11-1,137
1914,11,2,237,194,43,1914-11-2,151
1914,11,3,174,108,66,1914-11-3,42
1914,11,4,66,0,66,1914-11-4,-66
1914,11,5,84,0,84,1914-11-5,-84
1914,11,6,111,4,107,1914-11-6,-103
1914,11,7,248,199,49,1914-11-7,150
1914,11,8,312,294,18,1914-11-8,276
1914,11,9,373,352,21,1914-11-9,331
1914,11,10,362,328,34,1914-11-10,294
1914,11,11,228,221,7,1914-11-11,214
1914,11,12,135,135,0,1914-11-12,135
1914,11,13,216,146,70,1914-11-13,76
1914,11,14,156,129,27,1914-11-14,102
1914,11,15,148,128,20,1914-11-15,108
1914,11,16,0,0,0,1914-11-16,0
1914,11,17,0,0,0,1914-11-17,0
1914,11,18,216,211,5,1914-11-18,206
1914,11,19,194,192,2,1914-11-19,190
1914,11,20,148,144,4,1914-11-20,140
1914,11,21,200,197,3,1914-11-21,194
1914,11,22,232,228,4,1914-11-22,224
1914,11,23,95,95,0,1914-11-23,95
1914,11,24,254,254,0,1914-11-24,254
1914,11,25,147,147,0,1914-11-25,147
1914,11,26,73,73,0,1914-11-26,73
1914,11,27,86,13,73,1914-11-27,-60
1914,11,28,304,7,297,1914-11-28,-290
1914,11,29,835,206,629,1914-11-29,-423
1914,11,30,888,183,705,1914-11-30,-522
1914,12,1,676,190,486,1914-12-1,-296
1914,12,2,680,165,515,1914-12-2,-350
1914,12,3,597,224,373,1914-12-3,-149
1914,12,4,892,597,295,1914-12-4,302
1914,12,5,799,555,244,1914-12-5,311
1914,12,6,648,438,210,1914-12-6,228
1914,12,7,468,303,165,1914-12-7,138
1914,12,8,444,278,166,1914-12-8,112
1914,12,9,472,238,234,1914-12-9,4
1914,12,10,186,138,48,1914-12-10,90
1914,12,11,247,62,185,1914-12-11,-123
1914,12,12,381,57,324,1914-12-12,-267
1914,12,13,323,28,295,1914-12-13,-267
1914,12,14,354,22,332,1914-12-14,-310
1914,12,15,263,54,209,1914-12-15,-155
1914,12,16,232,0,232,1914-12-16,-232
1914,12,17,250,37,213,1914-12-17,-176
1914,12,18,236,46,190,1914-12-18,-144
1914,12,19,169,81,88,1914-12-19,-7
1914,12,20,82,65,17,1914-12-20,48
1914,12,21,39,39,0,1914-12-21,39
1914,12,22,42,42,0,1914-12-22,42
1914,12,23,24,24,0,1914-12-23,24
1914,12,24,18,11,7,1914-12-24,4
1914,12,25,115,5,110,1914-12-25,-105
1914,12,26,70,11,59,1914-12-26,-48
1914,12,27,74,0,74,1914-12-27,-74
1914,12,28,42,0,42,1914-12-28,-42
1914,12,29,34,0,34,1914-12-29,-34
1914,12,30,124,54,70,1914-12-30,-16
1914,12,31,149,106,43,1914-12-31,63
1915,1,1,135,88,47,1915-1-1,41
1915,1,2,311,274,37,1915-1-2,237
1915,1,3,521,508,13,1915-1-3,495
1915,1,4,715,698,17,1915-1-4,681
1915,1,5,868,855,13,1915-1-5,842
1915,1,6,750,739,11,1915-1-6,728
1915,1,7,762,762,0,1915-1-7,762
1915,1,8,593,593,0,1915-1-8,593
1915,1,9,561,561,0,1915-1-9,561
1915,1,10,527,527,0,1915-1-10,527
1915,1,11,539,539,0,1915-1-11,539
1915,1,12,426,401,25,1915-1-12,376
1915,1,13,115,77,38,1915-1-13,39
1915,1,14,209,120,89,1915-1-14,31
1915,1,15,379,276,103,1915-1-15,173
1915,1,16,532,291,241,1915-1-16,50
1915,1,17,287,256,31,1915-1-17,225
1915,1,18,233,233,0,1915-1-18,233
1915,1,19,191,179,12,1915-1-19,167
1915,1,20,147,147,0,1915-1-20,147
1915,1,21,52,52,0,1915-1-21,52
1915,1,22,64,64,0,1915-1-22,64
1915,1,23,63,63,0,1915-1-23,63
1915,1,24,16,16,0,1915-1-24,16
1915,1,25,21,12,9,1915-1-25,3
1915,1,26,5,5,0,1915-1-26,5
1915,1,27,11,11,0,1915-1-27,11
1915,1,28,60,60,0,1915-1-28,60
1915,1,29,90,90,0,1915-1-29,90
1915,1,30,7,0,7,1915-1-30,-7
1915,1,31,188,0,188,1915-1-31,-188
1915,2,1,164,0,164,1915-2-1,-164
1915,2,2,271,5,266,1915-2-2,-261
1915,2,3,276,12,264,1915-2-3,-252
1915,2,4,311,74,237,1915-2-4,-163
1915,2,5,580,91,489,1915-2-5,-398
1915,2,6,542,93,449,1915-2-6,-356
1915,2,7,738,70,668,1915-2-7,-598
1915,2,8,974,462,512,1915-2-8,-50
1915,2,9,1218,732,486,1915-2-9,246
1915,2,10,1455,1027,428,1915-2-10,599
1915,2,11,1507,1077,430,1915-2-11,647
1915,2,12,1362,1001,361,1915-2-12,640
1915,2,13,1193,607,586,1915-2-13,21
1915,2,14,700,559,141,1915-2-14,418
1915,2,15,684,514,170,1915-2-15,344
1915,2,16,629,500,129,1915-2-16,371
1915,2,17,590,473,117,1915-2-17,356
1915,2,18,636,472,164,1915-2-18,308
1915,2,19,455,455,0,1915-2-19,455
1915,2,20,281,273,8,1915-2-20,265
1915,2,21,154,121,33,1915-2-21,88
1915,2,22,145,102,43,1915-2-22,59
1915,2,23,219,30,189,1915-2-23,-159
1915,2,24,519,14,505,1915-2-24,-491
1915,2,25,594,32,562,1915-2-25,-530
1915,2,26,786,20,766,1915-2-26,-746
1915,2,27,794,118,676,1915-2-27,-558
1915,2,28,999,249,750,1915-2-28,-501
1915,3,1,860,154,706,1915-3-1,-552
1915,3,2,795,115,680,1915-3-2,-565
1915,3,3,835,102,733,1915-3-3,-631
1915,3,4,636,73,563,1915-3-4,-490
1915,3,5,776,260,516,1915-3-5,-256
1915,3,6,782,374,408,1915-3-6,-34
1915,3,7,809,457,352,1915-3-7,105
1915,3,8,835,551,284,1915-3-8,267
1915,3,9,756,504,252,1915-3-9,252
1915,3,10,670,472,198,1915-3-10,274
1915,3,11,481,382,99,1915-3-11,283
1915,3,12,320,320,0,1915-3-12,320
1915,3,13,239,239,0,1915-3-13,239
1915,3,14,236,203,33,1915-3-14,170
1915,3,15,319,203,116,1915-3-15,87
1915,3,16,221,178,43,1915-3-16,135
1915,3,17,321,182,139,1915-3-17,43
1915,3,18,397,193,204,1915-3-18,-11
1915,3,19,347,197,150,1915-3-19,47
1915,3,20,202,92,110,1915-3-20,-18
1915,3,21,94,94,0,1915-3-21,94
1915,3,22,167,167,0,1915-3-22,167
1915,3,23,130,130,0,1915-3-23,130
1915,3,24,122,122,0,1915-3-24,122
1915,3,25,128,117,11,1915-3-25,106
1915,3,26,122,111,11,1915-3-26,100
1915,3,27,132,120,12,1915-3-27,108
1915,3,28,109,109,0,1915-3-28,109
1915,3,29,171,153,18,1915-3-29,135
1915,3,30,1422,1330,92,1915-3-30,1238
1915,3,31,1542,1502,40,1915-3-31,1462
1915,4,1,1648,1582,66,1915-4-1,1516
1915,4,2,1748,1555,193,1915-4-2,1362
1915,4,3,2277,2032,245,1915-4-3,1787
1915,4,4,2298,2088,210,1915-4-4,1878
1915,4,5,2445,2182,263,1915-4-5,1919
1915,4,6,2109,1890,219,1915-4-6,1671
1915,4,7,2158,1992,166,1915-4-7,1826
1915,4,8,2060,1906,154,1915-4-8,1752
1915,4,9,1872,1712,160,1915-4-9,1552
1915,4,10,1855,1683,172,1915-4-10,1511
1915,4,11,836,619,217,1915-4-11,402
1915,4,12,322,119,203,1915-4-12,-84
1915,4,13,245,31,214,1915-4-13,-183
1915,4,14,39,39,0,1915-4-14,39
1915,4,15,36,6,30,1915-4-15,-24
1915,4,16,173,0,173,1915-4-16,-173
1915,4,17,0,0,0,1915-4-17,0
1915,4,18,16,0,16,1915-4-18,-16
1915,4,19,87,26,61,1915-4-19,-35
1915,4,20,73,0,73,1915-4-20,-73
1915,4,21,459,7,452,1915-4-21,-445
1915,4,22,479,0,479,1915-4-22,-479
1915,4,23,440,8,432,1915-4-23,-424
1915,4,24,316,2,314,1915-4-24,-312
1915,4,25,237,0,237,1915-4-25,-237
1915,4,26,862,597,265,1915-4-26,332
1915,4,27,853,542,311,1915-4-27,231
1915,4,28,1036,660,376,1915-4-28,284
1915,4,29,914,610,304,1915-4-29,306
1915,4,30,1055,737,318,1915-4-30,419
1915,5,1,1023,750,273,1915-5-1,477
1915,5,2,988,728,260,1915-5-2,468
1915,5,3,1051,780,271,1915-5-3,509
1915,5,4,1095,813,282,1915-5-4,531
1915,5,5,1131,876,255,1915-5-5,621
1915,5,6,1313,1045,268,1915-5-6,777
1915,5,7,879,658,221,1915-5-7,437
1915,5,8,470,337,133,1915-5-8,204
1915,5,9,65,53,12,1915-5-9,41
1915,5,10,23,23,0,1915-5-10,23
1915,5,11,0,0,0,1915-5-11,0
1915,5,12,0,0,0,1915-5-12,0
1915,5,13,0,0,0,1915-5-13,0
1915,5,14,14,14,0,1915-5-14,14
1915,5,15,6,6,0,1915-5-15,6
1915,5,16,21,21,0,1915-5-16,21
1915,5,17,0,0,0,1915-5-17,0
1915,5,18,17,17,0,1915-5-18,17
1915,5,19,0,0,0,1915-5-19,0
1915,5,20,218,210,8,1915-5-20,202
1915,5,21,281,281,0,1915-5-21,281
1915,5,22,959,959,0,1915-5-22,959
1915,5,23,832,832,0,1915-5-23,832
1915,5,24,919,898,21,1915-5-24,877
1915,5,25,812,801,11,1915-5-25,790
1915,5,26,860,860,0,1915-5-26,860
1915,5,27,787,787,0,1915-5-27,787
1915,5,28,680,680,0,1915-5-28,680
1915,5,29,728,728,0,1915-5-29,728
1915,5,30,700,700,0,1915-5-30,700
1915,5,31,506,506,0,1915-5-31,506
1915,6,1,433,433,0,1915-6-1,433
1915,6,2,509,434,75,1915-6-2,359
1915,6,3,649,475,174,1915-6-3,301
1915,6,4,18,18,0,1915-6-4,18
1915,6,5,48,48,0,1915-6-5,48
1915,6,6,48,48,0,1915-6-6,48
1915,6,7,39,39,0,1915-6-7,39
1915,6,8,66,66,0,1915-6-8,66
1915,6,9,18,14,4,1915-6-9,10
1915,6,10,38,38,0,1915-6-10,38
1915,6,11,5,5,0,1915-6-11,5
1915,6,12,142,139,3,1915-6-12,136
1915,6,13,384,208,176,1915-6-13,32
1915,6,14,704,457,247,1915-6-14,210
1915,6,15,858,497,361,1915-6-15,136
1915,6,16,1007,632,375,1915-6-16,257
1915,6,17,1276,760,516,1915-6-17,244
1915,6,18,1631,886,745,1915-6-18,141
1915,6,19,1911,962,949,1915-6-19,13
1915,6,20,2388,1255,1133,1915-6-20,122
1915,6,21,2756,1605,1151,1915-6-21,454
1915,6,22,2747,1630,1117,1915-6-22,513
1915,6,23,2423,1479,944,1915-6-23,535
1915,6,24,2178,1191,987,1915-6-24,204
1915,6,25,1795,1076,719,1915-6-25,357
1915,6,26,2051,1281,770,1915-6-26,511
1915,6,27,905,248,657,1915-6-27,-409
1915,6,28,650,91,559,1915-6-28,-468
1915,6,29,599,127,472,1915-6-29,-345
1915,6,30,794,168,626,1915-6-30,-458
1915,7,1,704,158,546,1915-7-1,-388
1915,7,2,378,87,291,1915-7-2,-204
1915,7,3,208,35,173,1915-7-3,-138
1915,7,4,80,26,54,1915-7-4,-28
1915,7,5,627,3,624,1915-7-5,-621
1915,7,6,1284,0,1284,1915-7-6,-1284
1915,7,7,1342,1,1341,1915-7-7,-1340
1915,7,8,1407,52,1355,1915-7-8,-1303
1915,7,9,1350,0,1350,1915-7-9,-1350
1915,7,10,1465,0,1465,1915-7-10,-1465
1915,7,11,1802,266,1536,1915-7-11,-1270
1915,7,12,1604,335,1269,1915-7-12,-934
1915,7,13,1634,349,1285,1915-7-13,-936
1915,7,14,1211,333,878,1915-7-14,-545
1915,7,15,1066,316,750,1915-7-15,-434
1915,7,16,1107,474,633,1915-7-16,-159
1915,7,17,1023,485,538,1915-7-17,-53
1915,7,18,444,406,38,1915-7-18,368
1915,7,19,591,366,225,1915-7-19,141
1915,7,20,1114,395,719,1915-7-20,-324
1915,7,21,1571,342,1229,1915-7-21,-887
1915,7,22,2002,303,1699,1915-7-22,-1396
1915,7,23,1723,327,1396,1915-7-23,-1069
1915,7,24,1689,125,1564,1915-7-24,-1439
1915,7,25,1733,177,1556,1915-7-25,-1379
1915,7,26,1877,307,1570,1915-7-26,-1263
1915,7,27,1622,423,1199,1915-7-27,-776
1915,7,28,1536,424,1112,1915-7-28,-688
1915,7,29,1937,436,1501,1915-7-29,-1065
1915,7,30,2280,440,1840,1915-7-30,-1400
1915,7,31,2133,312,1821,1915-7-31,-1509
1915,8,1,2062,277,1785,1915-8-1,-1508
1915,8,2,2148,245,1903,1915-8-2,-1658
1915,8,3,1911,201,1710,1915-8-3,-1509
1915,8,4,1506,145,1361,1915-8-4,-1216
1915,8,5,1621,150,1471,1915-8-5,-1321
1915,8,6,1309,110,1199,1915-8-6,-1089
1915,8,7,1197,258,939,1915-8-7,-681
1915,8,8,640,136,504,1915-8-8,-368
1915,8,9,561,175,386,1915-8-9,-211
1915,8,10,217,134,83,1915-8-10,51
1915,8,11,163,142,21,1915-8-11,121
1915,8,12,183,116,67,1915-8-12,49
1915,8,13,272,120,152,1915-8-13,-32
1915,8,14,192,104,88,1915-8-14,16
1915,8,15,405,98,307,1915-8-15,-209
1915,8,16,406,153,253,1915-8-16,-100
1915,8,17,477,185,292,1915-8-17,-107
1915,8,18,633,295,338,1915-8-18,-43
1915,8,19,823,372,451,1915-8-19,-79
1915,8,20,784,221,563,1915-8-20,-342
1915,8,21,786,187,599,1915-8-21,-412
1915,8,22,834,219,615,1915-8-22,-396
1915,8,23,820,370,450,1915-8-23,-80
1915,8,24,1190,612,578,1915-8-24,34
1915,8,25,1187,754,433,1915-8-25,321
1915,8,26,1106,666,440,1915-8-26,226
1915,8,27,686,584,102,1915-8-27,482
1915,8,28,1225,1113,112,1915-8-28,1001
1915,8,29,1241,1107,134,1915-8-29,973
1915,8,30,1405,922,483,1915-8-30,439
1915,8,31,1343,871,472,1915-8-31,399
1915,9,1,1386,868,518,1915-9-1,350
1915,9,2,1512,963,549,1915-9-2,414
1915,9,3,1175,608,567,1915-9-3,41
1915,9,4,1064,470,594,1915-9-4,-124
1915,9,5,847,359,488,1915-9-5,-129
1915,9,6,734,298,436,1915-9-6,-138
1915,9,7,808,237,571,1915-9-7,-334
1915,9,8,796,173,623,1915-9-8,-450
1915,9,9,711,132,579,1915-9-9,-447
1915,9,10,734,88,646,1915-9-10,-558
1915,9,11,358,30,328,1915-9-11,-298
1915,9,12,293,41,252,1915-9-12,-211
1915,9,13,180,26,154,1915-9-13,-128
1915,9,14,236,59,177,1915-9-14,-118
1915,9,15,147,24,123,1915-9-15,-99
1915,9,16,95,90,5,1915-9-16,85
1915,9,17,262,262,0,1915-9-17,262
1915,9,18,358,358,0,1915-9-18,358
1915,9,19,355,355,0,1915-9-19,355
1915,9,20,430,430,0,1915-9-20,430
1915,9,21,1209,1209,0,1915-9-21,1209
1915,9,22,1066,1066,0,1915-9-22,1066
1915,9,23,1023,1023,0,1915-9-23,1023
1915,9,24,943,943,0,1915-9-24,943
1915,9,25,1055,1055,0,1915-9-25,1055
1915,9,26,1130,935,195,1915-9-26,740
1915,9,27,923,718,205,1915-9-27,513
1915,9,28,961,801,160,1915-9-28,641
1915,9,29,878,733,145,1915-9-29,588
1915,9,30,830,702,128,1915-9-30,574
1915,10,1,754,614,140,1915-10-1,474
1915,10,2,687,518,169,1915-10-2,349
1915,10,3,135,0,135,1915-10-3,-135
1915,10,4,137,35,102,1915-10-4,-67
1915,10,5,139,43,96,1915-10-5,-53
1915,10,6,165,125,40,1915-10-6,85
1915,10,7,260,251,9,1915-10-7,242
1915,10,8,553,553,0,1915-10-8,553
1915,10,9,670,670,0,1915-10-9,670
1915,10,10,552,552,0,1915-10-10,552
1915,10,11,450,448,2,1915-10-11,446
1915,10,12,409,409,0,1915-10-12,409
1915,10,13,477,470,7,1915-10-13,463
1915,10,14,995,408,587,1915-10-14,-179
1915,10,15,859,406,453,1915-10-15,-47
1915,10,16,801,295,506,1915-10-16,-211
1915,10,17,1268,650,618,1915-10-17,32
1915,10,18,1431,807,624,1915-10-18,183
1915,10,19,1141,581,560,1915-10-19,21
1915,10,20,1040,433,607,1915-10-20,-174
1915,10,21,843,254,589,1915-10-21,-335
1915,10,22,725,154,571,1915-10-22,-417
1915,10,23,792,440,352,1915-10-23,88
1915,10,24,715,418,297,1915-10-24,121
1915,10,25,456,380,76,1915-10-25,304
1915,10,26,466,466,0,1915-10-26,466
1915,10,27,622,614,8,1915-10-27,606
1915,10,28,802,778,24,1915-10-28,754
1915,10,29,876,846,30,1915-10-29,816
1915,10,30,383,338,45,1915-10-30,293
1915,10,31,464,350,114,1915-10-31,236
1915,11,1,517,404,113,1915-11-1,291
1915,11,2,473,317,156,1915-11-2,161
1915,11,3,546,325,221,1915-11-3,104
1915,11,4,422,208,214,1915-11-4,-6
1915,11,5,314,69,245,1915-11-5,-176
1915,11,6,326,31,295,1915-11-6,-264
1915,11,7,325,109,216,1915-11-7,-107
1915,11,8,287,167,120,1915-11-8,47
1915,11,9,287,159,128,1915-11-9,31
1915,11,10,320,211,109,1915-11-10,102
1915,11,11,322,253,69,1915-11-11,184
1915,11,12,290,255,35,1915-11-12,220
1915,11,13,359,318,41,1915-11-13,277
1915,11,14,352,293,59,1915-11-14,234
1915,11,15,330,289,41,1915-11-15,248
1915,11,16,355,335,20,1915-11-16,315
1915,11,17,313,277,36,1915-11-17,241
1915,11,18,468,149,319,1915-11-18,-170
1915,11,19,592,111,481,1915-11-19,-370
1915,11,20,683,79,604,1915-11-20,-525
1915,11,21,719,111,608,1915-11-21,-497
1915,11,22,770,261,509,1915-11-22,-248
1915,11,23,883,317,566,1915-11-23,-249
1915,11,24,732,508,224,1915-11-24,284
1915,11,25,657,413,244,1915-11-25,169
1915,11,26,288,37,251,1915-11-26,-214
1915,11,27,291,19,272,1915-11-27,-253
1915,11,28,273,2,271,1915-11-28,-269
1915,11,29,345,0,345,1915-11-29,-345
1915,11,30,508,0,508,1915-11-30,-508
1915,12,1,155,14,141,1915-12-1,-127
1915,12,2,135,73,62,1915-12-2,11
1915,12,3,158,101,57,1915-12-3,44
1915,12,4,112,87,25,1915-12-4,62
1915,12,5,92,40,52,1915-12-5,-12
1915,12,6,131,50,81,1915-12-6,-31
1915,12,7,130,48,82,1915-12-7,-34
1915,12,8,278,38,240,1915-12-8,-202
1915,12,9,276,43,233,1915-12-9,-190
1915,12,10,416,123,293,1915-12-10,-170
1915,12,11,394,109,285,1915-12-11,-176
1915,12,12,348,120,228,1915-12-12,-108
1915,12,13,387,114,273,1915-12-13,-159
1915,12,14,356,107,249,1915-12-14,-142
1915,12,15,428,135,293,1915-12-15,-158
1915,12,16,402,157,245,1915-12-16,-88
1915,12,17,445,238,207,1915-12-17,31
1915,12,18,504,317,187,1915-12-18,130
1915,12,19,657,423,234,1915-12-19,189
1915,12,20,1036,787,249,1915-12-20,538
1915,12,21,941,815,126,1915-12-21,689
1915,12,22,177,131,46,1915-12-22,85
1915,12,23,40,0,40,1915-12-23,-40
1915,12,24,46,7,39,1915-12-24,-32
1915,12,25,49,0,49,1915-12-25,-49
1915,12,26,201,9,192,1915-12-26,-183
1915,12,27,359,0,359,1915-12-27,-359
1915,12,28,362,0,362,1915-12-28,-362
1915,12,29,433,35,398,1915-12-29,-363
1915,12,30,808,435,373,1915-12-30,62
1915,12,31,859,559,300,1915-12-31,259
1916,1,1,834,520,314,1916-1-1,206
1916,1,2,698,381,317,1916-1-2,64
1916,1,3,696,362,334,1916-1-3,28
1916,1,4,1066,477,589,1916-1-4,-112
1916,1,5,1063,324,739,1916-1-5,-415
1916,1,6,1391,522,869,1916-1-6,-347
1916,1,7,1092,383,709,1916-1-7,-326
1916,1,8,824,300,524,1916-1-8,-224
1916,1,9,567,267,300,1916-1-9,-33
1916,1,10,531,252,279,1916-1-10,-27
1916,1,11,484,263,221,1916-1-11,42
1916,1,12,382,216,166,1916-1-12,50
1916,1,13,325,206,119,1916-1-13,87
1916,1,14,334,224,110,1916-1-14,114
1916,1,15,326,240,86,1916-1-15,154
1916,1,16,343,223,120,1916-1-16,103
1916,1,17,295,269,26,1916-1-17,243
1916,1,18,234,208,26,1916-1-18,182
1916,1,19,100,82,18,1916-1-19,64
1916,1,20,113,102,11,1916-1-20,91
1916,1,21,308,284,24,1916-1-21,260
1916,1,22,369,356,13,1916-1-22,343
1916,1,23,618,618,0,1916-1-23,618
1916,1,24,350,350,0,1916-1-24,350
1916,1,25,351,349,2,1916-1-25,347
1916,1,26,363,355,8,1916-1-26,347
1916,1,27,401,378,23,1916-1-27,355
1916,1,28,359,345,14,1916-1-28,331
1916,1,29,335,335,0,1916-1-29,335
1916,1,30,307,297,10,1916-1-30,287
1916,1,31,338,290,48,1916-1-31,242
1916,2,1,861,259,602,1916-2-1,-343
1916,2,2,1051,294,757,1916-2-2,-463
1916,2,3,967,220,747,1916-2-3,-527
1916,2,4,822,200,622,1916-2-4,-422
1916,2,5,683,157,526,1916-2-5,-369
1916,2,6,904,122,782,1916-2-6,-660
1916,2,7,1014,191,823,1916-2-7,-632
1916,2,8,1551,577,974,1916-2-8,-397
1916,2,9,1906,594,1312,1916-2-9,-718
1916,2,10,1551,557,994,1916-2-10,-437
1916,2,11,1442,549,893,1916-2-11,-344
1916,2,12,1051,558,493,1916-2-12,65
1916,2,13,639,571,68,1916-2-13,503
1916,2,14,628,593,35,1916-2-14,558
1916,2,15,449,439,10,1916-2-15,429
1916,2,16,482,451,31,1916-2-16,420
1916,2,17,294,271,23,1916-2-17,248
1916,2,18,266,208,58,1916-2-18,150
1916,2,19,298,38,260,1916-2-19,-222
1916,2,20,312,29,283,1916-2-20,-254
1916,2,21,346,20,326,1916-2-21,-306
1916,2,22,464,16,448,1916-2-22,-432
1916,2,23,521,0,521,1916-2-23,-521
1916,2,24,482,22,460,1916-2-24,-438
1916,2,25,296,15,281,1916-2-25,-266
1916,2,26,339,3,336,1916-2-26,-333
1916,2,27,380,6,374,1916-2-27,-368
1916,2,28,370,19,351,1916-2-28,-332
1916,2,29,296,10,286,1916-2-29,-276
1916,3,1,768,0,768,1916-3-1,-768
1916,3,2,976,47,929,1916-3-2,-882
1916,3,3,1105,183,922,1916-3-3,-739
1916,3,4,1537,334,1203,1916-3-4,-869
1916,3,5,1890,524,1366,1916-3-5,-842
1916,3,6,2060,680,1380,1916-3-6,-700
1916,3,7,1805,729,1076,1916-3-7,-347
1916,3,8,1147,534,613,1916-3-8,-79
1916,3,9,1092,509,583,1916-3-9,-74
1916,3,10,977,529,448,1916-3-10,81
1916,3,11,1072,536,536,1916-3-11,0
1916,3,12,1052,569,483,1916-3-12,86
1916,3,13,963,542,421,1916-3-13,121
1916,3,14,653,229,424,1916-3-14,-195
1916,3,15,66,45,21,1916-3-15,24
1916,3,16,148,104,44,1916-3-16,60
1916,3,17,175,93,82,1916-3-17,11
1916,3,18,287,116,171,1916-3-18,-55
1916,3,19,207,88,119,1916-3-19,-31
1916,3,20,359,235,124,1916-3-20,111
1916,3,21,581,402,179,1916-3-21,223
1916,3,22,935,762,173,1916-3-22,589
1916,3,23,1195,1103,92,1916-3-23,1011
1916,3,24,919,838,81,1916-3-24,757
1916,3,25,741,675,66,1916-3-25,609
1916,3,26,915,823,92,1916-3-26,731
1916,3,27,840,786,54,1916-3-27,732
1916,3,28,948,848,100,1916-3-28,748
1916,3,29,979,895,84,1916-3-29,811
1916,3,30,1015,915,100,1916-3-30,815
1916,3,31,2072,1910,162,1916-3-31,1748
1916,4,1,2104,2004,100,1916-4-1,1904
1916,4,2,1975,1874,101,1916-4-2,1773
1916,4,3,1581,1482,99,1916-4-3,1383
1916,4,4,1525,1411,114,1916-4-4,1297
1916,4,5,1542,1213,329,1916-4-5,884
1916,4,6,1300,1251,49,1916-4-6,1202
1916,4,7,681,530,151,1916-4-7,379
1916,4,8,631,438,193,1916-4-8,245
1916,4,9,408,362,46,1916-4-9,316
1916,4,10,425,308,117,1916-4-10,191
1916,4,11,705,356,349,1916-4-11,7
1916,4,12,461,87,374,1916-4-12,-287
1916,4,13,431,129,302,1916-4-13,-173
1916,4,14,432,45,387,1916-4-14,-342
1916,4,15,465,25,440,1916-4-15,-415
1916,4,16,240,29,211,1916-4-16,-182
1916,4,17,268,60,208,1916-4-17,-148
1916,4,18,157,34,123,1916-4-18,-89
1916,4,19,128,49,79,1916-4-19,-30
1916,4,20,569,363,206,1916-4-20,157
1916,4,21,659,342,317,1916-4-21,25
1916,4,22,571,248,323,1916-4-22,-75
1916,4,23,757,224,533,1916-4-23,-309
1916,4,24,724,177,547,1916-4-24,-370
1916,4,25,670,175,495,1916-4-25,-320
1916,4,26,691,158,533,1916-4-26,-375
1916,4,27,635,159,476,1916-4-27,-317
1916,4,28,637,226,411,1916-4-28,-185
1916,4,29,1230,577,653,1916-4-29,-76
1916,4,30,1591,1057,534,1916-4-30,523
1916,5,1,1659,1194,465,1916-5-1,729
1916,5,2,1271,895,376,1916-5-2,519
1916,5,3,1297,996,301,1916-5-3,695
1916,5,4,1184,877,307,1916-5-4,570
1916,5,5,1121,839,282,1916-5-5,557
1916,5,6,1076,804,272,1916-5-6,532
1916,5,7,1000,719,281,1916-5-7,438
1916,5,8,1039,750,289,1916-5-8,461
1916,5,9,1108,713,395,1916-5-9,318
1916,5,10,884,569,315,1916-5-10,254
1916,5,11,855,473,382,1916-5-11,91
1916,5,12,626,353,273,1916-5-12,80
1916,5,13,179,33,146,1916-5-13,-113
1916,5,14,182,86,96,1916-5-14,-10
1916,5,15,170,83,87,1916-5-15,-4
1916,5,16,219,97,122,1916-5-16,-25
1916,5,17,151,105,46,1916-5-17,59
1916,5,18,117,77,40,1916-5-18,37
1916,5,19,157,115,42,1916-5-19,73
1916,5,20,158,131,27,1916-5-20,104
1916,5,21,565,488,77,1916-5-21,411
1916,5,22,1026,430,596,1916-5-22,-166
1916,5,23,1319,392,927,1916-5-23,-535
1916,5,24,1488,396,1092,1916-5-24,-696
1916,5,25,1663,243,1420,1916-5-25,-1177
1916,5,26,1920,396,1524,1916-5-26,-1128
1916,5,27,2348,395,1953,1916-5-27,-1558
1916,5,28,2225,368,1857,1916-5-28,-1489
1916,5,29,1928,287,1641,1916-5-29,-1354
1916,5,30,1644,230,1414,1916-5-30,-1184
1916,5,31,1593,242,1351,1916-5-31,-1109
1916,6,1,1015,217,798,1916-6-1,-581
1916,6,2,453,207,246,1916-6-2,-39
1916,6,3,361,361,0,1916-6-3,361
1916,6,4,593,589,4,1916-6-4,585
1916,6,5,1221,1217,4,1916-6-5,1213
1916,6,6,1248,1248,0,1916-6-6,1248
1916,6,7,1237,1208,29,1916-6-7,1179
1916,6,8,1497,1435,62,1916-6-8,1373
1916,6,9,429,395,34,1916-6-9,361
1916,6,10,419,370,49,1916-6-10,321
1916,6,11,369,363,6,1916-6-11,357
1916,6,12,412,412,0,1916-6-12,412
1916,6,13,516,493,23,1916-6-13,470
1916,6,14,521,497,24,1916-6-14,473
1916,6,15,522,514,8,1916-6-15,506
1916,6,16,1018,385,633,1916-6-16,-248
1916,6,17,1090,380,710,1916-6-17,-330
1916,6,18,1198,472,726,1916-6-18,-254
1916,6,19,-1,-1,-1,1916-6-19,0
1916,6,20,1253,651,602,1916-6-20,49
1916,6,21,1571,1072,499,1916-6-21,573
1916,6,22,2267,1716,551,1916-6-22,1165
1916,6,23,2580,1930,650,1916-6-23,1280
1916,6,24,2440,1757,683,1916-6-24,1074
1916,6,25,2273,1625,648,1916-6-25,977
1916,6,26,1921,1300,621,1916-6-26,679
1916,6,27,1771,1162,609,1916-6-27,553
1916,6,28,1392,1066,326,1916-6-28,740
1916,6,29,1201,872,329,1916-6-29,543
1916,6,30,761,580,181,1916-6-30,399
1916,7,1,444,380,64,1916-7-1,316
1916,7,2,357,258,99,1916-7-2,159
1916,7,3,329,202,127,1916-7-3,75
1916,7,4,146,35,111,1916-7-4,-76
1916,7,5,289,131,158,1916-7-5,-27
1916,7,6,211,137,74,1916-7-6,63
1916,7,7,487,347,140,1916-7-7,207
1916,7,8,454,348,106,1916-7-8,242
1916,7,9,345,304,41,1916-7-9,263
1916,7,10,284,284,0,1916-7-10,284
1916,7,11,257,257,0,1916-7-11,257
1916,7,12,259,259,0,1916-7-12,259
1916,7,13,240,240,0,1916-7-13,240
1916,7,14,386,385,1,1916-7-14,384
1916,7,15,349,349,0,1916-7-15,349
1916,7,16,336,336,0,1916-7-16,336
1916,7,17,341,341,0,1916-7-17,341
1916,7,18,383,375,8,1916-7-18,367
1916,7,19,437,437,0,1916-7-19,437
1916,7,20,657,649,8,1916-7-20,641
1916,7,21,1208,1206,2,1916-7-21,1204
1916,7,22,1225,1225,0,1916-7-22,1225
1916,7,23,1283,1283,0,1916-7-23,1283
1916,7,24,1304,1280,24,1916-7-24,1256
1916,7,25,1376,1376,0,1916-7-25,1376
1916,7,26,1089,1077,12,1916-7-26,1065
1916,7,27,1138,1138,0,1916-7-27,1138
1916,7,28,752,752,0,1916-7-28,752
1916,7,29,631,631,0,1916-7-29,631
1916,7,30,474,474,0,1916-7-30,474
1916,7,31,276,249,27,1916-7-31,222
1916,8,1,273,238,35,1916-8-1,203
1916,8,2,112,106,6,1916-8-2,100
1916,8,3,171,156,15,1916-8-3,141
1916,8,4,108,103,5,1916-8-4,98
1916,8,5,139,139,0,1916-8-5,139
1916,8,6,206,170,36,1916-8-6,134
1916,8,7,218,178,40,1916-8-7,138
1916,8,8,189,162,27,1916-8-8,135
1916,8,9,162,140,22,1916-8-9,118
1916,8,10,156,136,20,1916-8-10,116
1916,8,11,354,333,21,1916-8-11,312
1916,8,12,314,276,38,1916-8-12,238
1916,8,13,369,272,97,1916-8-13,175
1916,8,14,461,272,189,1916-8-14,83
1916,8,15,410,240,170,1916-8-15,70
1916,8,16,368,275,93,1916-8-16,182
1916,8,17,254,254,0,1916-8-17,254
1916,8,18,260,260,0,1916-8-18,260
1916,8,19,740,740,0,1916-8-19,740
1916,8,20,1369,1369,0,1916-8-20,1369
1916,8,21,1324,1324,0,1916-8-21,1324
1916,8,22,946,946,0,1916-8-22,946
1916,8,23,790,790,0,1916-8-23,790
1916,8,24,547,542,5,1916-8-24,537
1916,8,25,0,0,0,1916-8-25,0
1916,8,26,1,1,0,1916-8-26,1
1916,8,27,0,0,0,1916-8-27,0
1916,8,28,34,0,34,1916-8-28,-34
1916,8,29,153,34,119,1916-8-29,-85
1916,8,30,45,0,45,1916-8-30,-45
1916,8,31,33,17,16,1916-8-31,1
1916,9,1,9,3,6,1916-9-1,-3
1916,9,2,34,23,11,1916-9-2,12
1916,9,3,68,36,32,1916-9-3,4
1916,9,4,149,24,125,1916-9-4,-101
1916,9,5,166,10,156,1916-9-5,-146
1916,9,6,151,16,135,1916-9-6,-119
1916,9,7,515,442,73,1916-9-7,369
1916,9,8,1008,944,64,1916-9-8,880
1916,9,9,588,524,64,1916-9-9,460
1916,9,10,708,569,139,1916-9-10,430
1916,9,11,632,616,16,1916-9-11,600
1916,9,12,662,656,6,1916-9-12,650
1916,9,13,811,806,5,1916-9-13,801
1916,9,14,994,707,287,1916-9-14,420
1916,9,15,991,758,233,1916-9-15,525
1916,9,16,776,541,235,1916-9-16,306
1916,9,17,868,705,163,1916-9-17,542
1916,9,18,715,531,184,1916-9-18,347
1916,9,19,905,751,154,1916-9-19,597
1916,9,20,916,791,125,1916-9-20,666
1916,9,21,1013,936,77,1916-9-21,859
1916,9,22,494,471,23,1916-9-22,448
1916,9,23,368,368,0,1916-9-23,368
1916,9,24,202,202,0,1916-9-24,202
1916,9,25,21,19,2,1916-9-25,17
1916,9,26,59,13,46,1916-9-26,-33
1916,9,27,52,14,38,1916-9-27,-24
1916,9,28,59,23,36,1916-9-28,-13
1916,9,29,34,7,27,1916-9-29,-20
1916,9,30,17,14,3,1916-9-30,11
1916,10,1,9,9,0,1916-10-1,9
1916,10,2,0,0,0,1916-10-2,0
1916,10,3,318,223,95,1916-10-3,128
1916,10,4,310,248,62,1916-10-4,186
1916,10,5,383,283,100,1916-10-5,183
1916,10,6,588,501,87,1916-10-6,414
1916,10,7,850,687,163,1916-10-7,524
1916,10,8,1240,1093,147,1916-10-8,946
1916,10,9,1500,1394,106,1916-10-9,1288
1916,10,10,1932,1837,95,1916-10-10,1742
1916,10,11,1859,1780,79,1916-10-11,1701
1916,10,12,1773,1667,106,1916-10-12,1561
1916,10,13,1759,1681,78,1916-10-13,1603
1916,10,14,1602,1579,23,1916-10-14,1556
1916,10,15,1572,1562,10,1916-10-15,1552
1916,10,16,1343,1218,125,1916-10-16,1093
1916,10,17,780,621,159,1916-10-17,462
1916,10,18,830,702,128,1916-10-18,574
1916,10,19,768,658,110,1916-10-19,548
1916,10,20,282,172,110,1916-10-20,62
1916,10,21,253,174,79,1916-10-21,95
1916,10,22,186,81,105,1916-10-22,-24
1916,10,23,92,49,43,1916-10-23,6
1916,10,24,59,30,29,1916-10-24,1
1916,10,25,63,11,52,1916-10-25,-41
1916,10,26,105,14,91,1916-10-26,-77
1916,10,27,205,0,205,1916-10-27,-205
1916,10,28,328,19,309,1916-10-28,-290
1916,10,29,432,92,340,1916-10-29,-248
1916,10,30,350,108,242,1916-10-30,-134
1916,10,31,610,319,291,1916-10-31,28
1916,11,1,497,271,226,1916-11-1,45
1916,11,2,627,425,202,1916-11-2,223
1916,11,3,843,626,217,1916-11-3,409
1916,11,4,1184,870,314,1916-11-4,556
1916,11,5,1378,1062,316,1916-11-5,746
1916,11,6,1489,1168,321,1916-11-6,847
1916,11,7,1063,818,245,1916-11-7,573
1916,11,8,922,797,125,1916-11-8,672
1916,11,9,868,760,108,1916-11-9,652
1916,11,10,643,598,45,1916-11-10,553
1916,11,11,586,554,32,1916-11-11,522
1916,11,12,572,512,60,1916-11-12,452
1916,11,13,676,442,234,1916-11-13,208
1916,11,14,480,280,200,1916-11-14,80
1916,11,15,279,86,193,1916-11-15,-107
1916,11,16,337,126,211,1916-11-16,-85
1916,11,17,473,237,236,1916-11-17,1
1916,11,18,281,105,176,1916-11-18,-71
1916,11,19,186,176,10,1916-11-19,166
1916,11,20,161,144,17,1916-11-20,127
1916,11,21,298,23,275,1916-11-21,-252
1916,11,22,561,50,511,1916-11-22,-461
1916,11,23,604,61,543,1916-11-23,-482
1916,11,24,525,53,472,1916-11-24,-419
1916,11,25,635,20,615,1916-11-25,-595
1916,11,26,638,164,474,1916-11-26,-310
1916,11,27,570,254,316,1916-11-27,-62
1916,11,28,419,233,186,1916-11-28,47
1916,11,29,598,287,311,1916-11-29,-24
1916,11,30,733,418,315,1916-11-30,103
1916,12,1,700,398,302,1916-12-1,96
1916,12,2,608,359,249,1916-12-2,110
1916,12,3,815,524,291,1916-12-3,233
1916,12,4,1236,681,555,1916-12-4,126
1916,12,5,1226,526,700,1916-12-5,-174
1916,12,6,957,452,505,1916-12-6,-53
1916,12,7,1095,777,318,1916-12-7,459
1916,12,8,970,868,102,1916-12-8,766
1916,12,9,984,940,44,1916-12-9,896
1916,12,10,648,605,43,1916-12-10,562
1916,12,11,369,351,18,1916-12-11,333
1916,12,12,371,328,43,1916-12-12,285
1916,12,13,404,391,13,1916-12-13,378
1916,12,14,296,296,0,1916-12-14,296
1916,12,15,193,80,113,1916-12-15,-33
1916,12,16,202,7,195,1916-12-16,-188
1916,12,17,217,24,193,1916-12-17,-169
1916,12,18,319,28,291,1916-12-18,-263
1916,12,19,354,20,334,1916-12-19,-314
1916,12,20,240,27,213,1916-12-20,-186
1916,12,21,129,0,129,1916-12-21,-129
1916,12,22,427,15,412,1916-12-22,-397
1916,12,23,484,105,379,1916-12-23,-274
1916,12,24,702,322,380,1916-12-24,-58
1916,12,25,739,340,399,1916-12-25,-59
1916,12,26,662,252,410,1916-12-26,-158
1916,12,27,719,237,482,1916-12-27,-245
1916,12,28,1518,1143,375,1916-12-28,768
1916,12,29,2239,1884,355,1916-12-29,1529
1916,12,30,2051,1744,307,1916-12-30,1437
1916,12,31,2746,2492,254,1916-12-31,2238
1917,1,1,2800,2521,279,1917-1-1,2242
1917,1,2,2422,2178,244,1917-1-2,1934
1917,1,3,2214,2043,171,1917-1-3,1872
1917,1,4,2011,2011,0,1917-1-4,2011
1917,1,5,1989,1989,0,1917-1-5,1989
1917,1,6,1731,1721,10,1917-1-6,1711
1917,1,7,1846,1821,25,1917-1-7,1796
1917,1,8,2138,2118,20,1917-1-8,2098
1917,1,9,2060,2056,4,1917-1-9,2052
1917,1,10,979,967,12,1917-1-10,955
1917,1,11,938,903,35,1917-1-11,868
1917,1,12,624,549,75,1917-1-12,474
1917,1,13,721,555,166,1917-1-13,389
1917,1,14,1045,903,142,1917-1-14,761
1917,1,15,631,401,230,1917-1-15,171
1917,1,16,500,302,198,1917-1-16,104
1917,1,17,501,292,209,1917-1-17,83
1917,1,18,449,236,213,1917-1-18,23
1917,1,19,400,173,227,1917-1-19,-54
1917,1,20,402,119,283,1917-1-20,-164
1917,1,21,438,264,174,1917-1-21,90
1917,1,22,375,224,151,1917-1-22,73
1917,1,23,529,401,128,1917-1-23,273
1917,1,24,414,252,162,1917-1-24,90
1917,1,25,452,311,141,1917-1-25,170
1917,1,26,489,331,158,1917-1-26,173
1917,1,27,640,360,280,1917-1-27,80
1917,1,28,621,385,236,1917-1-28,149
1917,1,29,631,520,111,1917-1-29,409
1917,1,30,804,727,77,1917-1-30,650
1917,1,31,626,612,14,1917-1-31,598
1917,2,1,485,469,16,1917-2-1,453
1917,2,2,341,297,44,1917-2-2,253
1917,2,3,307,274,33,1917-2-3,241
1917,2,4,593,417,176,1917-2-4,241
1917,2,5,1110,645,465,1917-2-5,180
1917,2,6,1749,610,1139,1917-2-6,-529
1917,2,7,2452,440,2012,1917-2-7,-1572
1917,2,8,2858,336,2522,1917-2-8,-2186
1917,2,9,2759,239,2520,1917-2-9,-2281
1917,2,10,3339,304,3035,1917-2-10,-2731
1917,2,11,3802,277,3525,1917-2-11,-3248
1917,2,12,3580,214,3366,1917-2-12,-3152
1917,2,13,3844,226,3618,1917-2-13,-3392
1917,2,14,3776,44,3732,1917-2-14,-3688
1917,2,15,3320,17,3303,1917-2-15,-3286
1917,2,16,1201,0,1201,1917-2-16,-1201
1917,2,17,775,4,771,1917-2-17,-767
1917,2,18,612,0,612,1917-2-18,-612
1917,2,19,486,0,486,1917-2-19,-486
1917,2,20,413,15,398,1917-2-20,-383
1917,2,21,351,32,319,1917-2-21,-287
1917,2,22,219,18,201,1917-2-22,-183
1917,2,23,52,25,27,1917-2-23,-2
1917,2,24,210,168,42,1917-2-24,126
1917,2,25,211,161,50,1917-2-25,111
1917,2,26,248,154,94,1917-2-26,60
1917,2,27,252,170,82,1917-2-27,88
1917,2,28,285,212,73,1917-2-28,139
1917,3,1,286,194,92,1917-3-1,102
1917,3,2,621,238,383,1917-3-2,-145
1917,3,3,1391,506,885,1917-3-3,-379
1917,3,4,2012,1088,924,1917-3-4,164
1917,3,5,2315,1459,856,1917-3-5,603
1917,3,6,2735,1982,753,1917-3-6,1229
1917,3,7,2316,1679,637,1917-3-7,1042
1917,3,8,1953,1494,459,1917-3-8,1035
1917,3,9,1454,1000,454,1917-3-9,546
1917,3,10,1289,869,420,1917-3-10,449
1917,3,11,869,467,402,1917-3-11,65
1917,3,12,877,476,401,1917-3-12,75
1917,3,13,944,557,387,1917-3-13,170
1917,3,14,1078,751,327,1917-3-14,424
1917,3,15,691,511,180,1917-3-15,331
1917,3,16,1025,490,535,1917-3-16,-45
1917,3,17,1106,547,559,1917-3-17,-12
1917,3,18,760,241,519,1917-3-18,-278
1917,3,19,712,228,484,1917-3-19,-256
1917,3,20,742,411,331,1917-3-20,80
1917,3,21,741,401,340,1917-3-21,61
1917,3,22,874,528,346,1917-3-22,182
1917,3,23,967,673,294,1917-3-23,379
1917,3,24,1159,940,219,1917-3-24,721
1917,3,25,990,779,211,1917-3-25,568
1917,3,26,1170,1138,32,1917-3-26,1106
1917,3,27,944,927,17,1917-3-27,910
1917,3,28,905,878,27,1917-3-28,851
1917,3,29,892,892,0,1917-3-29,892
1917,3,30,902,882,20,1917-3-30,862
1917,3,31,1020,997,23,1917-3-31,974
1917,4,1,458,449,9,1917-4-1,440
1917,4,2,398,393,5,1917-4-2,388
1917,4,3,303,286,17,1917-4-3,269
1917,4,4,109,107,2,1917-4-4,105
1917,4,5,18,0,18,1917-4-5,-18
1917,4,6,32,18,14,1917-4-6,4
1917,4,7,28,25,3,1917-4-7,22
1917,4,8,7,7,0,1917-4-8,7
1917,4,9,156,47,109,1917-4-9,-62
1917,4,10,135,30,105,1917-4-10,-75
1917,4,11,606,495,111,1917-4-11,384
1917,4,12,1123,873,250,1917-4-12,623
1917,4,13,1646,1256,390,1917-4-13,866
1917,4,14,1903,1430,473,1917-4-14,957
1917,4,15,1887,1559,328,1917-4-15,1231
1917,4,16,1698,1412,286,1917-4-16,1126
1917,4,17,1449,1247,202,1917-4-17,1045
1917,4,18,1440,1226,214,1917-4-18,1012
1917,4,19,1430,1226,204,1917-4-19,1022
1917,4,20,1450,1372,78,1917-4-20,1294
1917,4,21,1146,1022,124,1917-4-21,898
1917,4,22,1077,965,112,1917-4-22,853
1917,4,23,637,549,88,1917-4-23,461
1917,4,24,1058,744,314,1917-4-24,430
1917,4,25,1071,672,399,1917-4-25,273
1917,4,26,1380,857,523,1917-4-26,334
1917,4,27,1463,796,667,1917-4-27,129
1917,4,28,1373,670,703,1917-4-28,-33
1917,4,29,996,83,913,1917-4-29,-830
1917,4,30,1113,65,1048,1917-4-30,-983
1917,5,1,1202,87,1115,1917-5-1,-1028
1917,5,2,1153,39,1114,1917-5-2,-1075
1917,5,3,992,51,941,1917-5-3,-890
1917,5,4,969,21,948,1917-5-4,-927
1917,5,5,1114,175,939,1917-5-5,-764
1917,5,6,1044,297,747,1917-5-6,-450
1917,5,7,1220,677,543,1917-5-7,134
1917,5,8,1075,688,387,1917-5-8,301
1917,5,9,1049,567,482,1917-5-9,85
1917,5,10,958,529,429,1917-5-10,100
1917,5,11,1142,617,525,1917-5-11,92
1917,5,12,962,554,408,1917-5-12,146
1917,5,13,945,592,353,1917-5-13,239
1917,5,14,1110,574,536,1917-5-14,38
1917,5,15,1287,703,584,1917-5-15,119
1917,5,16,1325,824,501,1917-5-16,323
1917,5,17,1411,983,428,1917-5-17,555
1917,5,18,1488,1157,331,1917-5-18,826
1917,5,19,1579,1291,288,1917-5-19,1003
1917,5,20,1187,948,239,1917-5-20,709
1917,5,21,1167,1035,132,1917-5-21,903
1917,5,22,1007,817,190,1917-5-22,627
1917,5,23,1314,899,415,1917-5-23,484
1917,5,24,1727,737,990,1917-5-24,-253
1917,5,25,2024,737,1287,1917-5-25,-550
1917,5,26,1878,418,1460,1917-5-26,-1042
1917,5,27,3173,430,2743,1917-5-27,-2313
1917,5,28,2542,236,2306,1917-5-28,-2070
1917,5,29,2321,211,2110,1917-5-29,-1899
1917,5,30,2161,201,1960,1917-5-30,-1759
1917,5,31,2297,209,2088,1917-5-31,-1879
1917,6,1,2036,134,1902,1917-6-1,-1768
1917,6,2,1931,130,1801,1917-6-2,-1671
1917,6,3,1679,191,1488,1917-6-3,-1297
1917,6,4,1649,261,1388,1917-6-4,-1127
1917,6,5,1124,147,977,1917-6-5,-830
1917,6,6,1030,165,865,1917-6-6,-700
1917,6,7,700,154,546,1917-6-7,-392
1917,6,8,1280,577,703,1917-6-8,-126
1917,6,9,1644,750,894,1917-6-9,-144
1917,6,10,1813,929,884,1917-6-10,45
1917,6,11,2098,1084,1014,1917-6-11,70
1917,6,12,1848,915,933,1917-6-12,-18
1917,6,13,1848,895,953,1917-6-13,-58
1917,6,14,1578,851,727,1917-6-14,124
1917,6,15,1419,757,662,1917-6-15,95
1917,6,16,1688,1118,570,1917-6-16,548
1917,6,17,2489,1989,500,1917-6-17,1489
1917,6,18,2213,1815,398,1917-6-18,1417
1917,6,19,2540,1846,694,1917-6-19,1152
1917,6,20,2429,1712,717,1917-6-20,995
1917,6,21,1754,1204,550,1917-6-21,654
1917,6,22,1662,1233,429,1917-6-22,804
1917,6,23,1997,1593,404,1917-6-23,1189
1917,6,24,1922,1549,373,1917-6-24,1176
1917,6,25,1652,1237,415,1917-6-25,822
1917,6,26,1751,1290,461,1917-6-26,829
1917,6,27,1510,1162,348,1917-6-27,814
1917,6,28,1580,1129,451,1917-6-28,678
1917,6,29,1420,954,466,1917-6-29,488
1917,6,30,1232,607,625,1917-6-30,-18
1917,7,1,899,341,558,1917-7-1,-217
1917,7,2,644,286,358,1917-7-2,-72
1917,7,3,1187,89,1098,1917-7-3,-1009
1917,7,4,1079,117,962,1917-7-4,-845
1917,7,5,1503,471,1032,1917-7-5,-561
1917,7,6,1428,579,849,1917-7-6,-270
1917,7,7,1048,438,610,1917-7-7,-172
1917,7,8,1984,1381,603,1917-7-8,778
1917,7,9,2238,1732,506,1917-7-9,1226
1917,7,10,2391,2094,297,1917-7-10,1797
1917,7,11,2346,2117,229,1917-7-11,1888
1917,7,12,2420,2295,125,1917-7-12,2170
1917,7,13,2679,2460,219,1917-7-13,2241
1917,7,14,2601,2375,226,1917-7-14,2149
1917,7,15,2164,1912,252,1917-7-15,1660
1917,7,16,1767,1578,189,1917-7-16,1389
1917,7,17,1900,1588,312,1917-7-17,1276
1917,7,18,1450,1283,167,1917-7-18,1116
1917,7,19,1175,1055,120,1917-7-19,935
1917,7,20,691,570,121,1917-7-20,449
1917,7,21,732,419,313,1917-7-21,106
1917,7,22,1125,538,587,1917-7-22,-49
1917,7,23,1389,786,603,1917-7-23,183
1917,7,24,1332,915,417,1917-7-24,498
1917,7,25,1772,1212,560,1917-7-25,652
1917,7,26,1523,1004,519,1917-7-26,485
1917,7,27,1174,661,513,1917-7-27,148
1917,7,28,1196,623,573,1917-7-28,50
1917,7,29,1418,615,803,1917-7-29,-188
1917,7,30,1466,628,838,1917-7-30,-210
1917,7,31,1454,635,819,1917-7-31,-184
1917,8,1,1401,579,822,1917-8-1,-243
1917,8,2,1223,453,770,1917-8-2,-317
1917,8,3,1801,1253,548,1917-8-3,705
1917,8,4,2609,2239,370,1917-8-4,1869
1917,8,5,3006,2585,421,1917-8-5,2164
1917,8,6,3702,3210,492,1917-8-6,2718
1917,8,7,4520,3857,663,1917-8-7,3194
1917,8,8,5111,4192,919,1917-8-8,3273
1917,8,9,5248,4047,1201,1917-8-9,2846
1917,8,10,5124,3909,1215,1917-8-10,2694
1917,8,11,4387,3270,1117,1917-8-11,2153
1917,8,12,5000,3753,1247,1917-8-12,2506
1917,8,13,5297,3642,1655,1917-8-13,1987
1917,8,14,5446,3712,1734,1917-8-14,1978
1917,8,15,4931,3585,1346,1917-8-15,2239
1917,8,16,4775,3538,1237,1917-8-16,2301
1917,8,17,3041,1770,1271,1917-8-17,499
1917,8,18,2876,1583,1293,1917-8-18,290
1917,8,19,2539,1192,1347,1917-8-19,-155
1917,8,20,2311,1074,1237,1917-8-20,-163
1917,8,21,2698,1059,1639,1917-8-21,-580
1917,8,22,2433,1155,1278,1917-8-22,-123
1917,8,23,2062,933,1129,1917-8-23,-196
1917,8,24,2093,808,1285,1917-8-24,-477
1917,8,25,1283,503,780,1917-8-25,-277
1917,8,26,1204,663,541,1917-8-26,122
1917,8,27,1195,680,515,1917-8-27,165
1917,8,28,1104,616,488,1917-8-28,128
1917,8,29,1020,503,517,1917-8-29,-14
1917,8,30,1369,232,1137,1917-8-30,-905
1917,8,31,1499,459,1040,1917-8-31,-581
1917,9,1,1726,617,1109,1917-9-1,-492
1917,9,2,1254,144,1110,1917-9-2,-966
1917,9,3,893,121,772,1917-9-3,-651
1917,9,4,1231,272,959,1917-9-4,-687
1917,9,5,1152,324,828,1917-9-5,-504
1917,9,6,674,237,437,1917-9-6,-200
1917,9,7,794,367,427,1917-9-7,-60
1917,9,8,556,194,362,1917-9-8,-168
1917,9,9,594,244,350,1917-9-9,-106
1917,9,10,568,237,331,1917-9-10,-94
1917,9,11,605,408,197,1917-9-11,211
1917,9,12,1171,944,227,1917-9-12,717
1917,9,13,1631,1145,486,1917-9-13,659
1917,9,14,1555,1012,543,1917-9-14,469
1917,9,15,1289,789,500,1917-9-15,289
1917,9,16,1894,1516,378,1917-9-16,1138
1917,9,17,2787,1975,812,1917-9-17,1163
1917,9,18,2953,2036,917,1917-9-18,1119
1917,9,19,2951,1904,1047,1917-9-19,857
1917,9,20,3260,1913,1347,1917-9-20,566
1917,9,21,3423,1921,1502,1917-9-21,419
1917,9,22,3537,2043,1494,1917-9-22,549
1917,9,23,3650,2030,1620,1917-9-23,410
1917,9,24,3395,1973,1422,1917-9-24,551
1917,9,25,3485,1795,1690,1917-9-25,105
1917,9,26,3088,1463,1625,1917-9-26,-162
1917,9,27,2715,1128,1587,1917-9-27,-459
1917,9,28,1683,945,738,1917-9-28,207
1917,9,29,1260,882,378,1917-9-29,504
1917,9,30,476,185,291,1917-9-30,-106
1917,10,1,537,166,371,1917-10-1,-205
1917,10,2,433,2,431,1917-10-2,-429
1917,10,3,480,0,480,1917-10-3,-480
1917,10,4,459,21,438,1917-10-4,-417
1917,10,5,579,31,548,1917-10-5,-517
1917,10,6,948,89,859,1917-10-6,-770
1917,10,7,1431,140,1291,1917-10-7,-1151
1917,10,8,417,336,81,1917-10-8,255
1917,10,9,352,300,52,1917-10-9,248
1917,10,10,299,251,48,1917-10-10,203
1917,10,11,499,366,133,1917-10-11,233
1917,10,12,325,279,46,1917-10-12,233
1917,10,13,693,205,488,1917-10-13,-283
1917,10,14,1200,706,494,1917-10-14,212
1917,10,15,945,514,431,1917-10-15,83
1917,10,16,994,518,476,1917-10-16,42
1917,10,17,1154,581,573,1917-10-17,8
1917,10,18,1258,631,627,1917-10-18,4
1917,10,19,1364,865,499,1917-10-19,366
1917,10,20,1271,875,396,1917-10-20,479
1917,10,21,1280,910,370,1917-10-21,540
1917,10,22,1749,937,812,1917-10-22,125
1917,10,23,2329,948,1381,1917-10-23,-433
1917,10,24,2195,889,1306,1917-10-24,-417
1917,10,25,2030,824,1206,1917-10-25,-382
1917,10,26,1674,655,1019,1917-10-26,-364
1917,10,27,930,62,868,1917-10-27,-806
1917,10,28,743,8,735,1917-10-28,-727
1917,10,29,682,2,680,1917-10-29,-678
1917,10,30,558,76,482,1917-10-30,-406
1917,10,31,525,285,240,1917-10-31,45
1917,11,1,504,297,207,1917-11-1,90
1917,11,2,877,255,622,1917-11-2,-367
1917,11,3,1107,343,764,1917-11-3,-421
1917,11,4,731,40,691,1917-11-4,-651
1917,11,5,857,173,684,1917-11-5,-511
1917,11,6,975,313,662,1917-11-6,-349
1917,11,7,1028,489,539,1917-11-7,-50
1917,11,8,1073,517,556,1917-11-8,-39
1917,11,9,1507,957,550,1917-11-9,407
1917,11,10,1500,958,542,1917-11-10,416
1917,11,11,1584,1167,417,1917-11-11,750
1917,11,12,767,501,266,1917-11-12,235
1917,11,13,568,346,222,1917-11-13,124
1917,11,14,708,524,184,1917-11-14,340
1917,11,15,850,654,196,1917-11-15,458
1917,11,16,1051,874,177,1917-11-16,697
1917,11,17,983,813,170,1917-11-17,643
1917,11,18,1243,926,317,1917-11-18,609
1917,11,19,1201,891,310,1917-11-19,581
1917,11,20,918,705,213,1917-11-20,492
1917,11,21,606,317,289,1917-11-21,28
1917,11,22,699,326,373,1917-11-22,-47
1917,11,23,351,46,305,1917-11-23,-259
1917,11,24,492,85,407,1917-11-24,-322
1917,11,25,650,99,551,1917-11-25,-452
1917,11,26,1149,260,889,1917-11-26,-629
1917,11,27,1337,321,1016,1917-11-27,-695
1917,11,28,1520,480,1040,1917-11-28,-560
1917,11,29,1917,539,1378,1917-11-29,-839
1917,11,30,2083,513,1570,1917-11-30,-1057
1917,12,1,2573,557,2016,1917-12-1,-1459
1917,12,2,2557,482,2075,1917-12-2,-1593
1917,12,3,2161,297,1864,1917-12-3,-1567
1917,12,4,1438,181,1257,1917-12-4,-1076
1917,12,5,1255,467,788,1917-12-5,-321
1917,12,6,574,486,88,1917-12-6,398
1917,12,7,631,563,68,1917-12-7,495
1917,12,8,728,584,144,1917-12-8,440
1917,12,9,781,645,136,1917-12-9,509
1917,12,10,774,655,119,1917-12-10,536
1917,12,11,1120,638,482,1917-12-11,156
1917,12,12,1694,986,708,1917-12-12,278
1917,12,13,2435,1718,717,1917-12-13,1001
1917,12,14,2989,2222,767,1917-12-14,1455
1917,12,15,3008,2523,485,1917-12-15,2038
1917,12,16,3143,2546,597,1917-12-16,1949
1917,12,17,3042,2318,724,1917-12-17,1594
1917,12,18,2349,1295,1054,1917-12-18,241
1917,12,19,2148,697,1451,1917-12-19,-754
1917,12,20,2286,743,1543,1917-12-20,-800
1917,12,21,2547,995,1552,1917-12-21,-557
1917,12,22,2514,1099,1415,1917-12-22,-316
1917,12,23,2377,1088,1289,1917-12-23,-201
1917,12,24,2997,1508,1489,1917-12-24,19
1917,12,25,3421,1703,1718,1917-12-25,-15
1917,12,26,3367,1729,1638,1917-12-26,91
1917,12,27,3816,2132,1684,1917-12-27,448
1917,12,28,3522,2038,1484,1917-12-28,554
1917,12,29,3399,2044,1355,1917-12-29,689
1917,12,30,3103,1804,1299,1917-12-30,505
1917,12,31,2461,1426,1035,1917-12-31,391
1918,1,1,2221,1583,638,1918-1-1,945
1918,1,2,1904,1325,579,1918-1-2,746
1918,1,3,1502,1029,473,1918-1-3,556
1918,1,4,1695,1167,528,1918-1-4,639
1918,1,5,1973,1483,490,1918-1-5,993
1918,1,6,1433,1401,32,1918-1-6,1369
1918,1,7,1437,1386,51,1918-1-7,1335
1918,1,8,1472,1300,172,1918-1-8,1128
1918,1,9,1432,1084,348,1918-1-9,736
1918,1,10,1267,918,349,1918-1-10,569
1918,1,11,1430,818,612,1918-1-11,206
1918,1,12,1396,934,462,1918-1-12,472
1918,1,13,1666,1164,502,1918-1-13,662
1918,1,14,2277,749,1528,1918-1-14,-779
1918,1,15,2988,975,2013,1918-1-15,-1038
1918,1,16,3359,1493,1866,1918-1-16,-373
1918,1,17,3054,1469,1585,1918-1-17,-116
1918,1,18,2277,823,1454,1918-1-18,-631
1918,1,19,1950,601,1349,1918-1-19,-748
1918,1,20,2082,573,1509,1918-1-20,-936
1918,1,21,1708,369,1339,1918-1-21,-970
1918,1,22,1715,408,1307,1918-1-22,-899
1918,1,23,1471,408,1063,1918-1-23,-655
1918,1,24,1654,336,1318,1918-1-24,-982
1918,1,25,1939,301,1638,1918-1-25,-1337
1918,1,26,2103,265,1838,1918-1-26,-1573
1918,1,27,1396,215,1181,1918-1-27,-966
1918,1,28,1628,369,1259,1918-1-28,-890
1918,1,29,1193,381,812,1918-1-29,-431
1918,1,30,1172,431,741,1918-1-30,-310
1918,1,31,925,426,499,1918-1-31,-73
1918,2,1,924,424,500,1918-2-1,-76
1918,2,2,839,384,455,1918-2-2,-71
1918,2,3,486,320,166,1918-2-3,154
1918,2,4,373,319,54,1918-2-4,265
1918,2,5,362,321,41,1918-2-5,280
1918,2,6,327,308,19,1918-2-6,289
1918,2,7,280,267,13,1918-2-7,254
1918,2,8,225,212,13,1918-2-8,199
1918,2,9,230,200,30,1918-2-9,170
1918,2,10,94,6,88,1918-2-10,-82
1918,2,11,852,571,281,1918-2-11,290
1918,2,12,1106,846,260,1918-2-12,586
1918,2,13,1433,986,447,1918-2-13,539
1918,2,14,1496,1088,408,1918-2-14,680
1918,2,15,1223,916,307,1918-2-15,609
1918,2,16,1313,1044,269,1918-2-16,775
1918,2,17,1452,1107,345,1918-2-17,762
1918,2,18,1257,935,322,1918-2-18,613
1918,2,19,999,802,197,1918-2-19,605
1918,2,20,905,658,247,1918-2-20,411
1918,2,21,918,660,258,1918-2-21,402
1918,2,22,1001,809,192,1918-2-22,617
1918,2,23,1059,881,178,1918-2-23,703
1918,2,24,582,468,114,1918-2-24,354
1918,2,25,694,599,95,1918-2-25,504
1918,2,26,814,643,171,1918-2-26,472
1918,2,27,588,443,145,1918-2-27,298
1918,2,28,578,405,173,1918-2-28,232
1918,3,1,503,358,145,1918-3-1,213
1918,3,2,393,305,88,1918-3-2,217
1918,3,3,361,240,121,1918-3-3,119
1918,3,4,456,216,240,1918-3-4,-24
1918,3,5,287,188,99,1918-3-5,89
1918,3,6,190,130,60,1918-3-6,70
1918,3,7,181,111,70,1918-3-7,41
1918,3,8,711,429,282,1918-3-8,147
1918,3,9,714,643,71,1918-3-9,572
1918,3,10,615,565,50,1918-3-10,515
1918,3,11,747,607,140,1918-3-11,467
1918,3,12,913,819,94,1918-3-12,725
1918,3,13,1364,1258,106,1918-3-13,1152
1918,3,14,1297,1253,44,1918-3-14,1209
1918,3,15,1426,1407,19,1918-3-15,1388
1918,3,16,1867,1862,5,1918-3-16,1857
1918,3,17,1761,1761,0,1918-3-17,1761
1918,3,18,1509,1484,25,1918-3-18,1459
1918,3,19,1623,1308,315,1918-3-19,993
1918,3,20,1391,915,476,1918-3-20,439
1918,3,21,411,88,323,1918-3-21,-235
1918,3,22,357,33,324,1918-3-22,-291
1918,3,23,643,18,625,1918-3-23,-607
1918,3,24,716,0,716,1918-3-24,-716
1918,3,25,938,33,905,1918-3-25,-872
1918,3,26,1077,44,1033,1918-3-26,-989
1918,3,27,891,29,862,1918-3-27,-833
1918,3,28,742,6,736,1918-3-28,-730
1918,3,29,519,5,514,1918-3-29,-509
1918,3,30,547,0,547,1918-3-30,-547
1918,3,31,1329,806,523,1918-3-31,283
1918,4,1,1444,907,537,1918-4-1,370
1918,4,2,1405,979,426,1918-4-2,553
1918,4,3,1539,1094,445,1918-4-3,649
1918,4,4,1632,1138,494,1918-4-4,644
1918,4,5,1564,1137,427,1918-4-5,710
1918,4,6,1608,1227,381,1918-4-6,846
1918,4,7,1693,1562,131,1918-4-7,1431
1918,4,8,1690,1569,121,1918-4-8,1448
1918,4,9,1489,1368,121,1918-4-9,1247
1918,4,10,1026,1026,0,1918-4-10,1026
1918,4,11,927,778,149,1918-4-11,629
1918,4,12,486,368,118,1918-4-12,250
1918,4,13,495,291,204,1918-4-13,87
1918,4,14,583,290,293,1918-4-14,-3
1918,4,15,545,282,263,1918-4-15,19
1918,4,16,482,274,208,1918-4-16,66
1918,4,17,339,161,178,1918-4-17,-17
1918,4,18,341,229,112,1918-4-18,117
1918,4,19,662,187,475,1918-4-19,-288
1918,4,20,582,97,485,1918-4-20,-388
1918,4,21,408,0,408,1918-4-21,-408
1918,4,22,605,0,605,1918-4-22,-605
1918,4,23,787,0,787,1918-4-23,-787
1918,4,24,796,2,794,1918-4-24,-792
1918,4,25,931,149,782,1918-4-25,-633
1918,4,26,996,264,732,1918-4-26,-468
1918,4,27,1109,356,753,1918-4-27,-397
1918,4,28,1057,410,647,1918-4-28,-237
1918,4,29,1057,354,703,1918-4-29,-349
1918,4,30,1105,321,784,1918-4-30,-463
1918,5,1,1032,361,671,1918-5-1,-310
1918,5,2,1630,995,635,1918-5-2,360
1918,5,3,2614,1842,772,1918-5-3,1070
1918,5,4,2350,1768,582,1918-5-4,1186
1918,5,5,2272,1782,490,1918-5-5,1292
1918,5,6,1579,1449,130,1918-5-6,1319
1918,5,7,1204,1070,134,1918-5-7,936
1918,5,8,1023,894,129,1918-5-8,765
1918,5,9,937,866,71,1918-5-9,795
1918,5,10,983,852,131,1918-5-10,721
1918,5,11,749,663,86,1918-5-11,577
1918,5,12,759,505,254,1918-5-12,251
1918,5,13,1002,515,487,1918-5-13,28
1918,5,14,908,562,346,1918-5-14,216
1918,5,15,686,437,249,1918-5-15,188
1918,5,16,318,73,245,1918-5-16,-172
1918,5,17,246,97,149,1918-5-17,-52
1918,5,18,257,141,116,1918-5-18,25
1918,5,19,176,81,95,1918-5-19,-14
1918,5,20,298,47,251,1918-5-20,-204
1918,5,21,334,117,217,1918-5-21,-100
1918,5,22,331,58,273,1918-5-22,-215
1918,5,23,267,29,238,1918-5-23,-209
1918,5,24,253,0,253,1918-5-24,-253
1918,5,25,324,11,313,1918-5-25,-302
1918,5,26,360,57,303,1918-5-26,-246
1918,5,27,652,11,641,1918-5-27,-630
1918,5,28,872,42,830,1918-5-28,-788
1918,5,29,1135,77,1058,1918-5-29,-981
1918,5,30,1771,457,1314,1918-5-30,-857
1918,5,31,2229,520,1709,1918-5-31,-1189
1918,6,1,2573,708,1865,1918-6-1,-1157
1918,6,2,1805,795,1010,1918-6-2,-215
1918,6,3,1992,997,995,1918-6-3,2
1918,6,4,1126,580,546,1918-6-4,34
1918,6,5,1000,576,424,1918-6-5,152
1918,6,6,1140,816,324,1918-6-6,492
1918,6,7,948,746,202,1918-6-7,544
1918,6,8,665,595,70,1918-6-8,525
1918,6,9,559,556,3,1918-6-9,553
1918,6,10,507,507,0,1918-6-10,507
1918,6,11,520,520,0,1918-6-11,520
1918,6,12,247,247,0,1918-6-12,247
1918,6,13,55,55,0,1918-6-13,55
1918,6,14,81,81,0,1918-6-14,81
1918,6,15,67,63,4,1918-6-15,59
1918,6,16,50,35,15,1918-6-16,20
1918,6,17,42,17,25,1918-6-17,-8
1918,6,18,82,33,49,1918-6-18,-16
1918,6,19,107,18,89,1918-6-19,-71
1918,6,20,212,18,194,1918-6-20,-176
1918,6,21,221,15,206,1918-6-21,-191
1918,6,22,277,32,245,1918-6-22,-213
1918,6,23,169,6,163,1918-6-23,-157
1918,6,24,183,0,183,1918-6-24,-183
1918,6,25,218,126,92,1918-6-25,34
1918,6,26,355,122,233,1918-6-26,-111
1918,6,27,226,195,31,1918-6-27,164
1918,6,28,594,535,59,1918-6-28,476
1918,6,29,456,439,17,1918-6-29,422
1918,6,30,549,520,29,1918-6-30,491
1918,7,1,786,738,48,1918-7-1,690
1918,7,2,933,919,14,1918-7-2,905
1918,7,3,1558,1253,305,1918-7-3,948
1918,7,4,1919,1560,359,1918-7-4,1201
1918,7,5,1910,1571,339,1918-7-5,1232
1918,7,6,1558,1258,300,1918-7-6,958
1918,7,7,1528,1263,265,1918-7-7,998
1918,7,8,1237,945,292,1918-7-8,653
1918,7,9,1118,724,394,1918-7-9,330
1918,7,10,1151,627,524,1918-7-10,103
1918,7,11,1063,549,514,1918-7-11,35
1918,7,12,925,420,505,1918-7-12,-85
1918,7,13,654,220,434,1918-7-13,-214
1918,7,14,470,97,373,1918-7-14,-276
1918,7,15,1141,528,613,1918-7-15,-85
1918,7,16,1421,544,877,1918-7-16,-333
1918,7,17,1633,531,1102,1918-7-17,-571
1918,7,18,1552,502,1050,1918-7-18,-548
1918,7,19,1371,614,757,1918-7-19,-143
1918,7,20,1145,842,303,1918-7-20,539
1918,7,21,1212,1028,184,1918-7-21,844
1918,7,22,1101,821,280,1918-7-22,541
1918,7,23,1203,840,363,1918-7-23,477
1918,7,24,1597,1038,559,1918-7-24,479
1918,7,25,1801,1280,521,1918-7-25,759
1918,7,26,1576,1175,401,1918-7-26,774
1918,7,27,1763,1466,297,1918-7-27,1169
1918,7,28,1490,1146,344,1918-7-28,802
1918,7,29,1451,1265,186,1918-7-29,1079
1918,7,30,807,620,187,1918-7-30,433
1918,7,31,653,553,100,1918-7-31,453
1918,8,1,1405,938,467,1918-8-1,471
1918,8,2,2044,1180,864,1918-8-2,316
1918,8,3,2619,1560,1059,1918-8-3,501
1918,8,4,3288,1832,1456,1918-8-4,376
1918,8,5,2962,1847,1115,1918-8-5,732
1918,8,6,1668,797,871,1918-8-6,-74
1918,8,7,847,283,564,1918-8-7,-281
1918,8,8,984,341,643,1918-8-8,-302
1918,8,9,833,285,548,1918-8-9,-263
1918,8,10,808,403,405,1918-8-10,-2
1918,8,11,1245,888,357,1918-8-11,531
1918,8,12,1498,957,541,1918-8-12,416
1918,8,13,1792,1137,655,1918-8-13,482
1918,8,14,1254,1007,247,1918-8-14,760
1918,8,15,1519,1263,256,1918-8-15,1007
1918,8,16,1505,1181,324,1918-8-16,857
1918,8,17,2021,1267,754,1918-8-17,513
1918,8,18,2483,1360,1123,1918-8-18,237
1918,8,19,2446,1390,1056,1918-8-19,334
1918,8,20,2855,2017,838,1918-8-20,1179
1918,8,21,3144,2288,856,1918-8-21,1432
1918,8,22,3094,2273,821,1918-8-22,1452
1918,8,23,2420,1652,768,1918-8-23,884
1918,8,24,1894,1207,687,1918-8-24,520
1918,8,25,1719,1134,585,1918-8-25,549
1918,8,26,1703,1182,521,1918-8-26,661
1918,8,27,1534,1002,532,1918-8-27,470
1918,8,28,1459,1054,405,1918-8-28,649
1918,8,29,1260,878,382,1918-8-29,496
1918,8,30,850,793,57,1918-8-30,736
1918,8,31,804,710,94,1918-8-31,616
1918,9,1,833,603,230,1918-9-1,373
1918,9,2,404,267,137,1918-9-2,130
1918,9,3,163,45,118,1918-9-3,-73
1918,9,4,133,6,127,1918-9-4,-121
1918,9,5,150,26,124,1918-9-5,-98
1918,9,6,339,162,177,1918-9-6,-15
1918,9,7,465,271,194,1918-9-7,77
1918,9,8,381,309,72,1918-9-8,237
1918,9,9,344,272,72,1918-9-9,200
1918,9,10,337,183,154,1918-9-10,29
1918,9,11,491,227,264,1918-9-11,-37
1918,9,12,525,131,394,1918-9-12,-263
1918,9,13,654,96,558,1918-9-13,-462
1918,9,14,839,37,802,1918-9-14,-765
1918,9,15,1105,137,968,1918-9-15,-831
1918,9,16,1127,171,956,1918-9-16,-785
1918,9,17,1671,429,1242,1918-9-17,-813
1918,9,18,1756,332,1424,1918-9-18,-1092
1918,9,19,1675,296,1379,1918-9-19,-1083
1918,9,20,1642,438,1204,1918-9-20,-766
1918,9,21,1278,641,637,1918-9-21,4
1918,9,22,1147,882,265,1918-9-22,617
1918,9,23,1034,742,292,1918-9-23,450
1918,9,24,1030,748,282,1918-9-24,466
1918,9,25,816,602,214,1918-9-25,388
1918,9,26,639,527,112,1918-9-26,415
1918,9,27,1258,944,314,1918-9-27,630
1918,9,28,1939,1244,695,1918-9-28,549
1918,9,29,2162,1324,838,1918-9-29,486
1918,9,30,1994,936,1058,1918-9-30,-122
1918,10,1,1569,546,1023,1918-10-1,-477
1918,10,2,1167,70,1097,1918-10-2,-1027
1918,10,3,1388,234,1154,1918-10-3,-920
1918,10,4,1194,312,882,1918-10-4,-570
1918,10,5,1013,130,883,1918-10-5,-753
1918,10,6,325,181,144,1918-10-6,37
1918,10,7,367,301,66,1918-10-7,235
1918,10,8,402,316,86,1918-10-8,230
1918,10,9,639,549,90,1918-10-9,459
1918,10,10,659,614,45,1918-10-10,569
1918,10,11,801,775,26,1918-10-11,749
1918,10,12,1004,942,62,1918-10-12,880
1918,10,13,1129,1017,112,1918-10-13,905
1918,10,14,868,810,58,1918-10-14,752
1918,10,15,852,836,16,1918-10-15,820
1918,10,16,1253,1225,28,1918-10-16,1197
1918,10,17,1312,1304,8,1918-10-17,1296
1918,10,18,1437,1394,43,1918-10-18,1351
1918,10,19,2225,1821,404,1918-10-19,1417
1918,10,20,1903,1510,393,1918-10-20,1117
1918,10,21,1843,1445,398,1918-10-21,1047
1918,10,22,1629,1252,377,1918-10-22,875
1918,10,23,2001,1436,565,1918-10-23,871
1918,10,24,1699,1166,533,1918-10-24,633
1918,10,25,1611,1108,503,1918-10-25,605
1918,10,26,1540,905,635,1918-10-26,270
1918,10,27,1500,764,736,1918-10-27,28
1918,10,28,1413,783,630,1918-10-28,153
1918,10,29,1220,673,547,1918-10-29,126
1918,10,30,1088,556,532,1918-10-30,24
1918,10,31,1051,636,415,1918-10-31,221
1918,11,1,749,530,219,1918-11-1,311
1918,11,2,606,476,130,1918-11-2,346
1918,11,3,517,378,139,1918-11-3,239
1918,11,4,506,383,123,1918-11-4,260
1918,11,5,401,349,52,1918-11-5,297
1918,11,6,192,126,66,1918-11-6,60
1918,11,7,252,105,147,1918-11-7,-42
1918,11,8,284,91,193,1918-11-8,-102
1918,11,9,378,293,85,1918-11-9,208
1918,11,10,234,234,0,1918-11-10,234
1918,11,11,179,168,11,1918-11-11,157
1918,11,12,585,570,15,1918-11-12,555
1918,11,13,1091,1087,4,1918-11-13,1083
1918,11,14,1288,1187,101,1918-11-14,1086
1918,11,15,1587,1230,357,1918-11-15,873
1918,11,16,2071,1362,709,1918-11-16,653
1918,11,17,1821,1077,744,1918-11-17,333
1918,11,18,2206,1176,1030,1918-11-18,146
1918,11,19,2313,1219,1094,1918-11-19,125
1918,11,20,2119,1111,1008,1918-11-20,103
1918,11,21,2085,1026,1059,1918-11-21,-33
1918,11,22,1196,677,519,1918-11-22,158
1918,11,23,1101,629,472,1918-11-23,157
1918,11,24,-1,-1,-1,1918-11-24,0
1918,11,25,1174,163,1011,1918-11-25,-848
1918,11,26,1165,10,1155,1918-11-26,-1145
1918,11,27,1161,9,1152,1918-11-27,-1143
1918,11,28,962,0,962,1918-11-28,-962
1918,11,29,1041,0,1041,1918-11-29,-1041
1918,11,30,919,0,919,1918-11-30,-919
1918,12,1,1343,5,1338,1918-12-1,-1333
1918,12,2,1859,54,1805,1918-12-2,-1751
1918,12,3,58,26,32,1918-12-3,-6
1918,12,4,115,47,68,1918-12-4,-21
1918,12,5,93,43,50,1918-12-5,-7
1918,12,6,681,45,636,1918-12-6,-591
1918,12,7,759,59,700,1918-12-7,-641
1918,12,8,1046,149,897,1918-12-8,-748
1918,12,9,1276,94,1182,1918-12-9,-1088
1918,12,10,1371,51,1320,1918-12-10,-1269
1918,12,11,715,31,684,1918-12-11,-653
1918,12,12,788,97,691,1918-12-12,-594
1918,12,13,851,204,647,1918-12-13,-443
1918,12,14,808,147,661,1918-12-14,-514
1918,12,15,593,85,508,1918-12-15,-423
1918,12,16,522,10,512,1918-12-16,-502
1918,12,17,1494,0,1494,1918-12-17,-1494
1918,12,18,1293,0,1293,1918-12-18,-1293
1918,12,19,1179,27,1152,1918-12-19,-1125
1918,12,20,1413,45,1368,1918-12-20,-1323
1918,12,21,1857,173,1684,1918-12-21,-1511
1918,12,22,1894,110,1784,1918-12-22,-1674
1918,12,23,1916,52,1864,1918-12-23,-1812
1918,12,24,1942,34,1908,1918-12-24,-1874
1918,12,25,2227,80,2147,1918-12-25,-2067
1918,12,26,1887,47,1840,1918-12-26,-1793
1918,12,27,1675,52,1623,1918-12-27,-1571
1918,12,28,1044,45,999,1918-12-28,-954
1918,12,29,856,40,816,1918-12-29,-776
1918,12,30,272,12,260,1918-12-30,-248
1918,12,31,202,6,196,1918-12-31,-190
1919,1,1,85,11,74,1919-1-1,-63
1919,1,2,272,28,244,1919-1-2,-216
1919,1,3,268,22,246,1919-1-3,-224
1919,1,4,194,8,186,1919-1-4,-178
1919,1,5,184,19,165,1919-1-5,-146
1919,1,6,310,154,156,1919-1-6,-2
1919,1,7,584,409,175,1919-1-7,234
1919,1,8,887,706,181,1919-1-8,525
1919,1,9,1035,814,221,1919-1-9,593
1919,1,10,1232,972,260,1919-1-10,712
1919,1,11,1712,1197,515,1919-1-11,682
1919,1,12,1527,1093,434,1919-1-12,659
1919,1,13,1528,1192,336,1919-1-13,856
1919,1,14,1353,970,383,1919-1-14,587
1919,1,15,1352,961,391,1919-1-15,570
1919,1,16,1098,758,340,1919-1-16,418
1919,1,17,448,150,298,1919-1-17,-148
1919,1,18,283,48,235,1919-1-18,-187
1919,1,19,318,114,204,1919-1-19,-90
1919,1,20,192,81,111,1919-1-20,-30
1919,1,21,279,62,217,1919-1-21,-155
1919,1,22,173,17,156,1919-1-22,-139
1919,1,23,120,3,117,1919-1-23,-114
1919,1,24,121,4,117,1919-1-24,-113
1919,1,25,126,6,120,1919-1-25,-114
1919,1,26,238,25,213,1919-1-26,-188
1919,1,27,565,18,547,1919-1-27,-529
1919,1,28,677,0,677,1919-1-28,-677
1919,1,29,746,0,746,1919-1-29,-746
1919,1,30,698,74,624,1919-1-30,-550
1919,1,31,723,195,528,1919-1-31,-333
1919,2,1,1288,1039,249,1919-2-1,790
1919,2,2,1719,1316,403,1919-2-2,913
1919,2,3,1757,1344,413,1919-2-3,931
1919,2,4,2030,1774,256,1919-2-4,1518
1919,2,5,1978,1714,264,1919-2-5,1450
1919,2,6,2173,1972,201,1919-2-6,1771
1919,2,7,2126,1989,137,1919-2-7,1852
1919,2,8,2183,2031,152,1919-2-8,1879
1919,2,9,2369,2288,81,1919-2-9,2207
1919,2,10,2250,2164,86,1919-2-10,2078
1919,2,11,2094,2054,40,1919-2-11,2014
1919,2,12,1522,1512,10,1919-2-12,1502
1919,2,13,1514,1514,0,1919-2-13,1514
1919,2,14,1284,1284,0,1919-2-14,1284
1919,2,15,1323,1167,156,1919-2-15,1011
1919,2,16,1538,1381,157,1919-2-16,1224
1919,2,17,1301,1124,177,1919-2-17,947
1919,2,18,1161,1012,149,1919-2-18,863
1919,2,19,919,754,165,1919-2-19,589
1919,2,20,641,468,173,1919-2-20,295
1919,2,21,232,46,186,1919-2-21,-140
1919,2,22,461,317,144,1919-2-22,173
1919,2,23,458,311,147,1919-2-23,164
1919,2,24,476,326,150,1919-2-24,176
1919,2,25,738,581,157,1919-2-25,424
1919,2,26,883,638,245,1919-2-26,393
1919,2,27,943,664,279,1919-2-27,385
1919,2,28,815,556,259,1919-2-28,297
1919,3,1,667,453,214,1919-3-1,239
1919,3,2,615,456,159,1919-3-2,297
1919,3,3,646,531,115,1919-3-3,416
1919,3,4,640,564,76,1919-3-4,488
1919,3,5,849,791,58,1919-3-5,733
1919,3,6,1249,1185,64,1919-3-6,1121
1919,3,7,1656,1656,0,1919-3-7,1656
1919,3,8,1843,1843,0,1919-3-8,1843
1919,3,9,1577,1577,0,1919-3-9,1577
1919,3,10,2504,2225,279,1919-3-10,1946
1919,3,11,2746,2252,494,1919-3-11,1758
1919,3,12,2529,1993,536,1919-3-12,1457
1919,3,13,2292,1798,494,1919-3-13,1304
1919,3,14,2207,1639,568,1919-3-14,1071
1919,3,15,1898,1382,516,1919-3-15,866
1919,3,16,1369,931,438,1919-3-16,493
1919,3,17,1250,879,371,1919-3-17,508
1919,3,18,1299,972,327,1919-3-18,645
1919,3,19,729,420,309,1919-3-19,111
1919,3,20,391,112,279,1919-3-20,-167
1919,3,21,507,102,405,1919-3-21,-303
1919,3,22,289,70,219,1919-3-22,-149
1919,3,23,664,46,618,1919-3-23,-572
1919,3,24,720,38,682,1919-3-24,-644
1919,3,25,807,70,737,1919-3-25,-667
1919,3,26,744,33,711,1919-3-26,-678
1919,3,27,772,15,757,1919-3-27,-742
1919,3,28,735,11,724,1919-3-28,-713
1919,3,29,715,11,704,1919-3-29,-693
1919,3,30,1040,355,685,1919-3-30,-330
1919,3,31,947,322,625,1919-3-31,-303
1919,4,1,873,365,508,1919-4-1,-143
1919,4,2,874,379,495,1919-4-2,-116
1919,4,3,933,430,503,1919-4-3,-73
1919,4,4,864,459,405,1919-4-4,54
1919,4,5,511,443,68,1919-4-5,375
1919,4,6,472,383,89,1919-4-6,294
1919,4,7,660,636,24,1919-4-7,612
1919,4,8,773,766,7,1919-4-8,759
1919,4,9,827,814,13,1919-4-9,801
1919,4,10,880,865,15,1919-4-10,850
1919,4,11,650,650,0,1919-4-11,650
1919,4,12,401,374,27,1919-4-12,347
1919,4,13,319,300,19,1919-4-13,281
1919,4,14,282,250,32,1919-4-14,218
1919,4,15,305,297,8,1919-4-15,289
1919,4,16,171,171,0,1919-4-16,171
1919,4,17,184,179,5,1919-4-17,174
1919,4,18,145,145,0,1919-4-18,145
1919,4,19,461,91,370,1919-4-19,-279
1919,4,20,373,35,338,1919-4-20,-303
1919,4,21,362,15,347,1919-4-21,-332
1919,4,22,541,71,470,1919-4-22,-399
1919,4,23,532,2,530,1919-4-23,-528
1919,4,24,770,163,607,1919-4-24,-444
1919,4,25,1392,439,953,1919-4-25,-514
1919,4,26,1488,381,1107,1919-4-26,-726
1919,4,27,1270,355,915,1919-4-27,-560
1919,4,28,1282,275,1007,1919-4-28,-732
1919,4,29,1364,165,1199,1919-4-29,-1034
1919,4,30,1266,170,1096,1919-4-30,-926
1919,5,1,1089,160,929,1919-5-1,-769
1919,5,2,1317,150,1167,1919-5-2,-1017
1919,5,3,1753,813,940,1919-5-3,-127
1919,5,4,1860,1085,775,1919-5-4,310
1919,5,5,2145,1388,757,1919-5-5,631
1919,5,6,2108,1255,853,1919-5-6,402
1919,5,7,2039,1353,686,1919-5-7,667
1919,5,8,1815,1130,685,1919-5-8,445
1919,5,9,1917,1114,803,1919-5-9,311
1919,5,10,1452,879,573,1919-5-10,306
1919,5,11,1219,704,515,1919-5-11,189
1919,5,12,1178,736,442,1919-5-12,294
1919,5,13,1988,1513,475,1919-5-13,1038
1919,5,14,1870,1530,340,1919-5-14,1190
1919,5,15,2203,1779,424,1919-5-15,1355
1919,5,16,2202,1563,639,1919-5-16,924
1919,5,17,2504,1670,834,1919-5-17,836
1919,5,18,2612,1800,812,1919-5-18,988
1919,5,19,2370,1656,714,1919-5-19,942
1919,5,20,2520,1663,857,1919-5-20,806
1919,5,21,2366,1540,826,1919-5-21,714
1919,5,22,2162,1459,703,1919-5-22,756
1919,5,23,1851,1201,650,1919-5-23,551
1919,5,24,1923,1301,622,1919-5-24,679
1919,5,25,1405,1002,403,1919-5-25,599
1919,5,26,612,134,478,1919-5-26,-344
1919,5,27,718,105,613,1919-5-27,-508
1919,5,28,600,103,497,1919-5-28,-394
1919,5,29,168,111,57,1919-5-29,54
1919,5,30,589,526,63,1919-5-30,463
1919,5,31,635,520,115,1919-5-31,405
1919,6,1,839,648,191,1919-6-1,457
1919,6,2,1228,638,590,1919-6-2,48
1919,6,3,1317,576,741,1919-6-3,-165
1919,6,4,1455,763,692,1919-6-4,71
1919,6,5,1605,1079,526,1919-6-5,553
1919,6,6,1465,1223,242,1919-6-6,981
1919,6,7,1449,1224,225,1919-6-7,999
1919,6,8,1011,858,153,1919-6-8,705
1919,6,9,1271,1234,37,1919-6-9,1197
1919,6,10,1728,1318,410,1919-6-10,908
1919,6,11,1531,1246,285,1919-6-11,961
1919,6,12,2025,928,1097,1919-6-12,-169
1919,6,13,2389,1042,1347,1919-6-13,-305
1919,6,14,2036,885,1151,1919-6-14,-266
1919,6,15,2035,789,1246,1919-6-15,-457
1919,6,16,2261,879,1382,1919-6-16,-503
1919,6,17,2339,1032,1307,1919-6-17,-275
1919,6,18,2305,1059,1246,1919-6-18,-187
1919,6,19,2620,1265,1355,1919-6-19,-90
1919,6,20,2531,1164,1367,1919-6-20,-203
1919,6,21,2839,1217,1622,1919-6-21,-405
1919,6,22,2761,829,1932,1919-6-22,-1103
1919,6,23,2722,661,2061,1919-6-23,-1400
1919,6,24,2787,773,2014,1919-6-24,-1241
1919,6,25,1621,686,935,1919-6-25,-249
1919,6,26,1876,889,987,1919-6-26,-98
1919,6,27,1908,711,1197,1919-6-27,-486
1919,6,28,1697,619,1078,1919-6-28,-459
1919,6,29,1611,469,1142,1919-6-29,-673
1919,6,30,1037,187,850,1919-6-30,-663
1919,7,1,513,179,334,1919-7-1,-155
1919,7,2,682,300,382,1919-7-2,-82
1919,7,3,850,316,534,1919-7-3,-218
1919,7,4,1189,660,529,1919-7-4,131
1919,7,5,959,628,331,1919-7-5,297
1919,7,6,502,489,13,1919-7-6,476
1919,7,7,499,476,23,1919-7-7,453
1919,7,8,349,340,9,1919-7-8,331
1919,7,9,316,295,21,1919-7-9,274
1919,7,10,360,309,51,1919-7-10,258
1919,7,11,500,244,256,1919-7-11,-12
1919,7,12,1211,227,984,1919-7-12,-757
1919,7,13,1347,184,1163,1919-7-13,-979
1919,7,14,1402,154,1248,1919-7-14,-1094
1919,7,15,1767,159,1608,1919-7-15,-1449
1919,7,16,1516,126,1390,1919-7-16,-1264
1919,7,17,1477,112,1365,1919-7-17,-1253
1919,7,18,1689,107,1582,1919-7-18,-1475
1919,7,19,1773,117,1656,1919-7-19,-1539
1919,7,20,1009,108,901,1919-7-20,-793
1919,7,21,1089,91,998,1919-7-21,-907
1919,7,22,949,93,856,1919-7-22,-763
1919,7,23,964,109,855,1919-7-23,-746
1919,7,24,967,111,856,1919-7-24,-745
1919,7,25,960,95,865,1919-7-25,-770
1919,7,26,819,91,728,1919-7-26,-637
1919,7,27,768,132,636,1919-7-27,-504
1919,7,28,505,131,374,1919-7-28,-243
1919,7,29,411,76,335,1919-7-29,-259
1919,7,30,341,58,283,1919-7-30,-225
1919,7,31,290,50,240,1919-7-31,-190
1919,8,1,215,9,206,1919-8-1,-197
1919,8,2,72,24,48,1919-8-2,-24
1919,8,3,700,24,676,1919-8-3,-652
1919,8,4,792,35,757,1919-8-4,-722
1919,8,5,866,20,846,1919-8-5,-826
1919,8,6,813,15,798,1919-8-6,-783
1919,8,7,1390,20,1370,1919-8-7,-1350
1919,8,8,1097,3,1094,1919-8-8,-1091
1919,8,9,1082,12,1070,1919-8-9,-1058
1919,8,10,1032,0,1032,1919-8-10,-1032
1919,8,11,1481,3,1478,1919-8-11,-1475
1919,8,12,1259,9,1250,1919-8-12,-1241
1919,8,13,2012,868,1144,1919-8-13,-276
1919,8,14,2763,1511,1252,1919-8-14,259
1919,8,15,2840,1386,1454,1919-8-15,-68
1919,8,16,2411,1336,1075,1919-8-16,261
1919,8,17,2397,1323,1074,1919-8-17,249
1919,8,18,2391,1273,1118,1919-8-18,155
1919,8,19,2299,1159,1140,1919-8-19,19
1919,8,20,2383,1198,1185,1919-8-20,13
1919,8,21,2627,1164,1463,1919-8-21,-299
1919,8,22,2466,1138,1328,1919-8-22,-190
1919,8,23,2048,912,1136,1919-8-23,-224
1919,8,24,1984,827,1157,1919-8-24,-330
1919,8,25,926,440,486,1919-8-25,-46
1919,8,26,594,5,589,1919-8-26,-584
1919,8,27,557,0,557,1919-8-27,-557
1919,8,28,394,0,394,1919-8-28,-394
1919,8,29,296,0,296,1919-8-29,-296
1919,8,30,280,0,280,1919-8-30,-280
1919,8,31,433,33,400,1919-8-31,-367
1919,9,1,481,8,473,1919-9-1,-465
1919,9,2,496,0,496,1919-9-2,-496
1919,9,3,517,5,512,1919-9-3,-507
1919,9,4,642,16,626,1919-9-4,-610
1919,9,5,903,40,863,1919-9-5,-823
1919,9,6,1123,35,1088,1919-9-6,-1053
1919,9,7,1275,9,1266,1919-9-7,-1257
1919,9,8,1867,486,1381,1919-9-8,-895
1919,9,9,1337,578,759,1919-9-9,-181
1919,9,10,1294,537,757,1919-9-10,-220
1919,9,11,1344,554,790,1919-9-11,-236
1919,9,12,1411,595,816,1919-9-12,-221
1919,9,13,1411,537,874,1919-9-13,-337
1919,9,14,1300,507,793,1919-9-14,-286
1919,9,15,1314,534,780,1919-9-15,-246
1919,9,16,1180,576,604,1919-9-16,-28
1919,9,17,1074,507,567,1919-9-17,-60
1919,9,18,1212,510,702,1919-9-18,-192
1919,9,19,1112,489,623,1919-9-19,-134
1919,9,20,1268,738,530,1919-9-20,208
1919,9,21,696,418,278,1919-9-21,140
1919,9,22,953,631,322,1919-9-22,309
1919,9,23,1050,484,566,1919-9-23,-82
1919,9,24,1027,408,619,1919-9-24,-211
1919,9,25,1083,404,679,1919-9-25,-275
1919,9,26,1104,324,780,1919-9-26,-456
1919,9,27,973,275,698,1919-9-27,-423
1919,9,28,1220,282,938,1919-9-28,-656
1919,9,29,1197,328,869,1919-9-29,-541
1919,9,30,999,237,762,1919-9-30,-525
1919,10,1,989,208,781,1919-10-1,-573
1919,10,2,805,89,716,1919-10-2,-627
1919,10,3,699,0,699,1919-10-3,-699
1919,10,4,627,0,627,1919-10-4,-627
1919,10,5,968,214,754,1919-10-5,-540
1919,10,6,821,474,347,1919-10-6,127
1919,10,7,920,484,436,1919-10-7,48
1919,10,8,826,466,360,1919-10-8,106
1919,10,9,844,598,246,1919-10-9,352
1919,10,10,1034,591,443,1919-10-10,148
1919,10,11,1263,608,655,1919-10-11,-47
1919,10,12,1689,789,900,1919-10-12,-111
1919,10,13,1285,655,630,1919-10-13,25
1919,10,14,874,564,310,1919-10-14,254
1919,10,15,868,512,356,1919-10-15,156
1919,10,16,777,358,419,1919-10-16,-61
1919,10,17,633,375,258,1919-10-17,117
1919,10,18,209,14,195,1919-10-18,-181
1919,10,19,62,0,62,1919-10-19,-62
1919,10,20,202,0,202,1919-10-20,-202
1919,10,21,176,34,142,1919-10-21,-108
1919,10,22,138,3,135,1919-10-22,-132
1919,10,23,130,3,127,1919-10-23,-124
1919,10,24,285,8,277,1919-10-24,-269
1919,10,25,304,19,285,1919-10-25,-266
1919,10,26,641,395,246,1919-10-26,149
1919,10,27,858,561,297,1919-10-27,264
1919,10,28,862,604,258,1919-10-28,346
1919,10,29,1224,949,275,1919-10-29,674
1919,10,30,1422,1172,250,1919-10-30,922
1919,10,31,1572,1236,336,1919-10-31,900
1919,11,1,1604,1045,559,1919-11-1,486
1919,11,2,1990,1493,497,1919-11-2,996
1919,11,3,1811,1285,526,1919-11-3,759
1919,11,4,1679,1212,467,1919-11-4,745
1919,11,5,1981,1183,798,1919-11-5,385
1919,11,6,1616,1308,308,1919-11-6,1000
1919,11,7,1181,901,280,1919-11-7,621
1919,11,8,715,439,276,1919-11-8,163
1919,11,9,774,507,267,1919-11-9,240
1919,11,10,767,476,291,1919-11-10,185
1919,11,11,655,399,256,1919-11-11,143
1919,11,12,391,391,0,1919-11-12,391
1919,11,13,388,388,0,1919-11-13,388
1919,11,14,240,240,0,1919-11-14,240
1919,11,15,47,47,0,1919-11-15,47
1919,11,16,30,30,0,1919-11-16,30
1919,11,17,58,58,0,1919-11-17,58
1919,11,18,13,0,13,1919-11-18,-13
1919,11,19,61,0,61,1919-11-19,-61
1919,11,20,40,8,32,1919-11-20,-24
1919,11,21,63,50,13,1919-11-21,37
1919,11,22,492,487,5,1919-11-22,482
1919,11,23,533,504,29,1919-11-23,475
1919,11,24,530,469,61,1919-11-24,408
1919,11,25,634,576,58,1919-11-25,518
1919,11,26,805,658,147,1919-11-26,511
1919,11,27,895,651,244,1919-11-27,407
1919,11,28,814,666,148,1919-11-28,518
1919,11,29,951,756,195,1919-11-29,561
1919,11,30,1079,651,428,1919-11-30,223
1919,12,1,956,589,367,1919-12-1,222
1919,12,2,771,455,316,1919-12-2,139
1919,12,3,904,513,391,1919-12-3,122
1919,12,4,981,689,292,1919-12-4,397
1919,12,5,425,184,241,1919-12-5,-57
1919,12,6,251,30,221,1919-12-6,-191
1919,12,7,149,3,146,1919-12-7,-143
1919,12,8,198,117,81,1919-12-8,36
1919,12,9,319,267,52,1919-12-9,215
1919,12,10,402,380,22,1919-12-10,358
1919,12,11,370,356,14,1919-12-11,342
1919,12,12,447,424,23,1919-12-12,401
1919,12,13,438,393,45,1919-12-13,348
1919,12,14,478,430,48,1919-12-14,382
1919,12,15,369,342,27,1919-12-15,315
1919,12,16,302,302,0,1919-12-16,302
1919,12,17,316,290,26,1919-12-17,264
1919,12,18,214,162,52,1919-12-18,110
1919,12,19,102,69,33,1919-12-19,36
1919,12,20,13,0,13,1919-12-20,-13
1919,12,21,68,32,36,1919-12-21,-4
1919,12,22,175,52,123,1919-12-22,-71
1919,12,23,253,57,196,1919-12-23,-139
1919,12,24,350,80,270,1919-12-24,-190
1919,12,25,155,32,123,1919-12-25,-91
1919,12,26,127,6,121,1919-12-26,-115
1919,12,27,79,18,61,1919-12-27,-43
1919,12,28,68,10,58,1919-12-28,-48
1919,12,29,29,4,25,1919-12-29,-21
1919,12,30,112,0,112,1919-12-30,-112
1919,12,31,298,0,298,1919-12-31,-298
1920,1,1,459,4,455,1920-1-1,-451
1920,1,2,898,18,880,1920-1-2,-862
1920,1,3,1161,11,1150,1920-1-3,-1139
1920,1,4,1019,14,1005,1920-1-4,-991
1920,1,5,902,0,902,1920-1-5,-902
1920,1,6,875,18,857,1920-1-6,-839
1920,1,7,852,0,852,1920-1-7,-852
1920,1,8,362,211,151,1920-1-8,60
1920,1,9,386,216,170,1920-1-9,46
1920,1,10,444,262,182,1920-1-10,80
1920,1,11,685,503,182,1920-1-11,321
1920,1,12,790,568,222,1920-1-12,346
1920,1,13,661,480,181,1920-1-13,299
1920,1,14,571,412,159,1920-1-14,253
1920,1,15,570,394,176,1920-1-15,218
1920,1,16,469,328,141,1920-1-16,187
1920,1,17,485,331,154,1920-1-17,177
1920,1,18,399,243,156,1920-1-18,87
1920,1,19,384,246,138,1920-1-19,108
1920,1,20,324,179,145,1920-1-20,34
1920,1,21,663,156,507,1920-1-21,-351
1920,1,22,1753,186,1567,1920-1-22,-1381
1920,1,23,1917,115,1802,1920-1-23,-1687
1920,1,24,2349,3,2346,1920-1-24,-2343
1920,1,25,3020,0,3020,1920-1-25,-3020
1920,1,26,2933,3,2930,1920-1-26,-2927
1920,1,27,2904,0,2904,1920-1-27,-2904
1920,1,28,2600,0,2600,1920-1-28,-2600
1920,1,29,2395,0,2395,1920-1-29,-2395
1920,1,30,1768,0,1768,1920-1-30,-1768
1920,1,31,1185,0,1185,1920-1-31,-1185
1920,2,1,832,0,832,1920-2-1,-832
1920,2,2,650,5,645,1920-2-2,-640
1920,2,3,353,0,353,1920-2-3,-353
1920,2,4,207,4,203,1920-2-4,-199
1920,2,5,182,59,123,1920-2-5,-64
1920,2,6,198,46,152,1920-2-6,-106
1920,2,7,208,17,191,1920-2-7,-174
1920,2,8,110,29,81,1920-2-8,-52
1920,2,9,208,60,148,1920-2-9,-88
1920,2,10,481,353,128,1920-2-10,225
1920,2,11,394,315,79,1920-2-11,236
1920,2,12,464,298,166,1920-2-12,132
1920,2,13,967,517,450,1920-2-13,67
1920,2,14,1136,877,259,1920-2-14,618
1920,2,15,1121,815,306,1920-2-15,509
1920,2,16,947,667,280,1920-2-16,387
1920,2,17,935,641,294,1920-2-17,347
1920,2,18,724,438,286,1920-2-18,152
1920,2,19,602,376,226,1920-2-19,150
1920,2,20,460,314,146,1920-2-20,168
1920,2,21,522,384,138,1920-2-21,246
1920,2,22,701,346,355,1920-2-22,-9
1920,2,23,633,337,296,1920-2-23,41
1920,2,24,435,220,215,1920-2-24,5
1920,2,25,466,165,301,1920-2-25,-136
1920,2,26,558,151,407,1920-2-26,-256
1920,2,27,591,170,421,1920-2-27,-251
1920,2,28,554,95,459,1920-2-28,-364
1920,2,29,397,0,397,1920-2-29,-397
1920,3,1,325,0,325,1920-3-1,-325
1920,3,2,332,0,332,1920-3-2,-332
1920,3,3,365,69,296,1920-3-3,-227
1920,3,4,356,63,293,1920-3-4,-230
1920,3,5,471,217,254,1920-3-5,-37
1920,3,6,448,273,175,1920-3-6,98
1920,3,7,372,372,0,1920-3-7,372
1920,3,8,719,719,0,1920-3-8,719
1920,3,9,776,698,78,1920-3-9,620
1920,3,10,1348,1239,109,1920-3-10,1130
1920,3,11,1267,1118,149,1920-3-11,969
1920,3,12,1397,1287,110,1920-3-12,1177
1920,3,13,1379,1255,124,1920-3-13,1131
1920,3,14,928,832,96,1920-3-14,736
1920,3,15,739,172,567,1920-3-15,-395
1920,3,16,1919,0,1919,1920-3-16,-1919
1920,3,17,2348,0,2348,1920-3-17,-2348
1920,3,18,2304,0,2304,1920-3-18,-2304
1920,3,19,2280,0,2280,1920-3-19,-2280
1920,3,20,2405,5,2400,1920-3-20,-2395
1920,3,21,2851,23,2828,1920-3-21,-2805
1920,3,22,2864,0,2864,1920-3-22,-2864
1920,3,23,3291,0,3291,1920-3-23,-3291
1920,3,24,3194,314,2880,1920-3-24,-2566
1920,3,25,2992,261,2731,1920-3-25,-2470
1920,3,26,2730,248,2482,1920-3-26,-2234
1920,3,27,2126,192,1934,1920-3-27,-1742
1920,3,28,446,216,230,1920-3-28,-14
1920,3,29,537,191,346,1920-3-29,-155
1920,3,30,203,203,0,1920-3-30,203
1920,3,31,185,179,6,1920-3-31,173
1920,4,1,224,212,12,1920-4-1,200
1920,4,2,221,219,2,1920-4-2,217
1920,4,3,224,222,2,1920-4-3,220
1920,4,4,222,222,0,1920-4-4,222
1920,4,5,17,17,0,1920-4-5,17
1920,4,6,15,15,0,1920-4-6,15
1920,4,7,30,30,0,1920-4-7,30
1920,4,8,36,34,2,1920-4-8,32
1920,4,9,25,25,0,1920-4-9,25
1920,4,10,573,0,573,1920-4-10,-573
1920,4,11,764,0,764,1920-4-11,-764
1920,4,12,692,6,686,1920-4-12,-680
1920,4,13,782,0,782,1920-4-13,-782
1920,4,14,714,0,714,1920-4-14,-714
1920,4,15,610,0,610,1920-4-15,-610
1920,4,16,574,7,567,1920-4-16,-560
1920,4,17,539,3,536,1920-4-17,-533
1920,4,18,513,0,513,1920-4-18,-513
1920,4,19,485,0,485,1920-4-19,-485
1920,4,20,481,6,475,1920-4-20,-469
1920,4,21,447,0,447,1920-4-21,-447
1920,4,22,553,0,553,1920-4-22,-553
1920,4,23,289,4,285,1920-4-23,-281
1920,4,24,0,0,0,1920-4-24,0
1920,4,25,137,137,0,1920-4-25,137
1920,4,26,114,114,0,1920-4-26,114
1920,4,27,120,120,0,1920-4-27,120
1920,4,28,142,136,6,1920-4-28,130
1920,4,29,151,151,0,1920-4-29,151
1920,4,30,141,141,0,1920-4-30,141
1920,5,1,170,156,14,1920-5-1,142
1920,5,2,146,135,11,1920-5-2,124
1920,5,3,249,135,114,1920-5-3,21
1920,5,4,420,125,295,1920-5-4,-170
1920,5,5,409,102,307,1920-5-5,-205
1920,5,6,310,126,184,1920-5-6,-58
1920,5,7,340,151,189,1920-5-7,-38
1920,5,8,311,4,307,1920-5-8,-303
1920,5,9,357,0,357,1920-5-9,-357
1920,5,10,317,49,268,1920-5-10,-219
1920,5,11,207,58,149,1920-5-11,-91
1920,5,12,180,62,118,1920-5-12,-56
1920,5,13,197,121,76,1920-5-13,45
1920,5,14,225,174,51,1920-5-14,123
1920,5,15,429,406,23,1920-5-15,383
1920,5,16,8,5,3,1920-5-16,2
1920,5,17,78,78,0,1920-5-17,78
1920,5,18,131,131,0,1920-5-18,131
1920,5,19,131,129,2,1920-5-19,127
1920,5,20,31,31,0,1920-5-20,31
1920,5,21,12,9,3,1920-5-21,6
1920,5,22,447,447,0,1920-5-22,447
1920,5,23,350,350,0,1920-5-23,350
1920,5,24,234,234,0,1920-5-24,234
1920,5,25,246,236,10,1920-5-25,226
1920,5,26,439,428,11,1920-5-26,417
1920,5,27,509,495,14,1920-5-27,481
1920,5,28,461,452,9,1920-5-28,443
1920,5,29,552,470,82,1920-5-29,388
1920,5,30,674,514,160,1920-5-30,354
1920,5,31,774,608,166,1920-5-31,442
1920,6,1,748,739,9,1920-6-1,730
1920,6,2,737,721,16,1920-6-2,705
1920,6,3,557,532,25,1920-6-3,507
1920,6,4,514,471,43,1920-6-4,428
1920,6,5,460,431,29,1920-6-5,402
1920,6,6,447,438,9,1920-6-6,429
1920,6,7,389,389,0,1920-6-7,389
1920,6,8,576,576,0,1920-6-8,576
1920,6,9,723,723,0,1920-6-9,723
1920,6,10,759,759,0,1920-6-10,759
1920,6,11,311,311,0,1920-6-11,311
1920,6,12,458,458,0,1920-6-12,458
1920,6,13,506,502,4,1920-6-13,498
1920,6,14,380,380,0,1920-6-14,380
1920,6,15,453,351,102,1920-6-15,249
1920,6,16,406,277,129,1920-6-16,148
1920,6,17,525,240,285,1920-6-17,-45
1920,6,18,465,184,281,1920-6-18,-97
1920,6,19,253,14,239,1920-6-19,-225
1920,6,20,237,17,220,1920-6-20,-203
1920,6,21,372,198,174,1920-6-21,24
1920,6,22,575,444,131,1920-6-22,313
1920,6,23,491,373,118,1920-6-23,255
1920,6,24,421,301,120,1920-6-24,181
1920,6,25,788,627,161,1920-6-25,466
1920,6,26,673,581,92,1920-6-26,489
1920,6,27,582,535,47,1920-6-27,488
1920,6,28,703,513,190,1920-6-28,323
1920,6,29,752,445,307,1920-6-29,138
1920,6,30,914,429,485,1920-6-30,-56
1920,7,1,842,378,464,1920-7-1,-86
1920,7,2,818,346,472,1920-7-2,-126
1920,7,3,811,302,509,1920-7-3,-207
1920,7,4,1004,376,628,1920-7-4,-252
1920,7,5,855,367,488,1920-7-5,-121
1920,7,6,797,409,388,1920-7-6,21
1920,7,7,842,480,362,1920-7-7,118
1920,7,8,890,494,396,1920-7-8,98
1920,7,9,460,25,435,1920-7-9,-410
1920,7,10,300,44,256,1920-7-10,-212
1920,7,11,87,52,35,1920-7-11,17
1920,7,12,109,76,33,1920-7-12,43
1920,7,13,98,83,15,1920-7-13,68
1920,7,14,75,42,33,1920-7-14,9
1920,7,15,77,28,49,1920-7-15,-21
1920,7,16,39,0,39,1920-7-16,-39
1920,7,17,255,218,37,1920-7-17,181
1920,7,18,249,173,76,1920-7-18,97
1920,7,19,222,189,33,1920-7-19,156
1920,7,20,220,208,12,1920-7-20,196
1920,7,21,173,173,0,1920-7-21,173
1920,7,22,129,129,0,1920-7-22,129
1920,7,23,294,294,0,1920-7-23,294
1920,7,24,296,296,0,1920-7-24,296
1920,7,25,468,296,172,1920-7-25,124
1920,7,26,438,219,219,1920-7-26,0
1920,7,27,445,253,192,1920-7-27,61
1920,7,28,456,233,223,1920-7-28,10
1920,7,29,400,229,171,1920-7-29,58
1920,7,30,243,90,153,1920-7-30,-63
1920,7,31,229,103,126,1920-7-31,-23
1920,8,1,215,95,120,1920-8-1,-25
1920,8,2,217,119,98,1920-8-2,21
1920,8,3,320,219,101,1920-8-3,118
1920,8,4,111,0,111,1920-8-4,-111
1920,8,5,33,0,33,1920-8-5,-33
1920,8,6,33,33,0,1920-8-6,33
1920,8,7,32,32,0,1920-8-7,32
1920,8,8,8,8,0,1920-8-8,8
1920,8,9,52,52,0,1920-8-9,52
1920,8,10,117,117,0,1920-8-10,117
1920,8,11,98,98,0,1920-8-11,98
1920,8,12,398,70,328,1920-8-12,-258
1920,8,13,447,91,356,1920-8-13,-265
1920,8,14,451,121,330,1920-8-14,-209
1920,8,15,423,162,261,1920-8-15,-99
1920,8,16,382,114,268,1920-8-16,-154
1920,8,17,301,61,240,1920-8-17,-179
1920,8,18,243,18,225,1920-8-18,-207
1920,8,19,221,13,208,1920-8-19,-195
1920,8,20,183,14,169,1920-8-20,-155
1920,8,21,161,10,151,1920-8-21,-141
1920,8,22,276,121,155,1920-8-22,-34
1920,8,23,240,91,149,1920-8-23,-58
1920,8,24,44,44,0,1920-8-24,44
1920,8,25,37,37,0,1920-8-25,37
1920,8,26,29,29,0,1920-8-26,29
1920,8,27,14,14,0,1920-8-27,14
1920,8,28,8,8,0,1920-8-28,8
1920,8,29,75,0,75,1920-8-29,-75
1920,8,30,168,8,160,1920-8-30,-152
1920,8,31,356,0,356,1920-8-31,-356
1920,9,1,629,5,624,1920-9-1,-619
1920,9,2,1149,0,1149,1920-9-2,-1149
1920,9,3,1472,0,1472,1920-9-3,-1472
1920,9,4,1433,6,1427,1920-9-4,-1421
1920,9,5,1607,51,1556,1920-9-5,-1505
1920,9,6,1720,32,1688,1920-9-6,-1656
1920,9,7,1824,24,1800,1920-9-7,-1776
1920,9,8,2025,0,2025,1920-9-8,-2025
1920,9,9,329,0,329,1920-9-9,-329
1920,9,10,167,0,167,1920-9-10,-167
1920,9,11,221,2,219,1920-9-11,-217
1920,9,12,273,22,251,1920-9-12,-229
1920,9,13,366,194,172,1920-9-13,22
1920,9,14,709,586,123,1920-9-14,463
1920,9,15,799,702,97,1920-9-15,605
1920,9,16,1139,1139,0,1920-9-16,1139
1920,9,17,275,275,0,1920-9-17,275
1920,9,18,0,0,0,1920-9-18,0
1920,9,19,0,0,0,1920-9-19,0
1920,9,20,0,0,0,1920-9-20,0
1920,9,21,149,2,147,1920-9-21,-145
1920,9,22,756,14,742,1920-9-22,-728
1920,9,23,908,7,901,1920-9-23,-894
1920,9,24,1045,8,1037,1920-9-24,-1029
1920,9,25,1057,20,1037,1920-9-25,-1017
1920,9,26,1202,49,1153,1920-9-26,-1104
1920,9,27,1144,151,993,1920-9-27,-842
1920,9,28,1111,352,759,1920-9-28,-407
1920,9,29,1042,477,565,1920-9-29,-88
1920,9,30,998,545,453,1920-9-30,92
1920,10,1,659,308,351,1920-10-1,-43
1920,10,2,667,296,371,1920-10-2,-75
1920,10,3,631,254,377,1920-10-3,-123
1920,10,4,655,410,245,1920-10-4,165
1920,10,5,802,726,76,1920-10-5,650
1920,10,6,607,601,6,1920-10-6,595
1920,10,7,1257,522,735,1920-10-7,-213
1920,10,8,1278,520,758,1920-10-8,-238
1920,10,9,957,379,578,1920-10-9,-199
1920,10,10,844,327,517,1920-10-10,-190
1920,10,11,929,478,451,1920-10-11,27
1920,10,12,836,454,382,1920-10-12,72
1920,10,13,673,377,296,1920-10-13,81
1920,10,14,510,271,239,1920-10-14,32
1920,10,15,638,385,253,1920-10-15,132
1920,10,16,684,387,297,1920-10-16,90
1920,10,17,664,266,398,1920-10-17,-132
1920,10,18,354,63,291,1920-10-18,-228
1920,10,19,384,190,194,1920-10-19,-4
1920,10,20,251,155,96,1920-10-20,59
1920,10,21,541,201,340,1920-10-21,-139
1920,10,22,473,143,330,1920-10-22,-187
1920,10,23,426,178,248,1920-10-23,-70
1920,10,24,540,205,335,1920-10-24,-130
1920,10,25,472,196,276,1920-10-25,-80
1920,10,26,332,157,175,1920-10-26,-18
1920,10,27,394,177,217,1920-10-27,-40
1920,10,28,407,140,267,1920-10-28,-127
1920,10,29,305,108,197,1920-10-29,-89
1920,10,30,409,251,158,1920-10-30,93
1920,10,31,566,80,486,1920-10-31,-406
1920,11,1,939,82,857,1920-11-1,-775
1920,11,2,1246,61,1185,1920-11-2,-1124
1920,11,3,1194,72,1122,1920-11-3,-1050
1920,11,4,1110,51,1059,1920-11-4,-1008
1920,11,5,1067,65,1002,1920-11-5,-937
1920,11,6,1222,56,1166,1920-11-6,-1110
1920,11,7,1150,125,1025,1920-11-7,-900
1920,11,8,832,52,780,1920-11-8,-728
1920,11,9,873,50,823,1920-11-9,-773
1920,11,10,707,9,698,1920-11-10,-689
1920,11,11,717,0,717,1920-11-11,-717
1920,11,12,41,41,0,1920-11-12,41
1920,11,13,96,96,0,1920-11-13,96
1920,11,14,370,370,0,1920-11-14,370
1920,11,15,391,391,0,1920-11-15,391
1920,11,16,238,211,27,1920-11-16,184
1920,11,17,201,190,11,1920-11-17,179
1920,11,18,152,152,0,1920-11-18,152
1920,11,19,154,154,0,1920-11-19,154
1920,11,20,140,140,0,1920-11-20,140
1920,11,21,123,123,0,1920-11-21,123
1920,11,22,244,91,153,1920-11-22,-62
1920,11,23,522,96,426,1920-11-23,-330
1920,11,24,580,93,487,1920-11-24,-394
1920,11,25,507,107,400,1920-11-25,-293
1920,11,26,789,87,702,1920-11-26,-615
1920,11,27,802,101,701,1920-11-27,-600
1920,11,28,651,0,651,1920-11-28,-651
1920,11,29,559,0,559,1920-11-29,-559
1920,11,30,485,0,485,1920-11-30,-485
1920,12,1,384,7,377,1920-12-1,-370
1920,12,2,316,0,316,1920-12-2,-316
1920,12,3,361,0,361,1920-12-3,-361
1920,12,4,322,0,322,1920-12-4,-322
1920,12,5,326,0,326,1920-12-5,-326
1920,12,6,234,0,234,1920-12-6,-234
1920,12,7,341,0,341,1920-12-7,-341
1920,12,8,351,0,351,1920-12-8,-351
1920,12,9,156,0,156,1920-12-9,-156
1920,12,10,136,0,136,1920-12-10,-136
1920,12,11,114,0,114,1920-12-11,-114
1920,12,12,170,0,170,1920-12-12,-170
1920,12,13,156,0,156,1920-12-13,-156
1920,12,14,120,0,120,1920-12-14,-120
1920,12,15,43,0,43,1920-12-15,-43
1920,12,16,10,0,10,1920-12-16,-10
1920,12,17,171,171,0,1920-12-17,171
1920,12,18,282,262,20,1920-12-18,242
1920,12,19,382,322,60,1920-12-19,262
1920,12,20,904,904,0,1920-12-20,904
1920,12,21,891,879,12,1920-12-21,867
1920,12,22,694,669,25,1920-12-22,644
1920,12,23,599,554,45,1920-12-23,509
1920,12,24,508,310,198,1920-12-24,112
1920,12,25,510,308,202,1920-12-25,106
1920,12,26,924,480,444,1920-12-26,36
1920,12,27,985,526,459,1920-12-27,67
1920,12,28,1141,455,686,1920-12-28,-231
1920,12,29,815,388,427,1920-12-29,-39
1920,12,30,550,261,289,1920-12-30,-28
1920,12,31,718,243,475,1920-12-31,-232
1921,1,1,595,213,382,1921-1-1,-169
1921,1,2,330,0,330,1921-1-2,-330
1921,1,3,365,0,365,1921-1-3,-365
1921,1,4,355,9,346,1921-1-4,-337
1921,1,5,355,0,355,1921-1-5,-355
1921,1,6,187,0,187,1921-1-6,-187
1921,1,7,112,0,112,1921-1-7,-112
1921,1,8,201,0,201,1921-1-8,-201
1921,1,9,812,0,812,1921-1-9,-812
1921,1,10,752,0,752,1921-1-10,-752
1921,1,11,1051,14,1037,1921-1-11,-1023
1921,1,12,1296,99,1197,1921-1-12,-1098
1921,1,13,1326,127,1199,1921-1-13,-1072
1921,1,14,1548,121,1427,1921-1-14,-1306
1921,1,15,1184,116,1068,1921-1-15,-952
1921,1,16,556,131,425,1921-1-16,-294
1921,1,17,516,278,238,1921-1-17,40
1921,1,18,471,290,181,1921-1-18,109
1921,1,19,535,291,244,1921-1-19,47
1921,1,20,655,241,414,1921-1-20,-173
1921,1,21,456,216,240,1921-1-21,-24
1921,1,22,343,194,149,1921-1-22,45
1921,1,23,266,155,111,1921-1-23,44
1921,1,24,226,165,61,1921-1-24,104
1921,1,25,52,22,30,1921-1-25,-8
1921,1,26,45,3,42,1921-1-26,-39
1921,1,27,67,27,40,1921-1-27,-13
1921,1,28,67,7,60,1921-1-28,-53
1921,1,29,28,0,28,1921-1-29,-28
1921,1,30,183,0,183,1921-1-30,-183
1921,1,31,276,0,276,1921-1-31,-276
1921,2,1,293,23,270,1921-2-1,-247
1921,2,2,323,28,295,1921-2-2,-267
1921,2,3,299,11,288,1921-2-3,-277
1921,2,4,287,5,282,1921-2-4,-277
1921,2,5,274,0,274,1921-2-5,-274
1921,2,6,273,0,273,1921-2-6,-273
1921,2,7,253,0,253,1921-2-7,-253
1921,2,8,322,0,322,1921-2-8,-322
1921,2,9,253,0,253,1921-2-9,-253
1921,2,10,298,0,298,1921-2-10,-298
1921,2,11,290,23,267,1921-2-11,-244
1921,2,12,426,49,377,1921-2-12,-328
1921,2,13,112,0,112,1921-2-13,-112
1921,2,14,90,0,90,1921-2-14,-90
1921,2,15,44,0,44,1921-2-15,-44
1921,2,16,19,0,19,1921-2-16,-19
1921,2,17,31,0,31,1921-2-17,-31
1921,2,18,171,0,171,1921-2-18,-171
1921,2,19,507,0,507,1921-2-19,-507
1921,2,20,864,0,864,1921-2-20,-864
1921,2,21,761,0,761,1921-2-21,-761
1921,2,22,776,0,776,1921-2-22,-776
1921,2,23,678,0,678,1921-2-23,-678
1921,2,24,761,0,761,1921-2-24,-761
1921,2,25,113,0,113,1921-2-25,-113
1921,2,26,56,0,56,1921-2-26,-56
1921,2,27,175,129,46,1921-2-27,83
1921,2,28,154,106,48,1921-2-28,58
1921,3,1,79,71,8,1921-3-1,63
1921,3,2,58,58,0,1921-3-2,58
1921,3,3,26,19,7,1921-3-3,12
1921,3,4,8,8,0,1921-3-4,8
1921,3,5,7,0,7,1921-3-5,-7
1921,3,6,0,0,0,1921-3-6,0
1921,3,7,10,0,10,1921-3-7,-10
1921,3,8,40,40,0,1921-3-8,40
1921,3,9,153,153,0,1921-3-9,153
1921,3,10,308,280,28,1921-3-10,252
1921,3,11,310,211,99,1921-3-11,112
1921,3,12,649,215,434,1921-3-12,-219
1921,3,13,438,199,239,1921-3-13,-40
1921,3,14,313,129,184,1921-3-14,-55
1921,3,15,314,130,184,1921-3-15,-54
1921,3,16,244,77,167,1921-3-16,-90
1921,3,17,166,29,137,1921-3-17,-108
1921,3,18,183,107,76,1921-3-18,31
1921,3,19,229,168,61,1921-3-19,107
1921,3,20,149,99,50,1921-3-20,49
1921,3,21,572,562,10,1921-3-21,552
1921,3,22,877,877,0,1921-3-22,877
1921,3,23,993,993,0,1921-3-23,993
1921,3,24,654,621,33,1921-3-24,588
1921,3,25,698,563,135,1921-3-25,428
1921,3,26,753,528,225,1921-3-26,303
1921,3,27,929,584,345,1921-3-27,239
1921,3,28,837,540,297,1921-3-28,243
1921,3,29,767,535,232,1921-3-29,303
1921,3,30,712,452,260,1921-3-30,192
1921,3,31,695,460,235,1921-3-31,225
1921,4,1,638,409,229,1921-4-1,180
1921,4,2,643,401,242,1921-4-2,159
1921,4,3,255,12,243,1921-4-3,-231
1921,4,4,327,9,318,1921-4-4,-309
1921,4,5,194,129,65,1921-4-5,64
1921,4,6,529,393,136,1921-4-6,257
1921,4,7,481,398,83,1921-4-7,315
1921,4,8,343,296,47,1921-4-8,249
1921,4,9,167,167,0,1921-4-9,167
1921,4,10,528,528,0,1921-4-10,528
1921,4,11,438,438,0,1921-4-11,438
1921,4,12,411,407,4,1921-4-12,403
1921,4,13,394,394,0,1921-4-13,394
1921,4,14,390,390,0,1921-4-14,390
1921,4,15,367,367,0,1921-4-15,367
1921,4,16,641,512,129,1921-4-16,383
1921,4,17,886,767,119,1921-4-17,648
1921,4,18,938,789,149,1921-4-18,640
1921,4,19,960,692,268,1921-4-19,424
1921,4,20,807,580,227,1921-4-20,353
1921,4,21,535,316,219,1921-4-21,97
1921,4,22,417,212,205,1921-4-22,7
1921,4,23,367,203,164,1921-4-23,39
1921,4,24,349,206,143,1921-4-24,63
1921,4,25,341,174,167,1921-4-25,7
1921,4,26,356,173,183,1921-4-26,-10
1921,4,27,335,184,151,1921-4-27,33
1921,4,28,223,155,68,1921-4-28,87
1921,4,29,197,197,0,1921-4-29,197
1921,4,30,0,0,0,1921-4-30,0
1921,5,1,4,4,0,1921-5-1,4
1921,5,2,138,138,0,1921-5-2,138
1921,5,3,284,284,0,1921-5-3,284
1921,5,4,287,287,0,1921-5-4,287
1921,5,5,0,0,0,1921-5-5,0
1921,5,6,0,0,0,1921-5-6,0
1921,5,7,0,0,0,1921-5-7,0
1921,5,8,493,493,0,1921-5-8,493
1921,5,9,1565,1565,0,1921-5-9,1565
1921,5,10,1695,0,1695,1921-5-10,-1695
1921,5,11,1715,6,1709,1921-5-11,-1703
1921,5,12,1396,1391,5,1921-5-12,1386
1921,5,13,1394,1394,0,1921-5-13,1394
1921,5,14,1391,1391,0,1921-5-14,1391
1921,5,15,1155,1155,0,1921-5-15,1155
1921,5,16,1177,1177,0,1921-5-16,1177
1921,5,17,1169,1169,0,1921-5-17,1169
1921,5,18,1196,1183,13,1921-5-18,1170
1921,5,19,1127,1120,7,1921-5-19,1113
1921,5,20,1355,1355,0,1921-5-20,1355
1921,5,21,488,488,0,1921-5-21,488
1921,5,22,75,75,0,1921-5-22,75
1921,5,23,96,96,0,1921-5-23,96
1921,5,24,74,74,0,1921-5-24,74
1921,5,25,18,18,0,1921-5-25,18
1921,5,26,22,22,0,1921-5-26,22
1921,5,27,155,13,142,1921-5-27,-129
1921,5,28,108,9,99,1921-5-28,-90
1921,5,29,75,0,75,1921-5-29,-75
1921,5,30,62,0,62,1921-5-30,-62
1921,5,31,11,7,4,1921-5-31,3
1921,6,1,116,99,17,1921-6-1,82
1921,6,2,105,100,5,1921-6-2,95
1921,6,3,122,104,18,1921-6-3,86
1921,6,4,195,195,0,1921-6-4,195
1921,6,5,181,181,0,1921-6-5,181
1921,6,6,222,222,0,1921-6-6,222
1921,6,7,319,315,4,1921-6-7,311
1921,6,8,354,331,23,1921-6-8,308
1921,6,9,455,384,71,1921-6-9,313
1921,6,10,413,388,25,1921-6-10,363
1921,6,11,336,320,16,1921-6-11,304
1921,6,12,338,294,44,1921-6-12,250
1921,6,13,248,224,24,1921-6-13,200
1921,6,14,288,269,19,1921-6-14,250
1921,6,15,311,311,0,1921-6-15,311
1921,6,16,129,129,0,1921-6-16,129
1921,6,17,158,158,0,1921-6-17,158
1921,6,18,129,129,0,1921-6-18,129
1921,6,19,176,176,0,1921-6-19,176
1921,6,20,155,155,0,1921-6-20,155
1921,6,21,226,226,0,1921-6-21,226
1921,6,22,214,214,0,1921-6-22,214
1921,6,23,279,279,0,1921-6-23,279
1921,6,24,373,354,19,1921-6-24,335
1921,6,25,327,321,6,1921-6-25,315
1921,6,26,703,390,313,1921-6-26,77
1921,6,27,892,459,433,1921-6-27,26
1921,6,28,1100,389,711,1921-6-28,-322
1921,6,29,1112,295,817,1921-6-29,-522
1921,6,30,1645,807,838,1921-6-30,-31
1921,7,1,1753,1071,682,1921-7-1,389
1921,7,2,1739,1181,558,1921-7-2,623
1921,7,3,1557,1127,430,1921-7-3,697
1921,7,4,1402,1033,369,1921-7-4,664
1921,7,5,1437,1071,366,1921-7-5,705
1921,7,6,1089,1004,85,1921-7-6,919
1921,7,7,836,836,0,1921-7-7,836
1921,7,8,731,723,8,1921-7-8,715
1921,7,9,759,676,83,1921-7-9,593
1921,7,10,647,551,96,1921-7-10,455
1921,7,11,558,428,130,1921-7-11,298
1921,7,12,633,430,203,1921-7-12,227
1921,7,13,552,276,276,1921-7-13,0
1921,7,14,360,11,349,1921-7-14,-338
1921,7,15,147,5,142,1921-7-15,-137
1921,7,16,81,0,81,1921-7-16,-81
1921,7,17,55,0,55,1921-7-17,-55
1921,7,18,50,0,50,1921-7-18,-50
1921,7,19,49,9,40,1921-7-19,-31
1921,7,20,50,0,50,1921-7-20,-50
1921,7,21,21,0,21,1921-7-21,-21
1921,7,22,16,0,16,1921-7-22,-16
1921,7,23,7,0,7,1921-7-23,-7
1921,7,24,24,0,24,1921-7-24,-24
1921,7,25,179,14,165,1921-7-25,-151
1921,7,26,439,37,402,1921-7-26,-365
1921,7,27,458,23,435,1921-7-27,-412
1921,7,28,581,14,567,1921-7-28,-553
1921,7,29,547,25,522,1921-7-29,-497
1921,7,30,615,12,603,1921-7-30,-591
1921,7,31,527,0,527,1921-7-31,-527
1921,8,1,439,0,439,1921-8-1,-439
1921,8,2,336,3,333,1921-8-2,-330
1921,8,3,237,0,237,1921-8-3,-237
1921,8,4,177,0,177,1921-8-4,-177
1921,8,5,64,0,64,1921-8-5,-64
1921,8,6,0,0,0,1921-8-6,0
1921,8,7,0,0,0,1921-8-7,0
1921,8,8,0,0,0,1921-8-8,0
1921,8,9,7,7,0,1921-8-9,7
1921,8,10,0,0,0,1921-8-10,0
1921,8,11,79,0,79,1921-8-11,-79
1921,8,12,114,0,114,1921-8-12,-114
1921,8,13,131,17,114,1921-8-13,-97
1921,8,14,86,7,79,1921-8-14,-72
1921,8,15,83,0,83,1921-8-15,-83
1921,8,16,239,46,193,1921-8-16,-147
1921,8,17,249,53,196,1921-8-17,-143
1921,8,18,270,48,222,1921-8-18,-174
1921,8,19,338,0,338,1921-8-19,-338
1921,8,20,331,0,331,1921-8-20,-331
1921,8,21,345,14,331,1921-8-21,-317
1921,8,22,343,58,285,1921-8-22,-227
1921,8,23,224,51,173,1921-8-23,-122
1921,8,24,255,109,146,1921-8-24,-37
1921,8,25,367,296,71,1921-8-25,225
1921,8,26,681,681,0,1921-8-26,681
1921,8,27,867,867,0,1921-8-27,867
1921,8,28,733,733,0,1921-8-28,733
1921,8,29,777,777,0,1921-8-29,777
1921,8,30,299,299,0,1921-8-30,299
1921,8,31,324,273,51,1921-8-31,222
1921,9,1,127,67,60,1921-9-1,7
1921,9,2,64,13,51,1921-9-2,-38
1921,9,3,78,37,41,1921-9-3,-4
1921,9,4,14,14,0,1921-9-4,14
1921,9,5,0,0,0,1921-9-5,0
1921,9,6,0,0,0,1921-9-6,0
1921,9,7,3,0,3,1921-9-7,-3
1921,9,8,0,0,0,1921-9-8,0
1921,9,9,0,0,0,1921-9-9,0
1921,9,10,17,0,17,1921-9-10,-17
1921,9,11,95,0,95,1921-9-11,-95
1921,9,12,520,346,174,1921-9-12,172
1921,9,13,799,568,231,1921-9-13,337
1921,9,14,666,495,171,1921-9-14,324
1921,9,15,644,508,136,1921-9-15,372
1921,9,16,640,492,148,1921-9-16,344
1921,9,17,567,484,83,1921-9-17,401
1921,9,18,642,507,135,1921-9-18,372
1921,9,19,526,463,63,1921-9-19,400
1921,9,20,497,431,66,1921-9-20,365
1921,9,21,524,403,121,1921-9-21,282
1921,9,22,543,399,144,1921-9-22,255
1921,9,23,477,344,133,1921-9-23,211
1921,9,24,456,356,100,1921-9-24,256
1921,9,25,501,501,0,1921-9-25,501
1921,9,26,167,167,0,1921-9-26,167
1921,9,27,280,280,0,1921-9-27,280
1921,9,28,418,418,0,1921-9-28,418
1921,9,29,560,560,0,1921-9-29,560
1921,9,30,161,161,0,1921-9-30,161
1921,10,1,3,3,0,1921-10-1,3
1921,10,2,0,0,0,1921-10-2,0
1921,10,3,0,0,0,1921-10-3,0
1921,10,4,0,0,0,1921-10-4,0
1921,10,5,0,0,0,1921-10-5,0
1921,10,6,0,0,0,1921-10-6,0
1921,10,7,0,0,0,1921-10-7,0
1921,10,8,49,5,44,1921-10-8,-39
1921,10,9,36,21,15,1921-10-9,6
1921,10,10,81,81,0,1921-10-10,81
1921,10,11,104,96,8,1921-10-11,88
1921,10,12,103,90,13,1921-10-12,77
1921,10,13,112,36,76,1921-10-13,-40
1921,10,14,266,259,7,1921-10-14,252
1921,10,15,184,184,0,1921-10-15,184
1921,10,16,177,177,0,1921-10-16,177
1921,10,17,158,158,0,1921-10-17,158
1921,10,18,174,174,0,1921-10-18,174
1921,10,19,123,123,0,1921-10-19,123
1921,10,20,105,105,0,1921-10-20,105
1921,10,21,85,85,0,1921-10-21,85
1921,10,22,120,94,26,1921-10-22,68
1921,10,23,524,524,0,1921-10-23,524
1921,10,24,974,974,0,1921-10-24,974
1921,10,25,1114,1114,0,1921-10-25,1114
1921,10,26,1403,1403,0,1921-10-26,1403
1921,10,27,1314,1314,0,1921-10-27,1314
1921,10,28,1501,1501,0,1921-10-28,1501
1921,10,29,380,380,0,1921-10-29,380
1921,10,30,299,299,0,1921-10-30,299
1921,10,31,241,241,0,1921-10-31,241
1921,11,1,210,201,9,1921-11-1,192
1921,11,2,157,157,0,1921-11-2,157
1921,11,3,0,0,0,1921-11-3,0
1921,11,4,0,0,0,1921-11-4,0
1921,11,5,0,0,0,1921-11-5,0
1921,11,6,0,0,0,1921-11-6,0
1921,11,7,0,0,0,1921-11-7,0
1921,11,8,0,0,0,1921-11-8,0
1921,11,9,0,0,0,1921-11-9,0
1921,11,10,4,4,0,1921-11-10,4
1921,11,11,0,0,0,1921-11-11,0
1921,11,12,459,456,3,1921-11-12,453
1921,11,13,507,507,0,1921-11-13,507
1921,11,14,514,514,0,1921-11-14,514
1921,11,15,527,527,0,1921-11-15,527
1921,11,16,535,535,0,1921-11-16,535
1921,11,17,700,700,0,1921-11-17,700
1921,11,18,606,606,0,1921-11-18,606
1921,11,19,1240,585,655,1921-11-19,-70
1921,11,20,1243,596,647,1921-11-20,-51
1921,11,21,1162,535,627,1921-11-21,-92
1921,11,22,1083,428,655,1921-11-22,-227
1921,11,23,1181,485,696,1921-11-23,-211
1921,11,24,1183,494,689,1921-11-24,-195
1921,11,25,678,86,592,1921-11-25,-506
1921,11,26,645,90,555,1921-11-26,-465
1921,11,27,586,71,515,1921-11-27,-444
1921,11,28,679,75,604,1921-11-28,-529
1921,11,29,554,18,536,1921-11-29,-518
1921,11,30,709,0,709,1921-11-30,-709
1921,12,1,10,10,0,1921-12-1,10
1921,12,2,20,9,11,1921-12-2,-2
1921,12,3,23,16,7,1921-12-3,9
1921,12,4,0,0,0,1921-12-4,0
1921,12,5,0,0,0,1921-12-5,0
1921,12,6,14,0,14,1921-12-6,-14
1921,12,7,0,0,0,1921-12-7,0
1921,12,8,0,0,0,1921-12-8,0
1921,12,9,248,248,0,1921-12-9,248
1921,12,10,218,218,0,1921-12-10,218
1921,12,11,386,386,0,1921-12-11,386
1921,12,12,412,412,0,1921-12-12,412
1921,12,13,561,561,0,1921-12-13,561
1921,12,14,666,666,0,1921-12-14,666
1921,12,15,1139,760,379,1921-12-15,381
1921,12,16,1251,771,480,1921-12-16,291
1921,12,17,1177,684,493,1921-12-17,191
1921,12,18,1346,858,488,1921-12-18,370
1921,12,19,1094,630,464,1921-12-19,166
1921,12,20,792,376,416,1921-12-20,-40
1921,12,21,685,255,430,1921-12-21,-175
1921,12,22,472,37,435,1921-12-22,-398
1921,12,23,395,20,375,1921-12-23,-355
1921,12,24,386,23,363,1921-12-24,-340
1921,12,25,316,2,314,1921-12-25,-312
1921,12,26,282,0,282,1921-12-26,-282
1921,12,27,334,56,278,1921-12-27,-222
1921,12,28,53,44,9,1921-12-28,35
1921,12,29,18,14,4,1921-12-29,10
1921,12,30,3,0,3,1921-12-30,-3
1921,12,31,7,0,7,1921-12-31,-7
1922,1,1,0,0,0,1922-1-1,0
1922,1,2,0,0,0,1922-1-2,0
1922,1,3,35,0,35,1922-1-3,-35
1922,1,4,17,0,17,1922-1-4,-17
1922,1,5,103,37,66,1922-1-5,-29
1922,1,6,66,38,28,1922-1-6,10
1922,1,7,142,59,83,1922-1-7,-24
1922,1,8,175,110,65,1922-1-8,45
1922,1,9,110,99,11,1922-1-9,88
1922,1,10,117,117,0,1922-1-10,117
1922,1,11,309,40,269,1922-1-11,-229
1922,1,12,179,41,138,1922-1-12,-97
1922,1,13,137,0,137,1922-1-13,-137
1922,1,14,229,51,178,1922-1-14,-127
1922,1,15,164,20,144,1922-1-15,-124
1922,1,16,151,0,151,1922-1-16,-151
1922,1,17,136,0,136,1922-1-17,-136
1922,1,18,139,0,139,1922-1-18,-139
1922,1,19,124,0,124,1922-1-19,-124
1922,1,20,124,0,124,1922-1-20,-124
1922,1,21,122,0,122,1922-1-21,-122
1922,1,22,109,0,109,1922-1-22,-109
1922,1,23,116,0,116,1922-1-23,-116
1922,1,24,0,0,0,1922-1-24,0
1922,1,25,0,0,0,1922-1-25,0
1922,1,26,0,0,0,1922-1-26,0
1922,1,27,0,0,0,1922-1-27,0
1922,1,28,0,0,0,1922-1-28,0
1922,1,29,0,0,0,1922-1-29,0
1922,1,30,1,0,1,1922-1-30,-1
1922,1,31,0,0,0,1922-1-31,0
1922,2,1,10,0,10,1922-2-1,-10
1922,2,2,22,0,22,1922-2-2,-22
1922,2,3,12,0,12,1922-2-3,-12
1922,2,4,6,0,6,1922-2-4,-6
1922,2,5,13,13,0,1922-2-5,13
1922,2,6,53,27,26,1922-2-6,1
1922,2,7,213,98,115,1922-2-7,-17
1922,2,8,295,200,95,1922-2-8,105
1922,2,9,290,177,113,1922-2-9,64
1922,2,10,346,208,138,1922-2-10,70
1922,2,11,933,632,301,1922-2-11,331
1922,2,12,1705,932,773,1922-2-12,159
1922,2,13,2262,1478,784,1922-2-13,694
1922,2,14,2080,1365,715,1922-2-14,650
1922,2,15,631,0,631,1922-2-15,-631
1922,2,16,493,0,493,1922-2-16,-493
1922,2,17,442,0,442,1922-2-17,-442
1922,2,18,514,0,514,1922-2-18,-514
1922,2,19,437,0,437,1922-2-19,-437
1922,2,20,154,0,154,1922-2-20,-154
1922,2,21,124,0,124,1922-2-21,-124
1922,2,22,118,0,118,1922-2-22,-118
1922,2,23,122,0,122,1922-2-23,-122
1922,2,24,282,158,124,1922-2-24,34
1922,2,25,332,220,112,1922-2-25,108
1922,2,26,353,247,106,1922-2-26,141
1922,2,27,555,456,99,1922-2-27,357
1922,2,28,1006,887,119,1922-2-28,768
1922,3,1,2510,2382,128,1922-3-1,2254
1922,3,2,3315,3232,83,1922-3-2,3149
1922,3,3,3509,3405,104,1922-3-3,3301
1922,3,4,2963,2963,0,1922-3-4,2963
1922,3,5,3011,3011,0,1922-3-5,3011
1922,3,6,3297,2587,710,1922-3-6,1877
1922,3,7,3377,2689,688,1922-3-7,2001
1922,3,8,2660,1948,712,1922-3-8,1236
1922,3,9,2080,1310,770,1922-3-9,540
1922,3,10,1827,1037,790,1922-3-10,247
1922,3,11,1801,893,908,1922-3-11,-15
1922,3,12,1768,738,1030,1922-3-12,-292
1922,3,13,1214,422,792,1922-3-13,-370
1922,3,14,574,115,459,1922-3-14,-344
1922,3,15,369,105,264,1922-3-15,-159
1922,3,16,225,124,101,1922-3-16,23
1922,3,17,163,127,36,1922-3-17,91
1922,3,18,159,104,55,1922-3-18,49
1922,3,19,77,0,77,1922-3-19,-77
1922,3,20,49,0,49,1922-3-20,-49
1922,3,21,23,0,23,1922-3-21,-23
1922,3,22,6,0,6,1922-3-22,-6
1922,3,23,344,340,4,1922-3-23,336
1922,3,24,552,552,0,1922-3-24,552
1922,3,25,433,423,10,1922-3-25,413
1922,3,26,323,323,0,1922-3-26,323
1922,3,27,336,336,0,1922-3-27,336
1922,3,28,438,438,0,1922-3-28,438
1922,3,29,335,335,0,1922-3-29,335
1922,3,30,301,301,0,1922-3-30,301
1922,3,31,273,273,0,1922-3-31,273
1922,4,1,372,372,0,1922-4-1,372
1922,4,2,345,345,0,1922-4-2,345
1922,4,3,335,335,0,1922-4-3,335
1922,4,4,189,189,0,1922-4-4,189
1922,4,5,135,135,0,1922-4-5,135
1922,4,6,154,150,4,1922-4-6,146
1922,4,7,136,136,0,1922-4-7,136
1922,4,8,80,80,0,1922-4-8,80
1922,4,9,12,0,12,1922-4-9,-12
1922,4,10,8,0,8,1922-4-10,-8
1922,4,11,13,0,13,1922-4-11,-13
1922,4,12,0,0,0,1922-4-12,0
1922,4,13,0,0,0,1922-4-13,0
1922,4,14,0,0,0,1922-4-14,0
1922,4,15,0,0,0,1922-4-15,0
1922,4,16,0,0,0,1922-4-16,0
1922,4,17,0,0,0,1922-4-17,0
1922,4,18,7,0,7,1922-4-18,-7
1922,4,19,0,0,0,1922-4-19,0
1922,4,20,0,0,0,1922-4-20,0
1922,4,21,0,0,0,1922-4-21,0
1922,4,22,10,10,0,1922-4-22,10
1922,4,23,45,45,0,1922-4-23,45
1922,4,24,177,177,0,1922-4-24,177
1922,4,25,136,136,0,1922-4-25,136
1922,4,26,92,92,0,1922-4-26,92
1922,4,27,46,46,0,1922-4-27,46
1922,4,28,54,54,0,1922-4-28,54
1922,4,29,61,61,0,1922-4-29,61
1922,4,30,154,154,0,1922-4-30,154
1922,5,1,553,553,0,1922-5-1,553
1922,5,2,540,537,3,1922-5-2,534
1922,5,3,493,493,0,1922-5-3,493
1922,5,4,394,394,0,1922-5-4,394
1922,5,5,330,330,0,1922-5-5,330
1922,5,6,274,274,0,1922-5-6,274
1922,5,7,266,266,0,1922-5-7,266
1922,5,8,236,236,0,1922-5-8,236
1922,5,9,254,254,0,1922-5-9,254
1922,5,10,0,0,0,1922-5-10,0
1922,5,11,4,4,0,1922-5-11,4
1922,5,12,0,0,0,1922-5-12,0
1922,5,13,0,0,0,1922-5-13,0
1922,5,14,0,0,0,1922-5-14,0
1922,5,15,0,0,0,1922-5-15,0
1922,5,16,0,0,0,1922-5-16,0
1922,5,17,0,0,0,1922-5-17,0
1922,5,18,0,0,0,1922-5-18,0
1922,5,19,0,0,0,1922-5-19,0
1922,5,20,0,0,0,1922-5-20,0
1922,5,21,0,0,0,1922-5-21,0
1922,5,22,0,0,0,1922-5-22,0
1922,5,23,0,0,0,1922-5-23,0
1922,5,24,127,127,0,1922-5-24,127
1922,5,25,93,93,0,1922-5-25,93
1922,5,26,47,47,0,1922-5-26,47
1922,5,27,57,57,0,1922-5-27,57
1922,5,28,25,25,0,1922-5-28,25
1922,5,29,33,33,0,1922-5-29,33
1922,5,30,25,25,0,1922-5-30,25
1922,5,31,87,87,0,1922-5-31,87
1922,6,1,9,9,0,1922-6-1,9
1922,6,2,0,0,0,1922-6-2,0
1922,6,3,0,0,0,1922-6-3,0
1922,6,4,0,0,0,1922-6-4,0
1922,6,5,0,0,0,1922-6-5,0
1922,6,6,0,0,0,1922-6-6,0
1922,6,7,23,23,0,1922-6-7,23
1922,6,8,15,15,0,1922-6-8,15
1922,6,9,14,14,0,1922-6-9,14
1922,6,10,0,0,0,1922-6-10,0
1922,6,11,51,51,0,1922-6-11,51
1922,6,12,68,68,0,1922-6-12,68
1922,6,13,35,35,0,1922-6-13,35
1922,6,14,46,46,0,1922-6-14,46
1922,6,15,53,35,18,1922-6-15,17
1922,6,16,69,0,69,1922-6-16,-69
1922,6,17,43,0,43,1922-6-17,-43
1922,6,18,0,0,0,1922-6-18,0
1922,6,19,9,1,8,1922-6-19,-7
1922,6,20,0,0,0,1922-6-20,0
1922,6,21,17,0,17,1922-6-21,-17
1922,6,22,13,0,13,1922-6-22,-13
1922,6,23,1,0,1,1922-6-23,-1
1922,6,24,11,4,7,1922-6-24,-3
1922,6,25,6,0,6,1922-6-25,-6
1922,6,26,0,0,0,1922-6-26,0
1922,6,27,0,0,0,1922-6-27,0
1922,6,28,0,0,0,1922-6-28,0
1922,6,29,0,0,0,1922-6-29,0
1922,6,30,0,0,0,1922-6-30,0
1922,7,1,0,0,0,1922-7-1,0
1922,7,2,0,0,0,1922-7-2,0
1922,7,3,0,0,0,1922-7-3,0
1922,7,4,10,10,0,1922-7-4,10
1922,7,5,38,8,30,1922-7-5,-22
1922,7,6,143,110,33,1922-7-6,77
1922,7,7,87,62,25,1922-7-7,37
1922,7,8,112,81,31,1922-7-8,50
1922,7,9,64,50,14,1922-7-9,36
1922,7,10,55,32,23,1922-7-10,9
1922,7,11,21,10,11,1922-7-11,-1
1922,7,12,10,10,0,1922-7-12,10
1922,7,13,0,0,0,1922-7-13,0
1922,7,14,6,0,6,1922-7-14,-6
1922,7,15,0,0,0,1922-7-15,0
1922,7,16,0,0,0,1922-7-16,0
1922,7,17,0,0,0,1922-7-17,0
1922,7,18,0,0,0,1922-7-18,0
1922,7,19,302,0,302,1922-7-19,-302
1922,7,20,502,0,502,1922-7-20,-502
1922,7,21,449,0,449,1922-7-21,-449
1922,7,22,371,0,371,1922-7-22,-371
1922,7,23,402,0,402,1922-7-23,-402
1922,7,24,294,0,294,1922-7-24,-294
1922,7,25,277,0,277,1922-7-25,-277
1922,7,26,209,0,209,1922-7-26,-209
1922,7,27,160,0,160,1922-7-27,-160
1922,7,28,108,0,108,1922-7-28,-108
1922,7,29,0,0,0,1922-7-29,0
1922,7,30,0,0,0,1922-7-30,0
1922,7,31,0,0,0,1922-7-31,0
1922,8,1,0,0,0,1922-8-1,0
1922,8,2,41,41,0,1922-8-2,41
1922,8,3,44,44,0,1922-8-3,44
1922,8,4,38,38,0,1922-8-4,38
1922,8,5,9,9,0,1922-8-5,9
1922,8,6,27,6,21,1922-8-6,-15
1922,8,7,4,0,4,1922-8-7,-4
1922,8,8,0,0,0,1922-8-8,0
1922,8,9,0,0,0,1922-8-9,0
1922,8,10,0,0,0,1922-8-10,0
1922,8,11,0,0,0,1922-8-11,0
1922,8,12,0,0,0,1922-8-12,0
1922,8,13,0,0,0,1922-8-13,0
1922,8,14,0,0,0,1922-8-14,0
1922,8,15,0,0,0,1922-8-15,0
1922,8,16,0,0,0,1922-8-16,0
1922,8,17,0,0,0,1922-8-17,0
1922,8,18,0,0,0,1922-8-18,0
1922,8,19,0,0,0,1922-8-19,0
1922,8,20,0,0,0,1922-8-20,0
1922,8,21,5,2,3,1922-8-21,-1
1922,8,22,0,0,0,1922-8-22,0
1922,8,23,18,0,18,1922-8-23,-18
1922,8,24,144,0,144,1922-8-24,-144
1922,8,25,415,0,415,1922-8-25,-415
1922,8,26,503,0,503,1922-8-26,-503
1922,8,27,364,5,359,1922-8-27,-354
1922,8,28,515,66,449,1922-8-28,-383
1922,8,29,215,215,0,1922-8-29,215
1922,8,30,221,221,0,1922-8-30,221
1922,8,31,122,122,0,1922-8-31,122
1922,9,1,5,5,0,1922-9-1,5
1922,9,2,0,0,0,1922-9-2,0
1922,9,3,0,0,0,1922-9-3,0
1922,9,4,0,0,0,1922-9-4,0
1922,9,5,0,0,0,1922-9-5,0
1922,9,6,0,0,0,1922-9-6,0
1922,9,7,3,0,3,1922-9-7,-3
1922,9,8,0,0,0,1922-9-8,0
1922,9,9,0,0,0,1922-9-9,0
1922,9,10,0,0,0,1922-9-10,0
1922,9,11,5,5,0,1922-9-11,5
1922,9,12,0,0,0,1922-9-12,0
1922,9,13,231,0,231,1922-9-13,-231
1922,9,14,202,0,202,1922-9-14,-202
1922,9,15,171,0,171,1922-9-15,-171
1922,9,16,140,0,140,1922-9-16,-140
1922,9,17,140,0,140,1922-9-17,-140
1922,9,18,119,0,119,1922-9-18,-119
1922,9,19,124,0,124,1922-9-19,-124
1922,9,20,126,9,117,1922-9-20,-108
1922,9,21,124,3,121,1922-9-21,-118
1922,9,22,121,0,121,1922-9-22,-121
1922,9,23,118,0,118,1922-9-23,-118
1922,9,24,73,0,73,1922-9-24,-73
1922,9,25,0,0,0,1922-9-25,0
1922,9,26,0,0,0,1922-9-26,0
1922,9,27,8,8,0,1922-9-27,8
1922,9,28,0,0,0,1922-9-28,0
1922,9,29,4,0,4,1922-9-29,-4
1922,9,30,11,0,11,1922-9-30,-11
1922,10,1,35,0,35,1922-10-1,-35
1922,10,2,29,2,27,1922-10-2,-25
1922,10,3,17,0,17,1922-10-3,-17
1922,10,4,21,0,21,1922-10-4,-21
1922,10,5,6,0,6,1922-10-5,-6
1922,10,6,0,0,0,1922-10-6,0
1922,10,7,0,0,0,1922-10-7,0
1922,10,8,0,0,0,1922-10-8,0
1922,10,9,11,11,0,1922-10-9,11
1922,10,10,172,148,24,1922-10-10,124
1922,10,11,132,120,12,1922-10-11,108
1922,10,12,68,65,3,1922-10-12,62
1922,10,13,25,22,3,1922-10-13,19
1922,10,14,5,5,0,1922-10-14,5
1922,10,15,0,0,0,1922-10-15,0
1922,10,16,35,35,0,1922-10-16,35
1922,10,17,40,40,0,1922-10-17,40
1922,10,18,24,24,0,1922-10-18,24
1922,10,19,130,16,114,1922-10-19,-98
1922,10,20,459,7,452,1922-10-20,-445
1922,10,21,678,0,678,1922-10-21,-678
1922,10,22,0,0,0,1922-10-22,0
1922,10,23,0,0,0,1922-10-23,0
1922,10,24,0,0,0,1922-10-24,0
1922,10,25,0,0,0,1922-10-25,0
1922,10,26,0,0,0,1922-10-26,0
1922,10,27,0,0,0,1922-10-27,0
1922,10,28,0,0,0,1922-10-28,0
1922,10,29,16,0,16,1922-10-29,-16
1922,10,30,18,0,18,1922-10-30,-18
1922,10,31,49,0,49,1922-10-31,-49
1922,11,1,35,0,35,1922-11-1,-35
1922,11,2,21,0,21,1922-11-2,-21
1922,11,3,9,0,9,1922-11-3,-9
1922,11,4,0,0,0,1922-11-4,0
1922,11,5,463,0,463,1922-11-5,-463
1922,11,6,414,0,414,1922-11-6,-414
1922,11,7,374,0,374,1922-11-7,-374
1922,11,8,299,0,299,1922-11-8,-299
1922,11,9,326,0,326,1922-11-9,-326
1922,11,10,296,0,296,1922-11-10,-296
1922,11,11,282,0,282,1922-11-11,-282
1922,11,12,315,0,315,1922-11-12,-315
1922,11,13,283,9,274,1922-11-13,-265
1922,11,14,277,15,262,1922-11-14,-247
1922,11,15,253,8,245,1922-11-15,-237
1922,11,16,233,0,233,1922-11-16,-233
1922,11,17,207,0,207,1922-11-17,-207
1922,11,18,0,0,0,1922-11-18,0
1922,11,19,0,0,0,1922-11-19,0
1922,11,20,15,15,0,1922-11-20,15
1922,11,21,45,45,0,1922-11-21,45
1922,11,22,39,39,0,1922-11-22,39
1922,11,23,0,0,0,1922-11-23,0
1922,11,24,0,0,0,1922-11-24,0
1922,11,25,2,2,0,1922-11-25,2
1922,11,26,0,0,0,1922-11-26,0
1922,11,27,2,2,0,1922-11-27,2
1922,11,28,303,0,303,1922-11-28,-303
1922,11,29,383,0,383,1922-11-29,-383
1922,11,30,413,0,413,1922-11-30,-413
1922,12,1,294,0,294,1922-12-1,-294
1922,12,2,316,0,316,1922-12-2,-316
1922,12,3,267,0,267,1922-12-3,-267
1922,12,4,297,0,297,1922-12-4,-297
1922,12,5,269,0,269,1922-12-5,-269
1922,12,6,206,0,206,1922-12-6,-206
1922,12,7,241,0,241,1922-12-7,-241
1922,12,8,195,0,195,1922-12-8,-195
1922,12,9,198,0,198,1922-12-9,-198
1922,12,10,179,0,179,1922-12-10,-179
1922,12,11,27,0,27,1922-12-11,-27
1922,12,12,0,0,0,1922-12-12,0
1922,12,13,0,0,0,1922-12-13,0
1922,12,14,0,0,0,1922-12-14,0
1922,12,15,0,0,0,1922-12-15,0
1922,12,16,0,0,0,1922-12-16,0
1922,12,17,0,0,0,1922-12-17,0
1922,12,18,0,0,0,1922-12-18,0
1922,12,19,0,0,0,1922-12-19,0
1922,12,20,0,0,0,1922-12-20,0
1922,12,21,0,0,0,1922-12-21,0
1922,12,22,622,622,0,1922-12-22,622
1922,12,23,1277,1277,0,1922-12-23,1277
1922,12,24,1323,1323,0,1922-12-24,1323
1922,12,25,1458,1385,73,1922-12-25,1312
1922,12,26,1575,1497,78,1922-12-26,1419
1922,12,27,1323,1257,66,1922-12-27,1191
1922,12,28,1411,1348,63,1922-12-28,1285
1922,12,29,1293,1250,43,1922-12-29,1207
1922,12,30,1068,1042,26,1922-12-30,1016
1922,12,31,981,964,17,1922-12-31,947
1923,1,1,891,881,10,1923-1-1,871
1923,1,2,762,755,7,1923-1-2,748
1923,1,3,784,781,3,1923-1-3,778
1923,1,4,244,241,3,1923-1-4,238
1923,1,5,0,0,0,1923-1-5,0
1923,1,6,0,0,0,1923-1-6,0
1923,1,7,0,0,0,1923-1-7,0
1923,1,8,0,0,0,1923-1-8,0
1923,1,9,0,0,0,1923-1-9,0
1923,1,10,0,0,0,1923-1-10,0
1923,1,11,0,0,0,1923-1-11,0
1923,1,12,0,0,0,1923-1-12,0
1923,1,13,0,0,0,1923-1-13,0
1923,1,14,0,0,0,1923-1-14,0
1923,1,15,0,0,0,1923-1-15,0
1923,1,16,0,0,0,1923-1-16,0
1923,1,17,0,0,0,1923-1-17,0
1923,1,18,0,0,0,1923-1-18,0
1923,1,19,0,0,0,1923-1-19,0
1923,1,20,0,0,0,1923-1-20,0
1923,1,21,11,0,11,1923-1-21,-11
1923,1,22,17,0,17,1923-1-22,-17
1923,1,23,16,14,2,1923-1-23,12
1923,1,24,0,0,0,1923-1-24,0
1923,1,25,0,0,0,1923-1-25,0
1923,1,26,0,0,0,1923-1-26,0
1923,1,27,0,0,0,1923-1-27,0
1923,1,28,16,16,0,1923-1-28,16
1923,1,29,37,37,0,1923-1-29,37
1923,1,30,51,51,0,1923-1-30,51
1923,1,31,71,71,0,1923-1-31,71
1923,2,1,0,0,0,1923-2-1,0
1923,2,2,0,0,0,1923-2-2,0
1923,2,3,0,0,0,1923-2-3,0
1923,2,4,0,0,0,1923-2-4,0
1923,2,5,0,0,0,1923-2-5,0
1923,2,6,0,0,0,1923-2-6,0
1923,2,7,0,0,0,1923-2-7,0
1923,2,8,0,0,0,1923-2-8,0
1923,2,9,0,0,0,1923-2-9,0
1923,2,10,0,0,0,1923-2-10,0
1923,2,11,0,0,0,1923-2-11,0
1923,2,12,13,2,11,1923-2-12,-9
1923,2,13,8,8,0,1923-2-13,8
1923,2,14,5,5,0,1923-2-14,5
1923,2,15,12,12,0,1923-2-15,12
1923,2,16,3,3,0,1923-2-16,3
1923,2,17,0,0,0,1923-2-17,0
1923,2,18,0,0,0,1923-2-18,0
1923,2,19,4,4,0,1923-2-19,4
1923,2,20,3,3,0,1923-2-20,3
1923,2,21,0,0,0,1923-2-21,0
1923,2,22,0,0,0,1923-2-22,0
1923,2,23,3,3,0,1923-2-23,3
1923,2,24,0,0,0,1923-2-24,0
1923,2,25,0,0,0,1923-2-25,0
1923,2,26,0,0,0,1923-2-26,0
1923,2,27,0,0,0,1923-2-27,0
1923,2,28,0,0,0,1923-2-28,0
1923,3,1,0,0,0,1923-3-1,0
1923,3,2,0,0,0,1923-3-2,0
1923,3,3,0,0,0,1923-3-3,0
1923,3,4,0,0,0,1923-3-4,0
1923,3,5,0,0,0,1923-3-5,0
1923,3,6,0,0,0,1923-3-6,0
1923,3,7,0,0,0,1923-3-7,0
1923,3,8,0,0,0,1923-3-8,0
1923,3,9,0,0,0,1923-3-9,0
1923,3,10,0,0,0,1923-3-10,0
1923,3,11,0,0,0,1923-3-11,0
1923,3,12,0,0,0,1923-3-12,0
1923,3,13,0,0,0,1923-3-13,0
1923,3,14,0,0,0,1923-3-14,0
1923,3,15,21,21,0,1923-3-15,21
1923,3,16,13,13,0,1923-3-16,13
1923,3,17,7,0,7,1923-3-17,-7
1923,3,18,0,0,0,1923-3-18,0
1923,3,19,0,0,0,1923-3-19,0
1923,3,20,2,0,2,1923-3-20,-2
1923,3,21,0,0,0,1923-3-21,0
1923,3,22,55,55,0,1923-3-22,55
1923,3,23,28,28,0,1923-3-23,28
1923,3,24,9,9,0,1923-3-24,9
1923,3,25,29,29,0,1923-3-25,29
1923,3,26,16,16,0,1923-3-26,16
1923,3,27,0,0,0,1923-3-27,0
1923,3,28,0,0,0,1923-3-28,0
1923,3,29,57,57,0,1923-3-29,57
1923,3,30,144,144,0,1923-3-30,144
1923,3,31,116,116,0,1923-3-31,116
1923,4,1,75,75,0,1923-4-1,75
1923,4,2,37,37,0,1923-4-2,37
1923,4,3,1,1,0,1923-4-3,1
1923,4,4,0,0,0,1923-4-4,0
1923,4,5,0,0,0,1923-4-5,0
1923,4,6,0,0,0,1923-4-6,0
1923,4,7,0,0,0,1923-4-7,0
1923,4,8,0,0,0,1923-4-8,0
1923,4,9,0,0,0,1923-4-9,0
1923,4,10,7,7,0,1923-4-10,7
1923,4,11,0,0,0,1923-4-11,0
1923,4,12,0,0,0,1923-4-12,0
1923,4,13,0,0,0,1923-4-13,0
1923,4,14,12,0,12,1923-4-14,-12
1923,4,15,12,5,7,1923-4-15,-2
1923,4,16,0,0,0,1923-4-16,0
1923,4,17,36,36,0,1923-4-17,36
1923,4,18,19,19,0,1923-4-18,19
1923,4,19,31,5,26,1923-4-19,-21
1923,4,20,82,0,82,1923-4-20,-82
1923,4,21,126,0,126,1923-4-21,-126
1923,4,22,130,0,130,1923-4-22,-130
1923,4,23,42,0,42,1923-4-23,-42
1923,4,24,42,0,42,1923-4-24,-42
1923,4,25,41,0,41,1923-4-25,-41
1923,4,26,37,0,37,1923-4-26,-37
1923,4,27,38,0,38,1923-4-27,-38
1923,4,28,92,0,92,1923-4-28,-92
1923,4,29,45,0,45,1923-4-29,-45
1923,4,30,8,8,0,1923-4-30,8
1923,5,1,0,0,0,1923-5-1,0
1923,5,2,0,0,0,1923-5-2,0
1923,5,3,0,0,0,1923-5-3,0
1923,5,4,0,0,0,1923-5-4,0
1923,5,5,0,0,0,1923-5-5,0
1923,5,6,0,0,0,1923-5-6,0
1923,5,7,0,0,0,1923-5-7,0
1923,5,8,0,0,0,1923-5-8,0
1923,5,9,0,0,0,1923-5-9,0
1923,5,10,0,0,0,1923-5-10,0
1923,5,11,2,2,0,1923-5-11,2
1923,5,12,21,21,0,1923-5-12,21
1923,5,13,15,15,0,1923-5-13,15
1923,5,14,5,5,0,1923-5-14,5
1923,5,15,0,0,0,1923-5-15,0
1923,5,16,0,0,0,1923-5-16,0
1923,5,17,0,0,0,1923-5-17,0
1923,5,18,0,0,0,1923-5-18,0
1923,5,19,0,0,0,1923-5-19,0
1923,5,20,8,8,0,1923-5-20,8
1923,5,21,4,4,0,1923-5-21,4
1923,5,22,0,0,0,1923-5-22,0
1923,5,23,44,0,44,1923-5-23,-44
1923,5,24,51,0,51,1923-5-24,-51
1923,5,25,41,0,41,1923-5-25,-41
1923,5,26,1,1,0,1923-5-26,1
1923,5,27,87,87,0,1923-5-27,87
1923,5,28,108,108,0,1923-5-28,108
1923,5,29,93,93,0,1923-5-29,93
1923,5,30,75,75,0,1923-5-30,75
1923,5,31,48,48,0,1923-5-31,48
1923,6,1,34,26,8,1923-6-1,18
1923,6,2,60,8,52,1923-6-2,-44
1923,6,3,31,4,27,1923-6-3,-23
1923,6,4,4,0,4,1923-6-4,-4
1923,6,5,3,0,3,1923-6-5,-3
1923,6,6,0,0,0,1923-6-6,0
1923,6,7,0,0,0,1923-6-7,0
1923,6,8,0,0,0,1923-6-8,0
1923,6,9,0,0,0,1923-6-9,0
1923,6,10,0,0,0,1923-6-10,0
1923,6,11,0,0,0,1923-6-11,0
1923,6,12,0,0,0,1923-6-12,0
1923,6,13,0,0,0,1923-6-13,0
1923,6,14,0,0,0,1923-6-14,0
1923,6,15,0,0,0,1923-6-15,0
1923,6,16,0,0,0,1923-6-16,0
1923,6,17,0,0,0,1923-6-17,0
1923,6,18,34,0,34,1923-6-18,-34
1923,6,19,57,0,57,1923-6-19,-57
1923,6,20,26,0,26,1923-6-20,-26
1923,6,21,39,7,32,1923-6-21,-25
1923,6,22,46,0,46,1923-6-22,-46
1923,6,23,23,0,23,1923-6-23,-23
1923,6,24,18,3,15,1923-6-24,-12
1923,6,25,228,215,13,1923-6-25,202
1923,6,26,293,293,0,1923-6-26,293
1923,6,27,169,169,0,1923-6-27,169
1923,6,28,131,131,0,1923-6-28,131
1923,6,29,400,400,0,1923-6-29,400
1923,6,30,611,611,0,1923-6-30,611
1923,7,1,509,509,0,1923-7-1,509
1923,7,2,166,166,0,1923-7-2,166
1923,7,3,65,65,0,1923-7-3,65
1923,7,4,0,0,0,1923-7-4,0
1923,7,5,0,0,0,1923-7-5,0
1923,7,6,0,0,0,1923-7-6,0
1923,7,7,0,0,0,1923-7-7,0
1923,7,8,0,0,0,1923-7-8,0
1923,7,9,0,0,0,1923-7-9,0
1923,7,10,0,0,0,1923-7-10,0
1923,7,11,5,5,0,1923-7-11,5
1923,7,12,0,0,0,1923-7-12,0
1923,7,13,0,0,0,1923-7-13,0
1923,7,14,0,0,0,1923-7-14,0
1923,7,15,0,0,0,1923-7-15,0
1923,7,16,0,0,0,1923-7-16,0
1923,7,17,0,0,0,1923-7-17,0
1923,7,18,0,0,0,1923-7-18,0
1923,7,19,0,0,0,1923-7-19,0
1923,7,20,0,0,0,1923-7-20,0
1923,7,21,0,0,0,1923-7-21,0
1923,7,22,24,24,0,1923-7-22,24
1923,7,23,12,12,0,1923-7-23,12
1923,7,24,8,8,0,1923-7-24,8
1923,7,25,9,9,0,1923-7-25,9
1923,7,26,4,4,0,1923-7-26,4
1923,7,27,3,3,0,1923-7-27,3
1923,7,28,3,3,0,1923-7-28,3
1923,7,29,26,26,0,1923-7-29,26
1923,7,30,57,16,41,1923-7-30,-25
1923,7,31,18,8,10,1923-7-31,-2
1923,8,1,7,0,7,1923-8-1,-7
1923,8,2,0,0,0,1923-8-2,0
1923,8,3,17,0,17,1923-8-3,-17
1923,8,4,3,0,3,1923-8-4,-3
1923,8,5,0,0,0,1923-8-5,0
1923,8,6,0,0,0,1923-8-6,0
1923,8,7,6,0,6,1923-8-7,-6
1923,8,8,0,0,0,1923-8-8,0
1923,8,9,0,0,0,1923-8-9,0
1923,8,10,0,0,0,1923-8-10,0
1923,8,11,0,0,0,1923-8-11,0
1923,8,12,0,0,0,1923-8-12,0
1923,8,13,0,0,0,1923-8-13,0
1923,8,14,0,0,0,1923-8-14,0
1923,8,15,0,0,0,1923-8-15,0
1923,8,16,12,12,0,1923-8-16,12
1923,8,17,0,0,0,1923-8-17,0
1923,8,18,0,0,0,1923-8-18,0
1923,8,19,0,0,0,1923-8-19,0
1923,8,20,7,3,4,1923-8-20,-1
1923,8,21,2,2,0,1923-8-21,2
1923,8,22,0,0,0,1923-8-22,0
1923,8,23,0,0,0,1923-8-23,0
1923,8,24,0,0,0,1923-8-24,0
1923,8,25,0,0,0,1923-8-25,0
1923,8,26,0,0,0,1923-8-26,0
1923,8,27,0,0,0,1923-8-27,0
1923,8,28,0,0,0,1923-8-28,0
1923,8,29,0,0,0,1923-8-29,0
1923,8,30,0,0,0,1923-8-30,0
1923,8,31,0,0,0,1923-8-31,0
1923,9,1,57,0,57,1923-9-1,-57
1923,9,2,71,0,71,1923-9-2,-71
1923,9,3,218,0,218,1923-9-3,-218
1923,9,4,277,0,277,1923-9-4,-277
1923,9,5,228,0,228,1923-9-5,-228
1923,9,6,183,0,183,1923-9-6,-183
1923,9,7,223,31,192,1923-9-7,-161
1923,9,8,315,134,181,1923-9-8,-47
1923,9,9,300,152,148,1923-9-9,4
1923,9,10,158,158,0,1923-9-10,158
1923,9,11,115,115,0,1923-9-11,115
1923,9,12,97,97,0,1923-9-12,97
1923,9,13,111,111,0,1923-9-13,111
1923,9,14,106,106,0,1923-9-14,106
1923,9,15,112,112,0,1923-9-15,112
1923,9,16,83,83,0,1923-9-16,83
1923,9,17,72,72,0,1923-9-17,72
1923,9,18,54,54,0,1923-9-18,54
1923,9,19,10,10,0,1923-9-19,10
1923,9,20,0,0,0,1923-9-20,0
1923,9,21,0,0,0,1923-9-21,0
1923,9,22,0,0,0,1923-9-22,0
1923,9,23,0,0,0,1923-9-23,0
1923,9,24,53,0,53,1923-9-24,-53
1923,9,25,247,0,247,1923-9-25,-247
1923,9,26,251,0,251,1923-9-26,-251
1923,9,27,188,0,188,1923-9-27,-188
1923,9,28,164,0,164,1923-9-28,-164
1923,9,29,172,0,172,1923-9-29,-172
1923,9,30,168,0,168,1923-9-30,-168
1923,10,1,175,0,175,1923-10-1,-175
1923,10,2,166,0,166,1923-10-2,-166
1923,10,3,156,0,156,1923-10-3,-156
1923,10,4,146,0,146,1923-10-4,-146
1923,10,5,166,6,160,1923-10-5,-154
1923,10,6,264,0,264,1923-10-6,-264
1923,10,7,0,0,0,1923-10-7,0
1923,10,8,0,0,0,1923-10-8,0
1923,10,9,124,124,0,1923-10-9,124
1923,10,10,107,107,0,1923-10-10,107
1923,10,11,104,104,0,1923-10-11,104
1923,10,12,108,108,0,1923-10-12,108
1923,10,13,98,98,0,1923-10-13,98
1923,10,14,84,84,0,1923-10-14,84
1923,10,15,90,90,0,1923-10-15,90
1923,10,16,80,80,0,1923-10-16,80
1923,10,17,58,58,0,1923-10-17,58
1923,10,18,31,31,0,1923-10-18,31
1923,10,19,28,28,0,1923-10-19,28
1923,10,20,28,28,0,1923-10-20,28
1923,10,21,55,0,55,1923-10-21,-55
1923,10,22,85,0,85,1923-10-22,-85
1923,10,23,292,0,292,1923-10-23,-292
1923,10,24,312,0,312,1923-10-24,-312
1923,10,25,292,0,292,1923-10-25,-292
1923,10,26,214,0,214,1923-10-26,-214
1923,10,27,159,0,159,1923-10-27,-159
1923,10,28,91,0,91,1923-10-28,-91
1923,10,29,40,0,40,1923-10-29,-40
1923,10,30,17,0,17,1923-10-30,-17
1923,10,31,62,0,62,1923-10-31,-62
1923,11,1,180,0,180,1923-11-1,-180
1923,11,2,254,0,254,1923-11-2,-254
1923,11,3,269,0,269,1923-11-3,-269
1923,11,4,412,228,184,1923-11-4,44
1923,11,5,388,304,84,1923-11-5,220
1923,11,6,290,276,14,1923-11-6,262
1923,11,7,197,197,0,1923-11-7,197
1923,11,8,173,173,0,1923-11-8,173
1923,11,9,189,189,0,1923-11-9,189
1923,11,10,211,211,0,1923-11-10,211
1923,11,11,201,201,0,1923-11-11,201
1923,11,12,158,158,0,1923-11-12,158
1923,11,13,88,88,0,1923-11-13,88
1923,11,14,68,68,0,1923-11-14,68
1923,11,15,63,63,0,1923-11-15,63
1923,11,16,41,41,0,1923-11-16,41
1923,11,17,0,0,0,1923-11-17,0
1923,11,18,0,0,0,1923-11-18,0
1923,11,19,0,0,0,1923-11-19,0
1923,11,20,0,0,0,1923-11-20,0
1923,11,21,0,0,0,1923-11-21,0
1923,11,22,0,0,0,1923-11-22,0
1923,11,23,0,0,0,1923-11-23,0
1923,11,24,57,0,57,1923-11-24,-57
1923,11,25,73,0,73,1923-11-25,-73
1923,11,26,37,0,37,1923-11-26,-37
1923,11,27,20,0,20,1923-11-27,-20
1923,11,28,7,0,7,1923-11-28,-7
1923,11,29,5,0,5,1923-11-29,-5
1923,11,30,0,0,0,1923-11-30,0
1923,12,1,0,0,0,1923-12-1,0
1923,12,2,0,0,0,1923-12-2,0
1923,12,3,2,0,2,1923-12-3,-2
1923,12,4,0,0,0,1923-12-4,0
1923,12,5,0,0,0,1923-12-5,0
1923,12,6,0,0,0,1923-12-6,0
1923,12,7,0,0,0,1923-12-7,0
1923,12,8,0,0,0,1923-12-8,0
1923,12,9,0,0,0,1923-12-9,0
1923,12,10,0,0,0,1923-12-10,0
1923,12,11,0,0,0,1923-12-11,0
1923,12,12,0,0,0,1923-12-12,0
1923,12,13,0,0,0,1923-12-13,0
1923,12,14,0,0,0,1923-12-14,0
1923,12,15,0,0,0,1923-12-15,0
1923,12,16,0,0,0,1923-12-16,0
1923,12,17,0,0,0,1923-12-17,0
1923,12,18,5,5,0,1923-12-18,5
1923,12,19,6,6,0,1923-12-19,6
1923,12,20,73,73,0,1923-12-20,73
1923,12,21,161,161,0,1923-12-21,161
1923,12,22,157,157,0,1923-12-22,157
1923,12,23,156,156,0,1923-12-23,156
1923,12,24,93,93,0,1923-12-24,93
1923,12,25,42,42,0,1923-12-25,42
1923,12,26,28,28,0,1923-12-26,28
1923,12,27,52,52,0,1923-12-27,52
1923,12,28,25,25,0,1923-12-28,25
1923,12,29,0,0,0,1923-12-29,0
1923,12,30,0,0,0,1923-12-30,0
1923,12,31,0,0,0,1923-12-31,0
1924,1,1,0,0,0,1924-1-1,0
1924,1,2,0,0,0,1924-1-2,0
1924,1,3,0,0,0,1924-1-3,0
1924,1,4,0,0,0,1924-1-4,0
1924,1,5,3,3,0,1924-1-5,3
1924,1,6,5,5,0,1924-1-6,5
1924,1,7,0,0,0,1924-1-7,0
1924,1,8,0,0,0,1924-1-8,0
1924,1,9,0,0,0,1924-1-9,0
1924,1,10,0,0,0,1924-1-10,0
1924,1,11,0,0,0,1924-1-11,0
1924,1,12,0,0,0,1924-1-12,0
1924,1,13,0,0,0,1924-1-13,0
1924,1,14,0,0,0,1924-1-14,0
1924,1,15,0,0,0,1924-1-15,0
1924,1,16,0,0,0,1924-1-16,0
1924,1,17,0,0,0,1924-1-17,0
1924,1,18,0,0,0,1924-1-18,0
1924,1,19,0,0,0,1924-1-19,0
1924,1,20,0,0,0,1924-1-20,0
1924,1,21,0,0,0,1924-1-21,0
1924,1,22,0,0,0,1924-1-22,0
1924,1,23,12,0,12,1924-1-23,-12
1924,1,24,0,0,0,1924-1-24,0
1924,1,25,0,0,0,1924-1-25,0
1924,1,26,16,16,0,1924-1-26,16
1924,1,27,0,0,0,1924-1-27,0
1924,1,28,16,16,0,1924-1-28,16
1924,1,29,0,0,0,1924-1-29,0
1924,1,30,0,0,0,1924-1-30,0
1924,1,31,0,0,0,1924-1-31,0
1924,2,1,0,0,0,1924-2-1,0
1924,2,2,0,0,0,1924-2-2,0
1924,2,3,17,0,17,1924-2-3,-17
1924,2,4,0,0,0,1924-2-4,0
1924,2,5,0,0,0,1924-2-5,0
1924,2,6,0,0,0,1924-2-6,0
1924,2,7,0,0,0,1924-2-7,0
1924,2,8,0,0,0,1924-2-8,0
1924,2,9,0,0,0,1924-2-9,0
1924,2,10,0,0,0,1924-2-10,0
1924,2,11,0,0,0,1924-2-11,0
1924,2,12,7,7,0,1924-2-12,7
1924,2,13,0,0,0,1924-2-13,0
1924,2,14,0,0,0,1924-2-14,0
1924,2,15,6,6,0,1924-2-15,6
1924,2,16,26,2,24,1924-2-16,-22
1924,2,17,0,0,0,1924-2-17,0
1924,2,18,0,0,0,1924-2-18,0
1924,2,19,0,0,0,1924-2-19,0
1924,2,20,0,0,0,1924-2-20,0
1924,2,21,0,0,0,1924-2-21,0
1924,2,22,0,0,0,1924-2-22,0
1924,2,23,0,0,0,1924-2-23,0
1924,2,24,0,0,0,1924-2-24,0
1924,2,25,160,160,0,1924-2-25,160
1924,2,26,433,428,5,1924-2-26,423
1924,2,27,480,480,0,1924-2-27,480
1924,2,28,479,479,0,1924-2-28,479
1924,2,29,365,365,0,1924-2-29,365
1924,3,1,335,329,6,1924-3-1,323
1924,3,2,273,273,0,1924-3-2,273
1924,3,3,210,210,0,1924-3-3,210
1924,3,4,158,158,0,1924-3-4,158
1924,3,5,0,0,0,1924-3-5,0
1924,3,6,0,0,0,1924-3-6,0
1924,3,7,0,0,0,1924-3-7,0
1924,3,8,0,0,0,1924-3-8,0
1924,3,9,0,0,0,1924-3-9,0
1924,3,10,0,0,0,1924-3-10,0
1924,3,11,0,0,0,1924-3-11,0
1924,3,12,0,0,0,1924-3-12,0
1924,3,13,0,0,0,1924-3-13,0
1924,3,14,0,0,0,1924-3-14,0
1924,3,15,0,0,0,1924-3-15,0
1924,3,16,0,0,0,1924-3-16,0
1924,3,17,0,0,0,1924-3-17,0
1924,3,18,0,0,0,1924-3-18,0
1924,3,19,0,0,0,1924-3-19,0
1924,3,20,0,0,0,1924-3-20,0
1924,3,21,5,0,5,1924-3-21,-5
1924,3,22,31,15,16,1924-3-22,-1
1924,3,23,15,7,8,1924-3-23,-1
1924,3,24,4,4,0,1924-3-24,4
1924,3,25,0,0,0,1924-3-25,0
1924,3,26,0,0,0,1924-3-26,0
1924,3,27,0,0,0,1924-3-27,0
1924,3,28,0,0,0,1924-3-28,0
1924,3,29,0,0,0,1924-3-29,0
1924,3,30,0,0,0,1924-3-30,0
1924,3,31,0,0,0,1924-3-31,0
1924,4,1,0,0,0,1924-4-1,0
1924,4,2,0,0,0,1924-4-2,0
1924,4,3,0,0,0,1924-4-3,0
1924,4,4,0,0,0,1924-4-4,0
1924,4,5,0,0,0,1924-4-5,0
1924,4,6,7,7,0,1924-4-6,7
1924,4,7,0,0,0,1924-4-7,0
1924,4,8,0,0,0,1924-4-8,0
1924,4,9,0,0,0,1924-4-9,0
1924,4,10,3,3,0,1924-4-10,3
1924,4,11,0,0,0,1924-4-11,0
1924,4,12,0,0,0,1924-4-12,0
1924,4,13,0,0,0,1924-4-13,0
1924,4,14,26,26,0,1924-4-14,26
1924,4,15,0,0,0,1924-4-15,0
1924,4,16,11,11,0,1924-4-16,11
1924,4,17,49,49,0,1924-4-17,49
1924,4,18,308,183,125,1924-4-18,58
1924,4,19,424,173,251,1924-4-19,-78
1924,4,20,506,86,420,1924-4-20,-334
1924,4,21,592,48,544,1924-4-21,-496
1924,4,22,603,17,586,1924-4-22,-569
1924,4,23,446,0,446,1924-4-23,-446
1924,4,24,514,0,514,1924-4-24,-514
1924,4,25,488,0,488,1924-4-25,-488
1924,4,26,338,0,338,1924-4-26,-338
1924,4,27,133,0,133,1924-4-27,-133
1924,4,28,8,8,0,1924-4-28,8
1924,4,29,0,0,0,1924-4-29,0
1924,4,30,0,0,0,1924-4-30,0
1924,5,1,0,0,0,1924-5-1,0
1924,5,2,0,0,0,1924-5-2,0
1924,5,3,0,0,0,1924-5-3,0
1924,5,4,2,2,0,1924-5-4,2
1924,5,5,0,0,0,1924-5-5,0
1924,5,6,4,4,0,1924-5-6,4
1924,5,7,63,63,0,1924-5-7,63
1924,5,8,179,179,0,1924-5-8,179
1924,5,9,124,124,0,1924-5-9,124
1924,5,10,103,103,0,1924-5-10,103
1924,5,11,84,44,40,1924-5-11,4
1924,5,12,258,18,240,1924-5-12,-222
1924,5,13,385,8,377,1924-5-13,-369
1924,5,14,394,7,387,1924-5-14,-380
1924,5,15,528,0,528,1924-5-15,-528
1924,5,16,661,0,661,1924-5-16,-661
1924,5,17,584,0,584,1924-5-17,-584
1924,5,18,451,24,427,1924-5-18,-403
1924,5,19,399,18,381,1924-5-19,-363
1924,5,20,268,15,253,1924-5-20,-238
1924,5,21,282,63,219,1924-5-21,-156
1924,5,22,145,94,51,1924-5-22,43
1924,5,23,154,67,87,1924-5-23,-20
1924,5,24,87,24,63,1924-5-24,-39
1924,5,25,10,0,10,1924-5-25,-10
1924,5,26,6,0,6,1924-5-26,-6
1924,5,27,53,47,6,1924-5-27,41
1924,5,28,61,61,0,1924-5-28,61
1924,5,29,450,450,0,1924-5-29,450
1924,5,30,969,969,0,1924-5-30,969
1924,5,31,946,937,9,1924-5-31,928
1924,6,1,872,872,0,1924-6-1,872
1924,6,2,889,882,7,1924-6-2,875
1924,6,3,892,892,0,1924-6-3,892
1924,6,4,1013,1013,0,1924-6-4,1013
1924,6,5,1076,1076,0,1924-6-5,1076
1924,6,6,1101,1101,0,1924-6-6,1101
1924,6,7,989,984,5,1924-6-7,979
1924,6,8,728,728,0,1924-6-8,728
1924,6,9,630,630,0,1924-6-9,630
1924,6,10,510,510,0,1924-6-10,510
1924,6,11,562,559,3,1924-6-11,556
1924,6,12,29,29,0,1924-6-12,29
1924,6,13,90,64,26,1924-6-13,38
1924,6,14,182,148,34,1924-6-14,114
1924,6,15,264,223,41,1924-6-15,182
1924,6,16,221,199,22,1924-6-16,177
1924,6,17,256,185,71,1924-6-17,114
1924,6,18,180,89,91,1924-6-18,-2
1924,6,19,116,44,72,1924-6-19,-28
1924,6,20,108,108,0,1924-6-20,108
1924,6,21,120,120,0,1924-6-21,120
1924,6,22,90,90,0,1924-6-22,90
1924,6,23,85,85,0,1924-6-23,85
1924,6,24,106,106,0,1924-6-24,106
1924,6,25,109,109,0,1924-6-25,109
1924,6,26,128,128,0,1924-6-26,128
1924,6,27,481,481,0,1924-6-27,481
1924,6,28,397,397,0,1924-6-28,397
1924,6,29,316,316,0,1924-6-29,316
1924,6,30,271,271,0,1924-6-30,271
1924,7,1,331,331,0,1924-7-1,331
1924,7,2,319,319,0,1924-7-2,319
1924,7,3,284,284,0,1924-7-3,284
1924,7,4,245,245,0,1924-7-4,245
1924,7,5,306,302,4,1924-7-5,298
1924,7,6,471,454,17,1924-7-6,437
1924,7,7,719,686,33,1924-7-7,653
1924,7,8,645,618,27,1924-7-8,591
1924,7,9,611,589,22,1924-7-9,567
1924,7,10,609,583,26,1924-7-10,557
1924,7,11,739,725,14,1924-7-11,711
1924,7,12,741,736,5,1924-7-12,731
1924,7,13,694,694,0,1924-7-13,694
1924,7,14,695,695,0,1924-7-14,695
1924,7,15,619,619,0,1924-7-15,619
1924,7,16,583,583,0,1924-7-16,583
1924,7,17,535,535,0,1924-7-17,535
1924,7,18,220,220,0,1924-7-18,220
1924,7,19,209,209,0,1924-7-19,209
1924,7,20,8,8,0,1924-7-20,8
1924,7,21,39,39,0,1924-7-21,39
1924,7,22,96,96,0,1924-7-22,96
1924,7,23,121,121,0,1924-7-23,121
1924,7,24,90,90,0,1924-7-24,90
1924,7,25,32,32,0,1924-7-25,32
1924,7,26,73,73,0,1924-7-26,73
1924,7,27,197,197,0,1924-7-27,197
1924,7,28,227,227,0,1924-7-28,227
1924,7,29,281,281,0,1924-7-29,281
1924,7,30,180,180,0,1924-7-30,180
1924,7,31,196,196,0,1924-7-31,196
1924,8,1,524,524,0,1924-8-1,524
1924,8,2,449,449,0,1924-8-2,449
1924,8,3,530,530,0,1924-8-3,530
1924,8,4,475,475,0,1924-8-4,475
1924,8,5,451,451,0,1924-8-5,451
1924,8,6,408,408,0,1924-8-6,408
1924,8,7,308,303,5,1924-8-7,298
1924,8,8,247,239,8,1924-8-8,231
1924,8,9,277,245,32,1924-8-9,213
1924,8,10,221,208,13,1924-8-10,195
1924,8,11,226,226,0,1924-8-11,226
1924,8,12,270,257,13,1924-8-12,244
1924,8,13,218,153,65,1924-8-13,88
1924,8,14,100,0,100,1924-8-14,-100
1924,8,15,279,279,0,1924-8-15,279
1924,8,16,359,359,0,1924-8-16,359
1924,8,17,357,357,0,1924-8-17,357
1924,8,18,301,301,0,1924-8-18,301
1924,8,19,298,298,0,1924-8-19,298
1924,8,20,203,203,0,1924-8-20,203
1924,8,21,176,176,0,1924-8-21,176
1924,8,22,149,149,0,1924-8-22,149
1924,8,23,169,169,0,1924-8-23,169
1924,8,24,176,176,0,1924-8-24,176
1924,8,25,165,165,0,1924-8-25,165
1924,8,26,140,140,0,1924-8-26,140
1924,8,27,82,82,0,1924-8-27,82
1924,8,28,271,271,0,1924-8-28,271
1924,8,29,821,821,0,1924-8-29,821
1924,8,30,1177,1175,2,1924-8-30,1173
1924,8,31,1343,1343,0,1924-8-31,1343
1924,9,1,1405,1405,0,1924-9-1,1405
1924,9,2,1461,1461,0,1924-9-2,1461
1924,9,3,1451,1451,0,1924-9-3,1451
1924,9,4,1353,1353,0,1924-9-4,1353
1924,9,5,999,997,2,1924-9-5,995
1924,9,6,568,554,14,1924-9-6,540
1924,9,7,208,158,50,1924-9-7,108
1924,9,8,212,171,41,1924-9-8,130
1924,9,9,271,250,21,1924-9-9,229
1924,9,10,102,81,21,1924-9-10,60
1924,9,11,277,277,0,1924-9-11,277
1924,9,12,328,328,0,1924-9-12,328
1924,9,13,331,331,0,1924-9-13,331
1924,9,14,225,225,0,1924-9-14,225
1924,9,15,238,238,0,1924-9-15,238
1924,9,16,97,97,0,1924-9-16,97
1924,9,17,124,124,0,1924-9-17,124
1924,9,18,94,88,6,1924-9-18,82
1924,9,19,138,31,107,1924-9-19,-76
1924,9,20,132,14,118,1924-9-20,-104
1924,9,21,141,5,136,1924-9-21,-131
1924,9,22,262,10,252,1924-9-22,-242
1924,9,23,233,0,233,1924-9-23,-233
1924,9,24,339,194,145,1924-9-24,49
1924,9,25,241,154,87,1924-9-25,67
1924,9,26,184,140,44,1924-9-26,96
1924,9,27,111,105,6,1924-9-27,99
1924,9,28,440,440,0,1924-9-28,440
1924,9,29,435,435,0,1924-9-29,435
1924,9,30,283,283,0,1924-9-30,283
1924,10,1,405,405,0,1924-10-1,405
1924,10,2,431,431,0,1924-10-2,431
1924,10,3,583,331,252,1924-10-3,79
1924,10,4,780,293,487,1924-10-4,-194
1924,10,5,751,238,513,1924-10-5,-275
1924,10,6,709,207,502,1924-10-6,-295
1924,10,7,638,199,439,1924-10-7,-240
1924,10,8,632,198,434,1924-10-8,-236
1924,10,9,421,160,261,1924-10-9,-101
1924,10,10,306,126,180,1924-10-10,-54
1924,10,11,221,0,221,1924-10-11,-221
1924,10,12,206,0,206,1924-10-12,-206
1924,10,13,461,344,117,1924-10-13,227
1924,10,14,605,505,100,1924-10-14,405
1924,10,15,651,572,79,1924-10-15,493
1924,10,16,562,562,0,1924-10-16,562
1924,10,17,559,559,0,1924-10-17,559
1924,10,18,553,553,0,1924-10-18,553
1924,10,19,523,523,0,1924-10-19,523
1924,10,20,556,556,0,1924-10-20,556
1924,10,21,444,444,0,1924-10-21,444
1924,10,22,463,463,0,1924-10-22,463
1924,10,23,488,488,0,1924-10-23,488
1924,10,24,480,480,0,1924-10-24,480
1924,10,25,579,579,0,1924-10-25,579
1924,10,26,659,659,0,1924-10-26,659
1924,10,27,263,263,0,1924-10-27,263
1924,10,28,228,228,0,1924-10-28,228
1924,10,29,143,143,0,1924-10-29,143
1924,10,30,123,123,0,1924-10-30,123
1924,10,31,102,74,28,1924-10-31,46
1924,11,1,75,63,12,1924-11-1,51
1924,11,2,58,48,10,1924-11-2,38
1924,11,3,0,0,0,1924-11-3,0
1924,11,4,0,0,0,1924-11-4,0
1924,11,5,4,4,0,1924-11-5,4
1924,11,6,0,0,0,1924-11-6,0
1924,11,7,11,11,0,1924-11-7,11
1924,11,8,0,0,0,1924-11-8,0
1924,11,9,0,0,0,1924-11-9,0
1924,11,10,0,0,0,1924-11-10,0
1924,11,11,24,24,0,1924-11-11,24
1924,11,12,35,35,0,1924-11-12,35
1924,11,13,-1,-1,-1,1924-11-13,0
1924,11,14,69,69,0,1924-11-14,69
1924,11,15,617,617,0,1924-11-15,617
1924,11,16,669,669,0,1924-11-16,669
1924,11,17,684,684,0,1924-11-17,684
1924,11,18,1092,1092,0,1924-11-18,1092
1924,11,19,1280,1280,0,1924-11-19,1280
1924,11,20,1277,1277,0,1924-11-20,1277
1924,11,21,1463,1463,0,1924-11-21,1463
1924,11,22,1490,1486,4,1924-11-22,1482
1924,11,23,1595,1588,7,1924-11-23,1581
1924,11,24,1262,1254,8,1924-11-24,1246
1924,11,25,1272,1272,0,1924-11-25,1272
1924,11,26,1463,1463,0,1924-11-26,1463
1924,11,27,1763,1763,0,1924-11-27,1763
1924,11,28,689,689,0,1924-11-28,689
1924,11,29,416,416,0,1924-11-29,416
1924,11,30,337,337,0,1924-11-30,337
1924,12,1,244,244,0,1924-12-1,244
1924,12,2,0,0,0,1924-12-2,0
1924,12,3,53,53,0,1924-12-3,53
1924,12,4,16,16,0,1924-12-4,16
1924,12,5,7,7,0,1924-12-5,7
1924,12,6,0,0,0,1924-12-6,0
1924,12,7,200,200,0,1924-12-7,200
1924,12,8,156,156,0,1924-12-8,156
1924,12,9,130,130,0,1924-12-9,130
1924,12,10,180,180,0,1924-12-10,180
1924,12,11,227,227,0,1924-12-11,227
1924,12,12,254,254,0,1924-12-12,254
1924,12,13,359,359,0,1924-12-13,359
1924,12,14,304,304,0,1924-12-14,304
1924,12,15,274,274,0,1924-12-15,274
1924,12,16,206,206,0,1924-12-16,206
1924,12,17,155,155,0,1924-12-17,155
1924,12,18,196,196,0,1924-12-18,196
1924,12,19,232,232,0,1924-12-19,232
1924,12,20,208,208,0,1924-12-20,208
1924,12,21,271,116,155,1924-12-21,-39
1924,12,22,537,105,432,1924-12-22,-327
1924,12,23,592,139,453,1924-12-23,-314
1924,12,24,460,37,423,1924-12-24,-386
1924,12,25,356,0,356,1924-12-25,-356
1924,12,26,274,0,274,1924-12-26,-274
1924,12,27,36,0,36,1924-12-27,-36
1924,12,28,9,9,0,1924-12-28,9
1924,12,29,6,0,6,1924-12-29,-6
1924,12,30,0,0,0,1924-12-30,0
1924,12,31,18,11,7,1924-12-31,4
1925,1,1,0,0,0,1925-1-1,0
1925,1,2,30,0,30,1925-1-2,-30
1925,1,3,28,0,28,1925-1-3,-28
1925,1,4,8,0,8,1925-1-4,-8
1925,1,5,3,0,3,1925-1-5,-3
1925,1,6,2,0,2,1925-1-6,-2
1925,1,7,3,0,3,1925-1-7,-3
1925,1,8,29,0,29,1925-1-8,-29
1925,1,9,0,0,0,1925-1-9,0
1925,1,10,0,0,0,1925-1-10,0
1925,1,11,10,0,10,1925-1-11,-10
1925,1,12,30,0,30,1925-1-12,-30
1925,1,13,3,3,0,1925-1-13,3
1925,1,14,0,0,0,1925-1-14,0
1925,1,15,0,0,0,1925-1-15,0
1925,1,16,47,47,0,1925-1-16,47
1925,1,17,11,11,0,1925-1-17,11
1925,1,18,38,38,0,1925-1-18,38
1925,1,19,185,185,0,1925-1-19,185
1925,1,20,168,168,0,1925-1-20,168
1925,1,21,128,128,0,1925-1-21,128
1925,1,22,126,126,0,1925-1-22,126
1925,1,23,114,114,0,1925-1-23,114
1925,1,24,46,46,0,1925-1-24,46
1925,1,25,82,82,0,1925-1-25,82
1925,1,26,4,4,0,1925-1-26,4
1925,1,27,0,0,0,1925-1-27,0
1925,1,28,7,7,0,1925-1-28,7
1925,1,29,0,0,0,1925-1-29,0
1925,1,30,0,0,0,1925-1-30,0
1925,1,31,20,20,0,1925-1-31,20
1925,2,1,56,19,37,1925-2-1,-18
1925,2,2,86,48,38,1925-2-2,10
1925,2,3,62,34,28,1925-2-3,6
1925,2,4,14,8,6,1925-2-4,2
1925,2,5,30,29,1,1925-2-5,28
1925,2,6,61,61,0,1925-2-6,61
1925,2,7,670,61,609,1925-2-7,-548
1925,2,8,629,97,532,1925-2-8,-435
1925,2,9,702,227,475,1925-2-9,-248
1925,2,10,792,336,456,1925-2-10,-120
1925,2,11,786,238,548,1925-2-11,-310
1925,2,12,859,245,614,1925-2-12,-369
1925,2,13,836,242,594,1925-2-13,-352
1925,2,14,872,192,680,1925-2-14,-488
1925,2,15,672,33,639,1925-2-15,-606
1925,2,16,490,28,462,1925-2-16,-434
1925,2,17,426,7,419,1925-2-17,-412
1925,2,18,238,0,238,1925-2-18,-238
1925,2,19,206,0,206,1925-2-19,-206
1925,2,20,137,0,137,1925-2-20,-137
1925,2,21,83,0,83,1925-2-21,-83
1925,2,22,23,0,23,1925-2-22,-23
1925,2,23,20,5,15,1925-2-23,-10
1925,2,24,13,13,0,1925-2-24,13
1925,2,25,0,0,0,1925-2-25,0
1925,2,26,0,0,0,1925-2-26,0
1925,2,27,0,0,0,1925-2-27,0
1925,2,28,19,5,14,1925-2-28,-9
1925,3,1,99,21,78,1925-3-1,-57
1925,3,2,60,0,60,1925-3-2,-60
1925,3,3,22,0,22,1925-3-3,-22
1925,3,4,16,6,10,1925-3-4,-4
1925,3,5,6,0,6,1925-3-5,-6
1925,3,6,0,0,0,1925-3-6,0
1925,3,7,0,0,0,1925-3-7,0
1925,3,8,0,0,0,1925-3-8,0
1925,3,9,0,0,0,1925-3-9,0
1925,3,10,0,0,0,1925-3-10,0
1925,3,11,129,0,129,1925-3-11,-129
1925,3,12,208,0,208,1925-3-12,-208
1925,3,13,410,10,400,1925-3-13,-390
1925,3,14,401,0,401,1925-3-14,-401
1925,3,15,398,0,398,1925-3-15,-398
1925,3,16,358,0,358,1925-3-16,-358
1925,3,17,318,14,304,1925-3-17,-290
1925,3,18,279,6,273,1925-3-18,-267
1925,3,19,341,7,334,1925-3-19,-327
1925,3,20,228,0,228,1925-3-20,-228
1925,3,21,238,0,238,1925-3-21,-238
1925,3,22,295,0,295,1925-3-22,-295
1925,3,23,231,38,193,1925-3-23,-155
1925,3,24,26,26,0,1925-3-24,26
1925,3,25,93,93,0,1925-3-25,93
1925,3,26,316,311,5,1925-3-26,306
1925,3,27,433,433,0,1925-3-27,433
1925,3,28,464,464,0,1925-3-28,464
1925,3,29,533,533,0,1925-3-29,533
1925,3,30,555,555,0,1925-3-30,555
1925,3,31,705,705,0,1925-3-31,705
1925,4,1,429,429,0,1925-4-1,429
1925,4,2,109,0,109,1925-4-2,-109
1925,4,3,89,0,89,1925-4-3,-89
1925,4,4,42,9,33,1925-4-4,-24
1925,4,5,75,47,28,1925-4-5,19
1925,4,6,50,43,7,1925-4-6,36
1925,4,7,147,77,70,1925-4-7,7
1925,4,8,160,70,90,1925-4-8,-20
1925,4,9,169,78,91,1925-4-9,-13
1925,4,10,311,260,51,1925-4-10,209
1925,4,11,470,431,39,1925-4-11,392
1925,4,12,595,582,13,1925-4-12,569
1925,4,13,482,482,0,1925-4-13,482
1925,4,14,510,504,6,1925-4-14,498
1925,4,15,561,556,5,1925-4-15,551
1925,4,16,380,380,0,1925-4-16,380
1925,4,17,747,385,362,1925-4-17,23
1925,4,18,563,57,506,1925-4-18,-449
1925,4,19,553,154,399,1925-4-19,-245
1925,4,20,331,93,238,1925-4-20,-145
1925,4,21,167,55,112,1925-4-21,-57
1925,4,22,180,146,34,1925-4-22,112
1925,4,23,244,211,33,1925-4-23,178
1925,4,24,358,329,29,1925-4-24,300
1925,4,25,312,301,11,1925-4-25,290
1925,4,26,222,193,29,1925-4-26,164
1925,4,27,121,97,24,1925-4-27,73
1925,4,28,96,85,11,1925-4-28,74
1925,4,29,26,26,0,1925-4-29,26
1925,4,30,855,855,0,1925-4-30,855
1925,5,1,883,883,0,1925-5-1,883
1925,5,2,799,799,0,1925-5-2,799
1925,5,3,755,755,0,1925-5-3,755
1925,5,4,754,745,9,1925-5-4,736
1925,5,5,723,713,10,1925-5-5,703
1925,5,6,798,798,0,1925-5-6,798
1925,5,7,834,834,0,1925-5-7,834
1925,5,8,737,731,6,1925-5-8,725
1925,5,9,906,830,76,1925-5-9,754
1925,5,10,777,650,127,1925-5-10,523
1925,5,11,686,607,79,1925-5-11,528
1925,5,12,765,683,82,1925-5-12,601
1925,5,13,338,262,76,1925-5-13,186
1925,5,14,454,307,147,1925-5-14,160
1925,5,15,556,409,147,1925-5-15,262
1925,5,16,452,291,161,1925-5-16,130
1925,5,17,759,607,152,1925-5-17,455
1925,5,18,941,842,99,1925-5-18,743
1925,5,19,1042,993,49,1925-5-19,944
1925,5,20,882,855,27,1925-5-20,828
1925,5,21,878,854,24,1925-5-21,830
1925,5,22,848,825,23,1925-5-22,802
1925,5,23,662,636,26,1925-5-23,610
1925,5,24,615,609,6,1925-5-24,603
1925,5,25,557,557,0,1925-5-25,557
1925,5,26,512,499,13,1925-5-26,486
1925,5,27,911,876,35,1925-5-27,841
1925,5,28,948,875,73,1925-5-28,802
1925,5,29,473,371,102,1925-5-29,269
1925,5,30,315,241,74,1925-5-30,167
1925,5,31,238,207,31,1925-5-31,176
1925,6,1,472,367,105,1925-6-1,262
1925,6,2,1346,839,507,1925-6-2,332
1925,6,3,1689,1072,617,1925-6-3,455
1925,6,4,1352,1224,128,1925-6-4,1096
1925,6,5,1155,1003,152,1925-6-5,851
1925,6,6,936,826,110,1925-6-6,716
1925,6,7,1019,926,93,1925-6-7,833
1925,6,8,1408,1237,171,1925-6-8,1066
1925,6,9,1264,1026,238,1925-6-9,788
1925,6,10,1294,870,424,1925-6-10,446
1925,6,11,1442,980,462,1925-6-11,518
1925,6,12,1430,920,510,1925-6-12,410
1925,6,13,1351,863,488,1925-6-13,375
1925,6,14,1119,696,423,1925-6-14,273
1925,6,15,449,392,57,1925-6-15,335
1925,6,16,241,241,0,1925-6-16,241
1925,6,17,68,68,0,1925-6-17,68
1925,6,18,73,73,0,1925-6-18,73
1925,6,19,3,3,0,1925-6-19,3
1925,6,20,0,0,0,1925-6-20,0
1925,6,21,4,4,0,1925-6-21,4
1925,6,22,81,18,63,1925-6-22,-45
1925,6,23,38,15,23,1925-6-23,-8
1925,6,24,189,7,182,1925-6-24,-175
1925,6,25,135,0,135,1925-6-25,-135
1925,6,26,109,0,109,1925-6-26,-109
1925,6,27,191,4,187,1925-6-27,-183
1925,6,28,218,0,218,1925-6-28,-218
1925,6,29,185,0,185,1925-6-29,-185
1925,6,30,187,0,187,1925-6-30,-187
1925,7,1,168,0,168,1925-7-1,-168
1925,7,2,315,0,315,1925-7-2,-315
1925,7,3,616,6,610,1925-7-3,-604
1925,7,4,661,3,658,1925-7-4,-655
1925,7,5,803,32,771,1925-7-5,-739
1925,7,6,740,16,724,1925-7-6,-708
1925,7,7,823,0,823,1925-7-7,-823
1925,7,8,783,9,774,1925-7-8,-765
1925,7,9,822,39,783,1925-7-9,-744
1925,7,10,888,296,592,1925-7-10,-296
1925,7,11,783,272,511,1925-7-11,-239
1925,7,12,759,296,463,1925-7-12,-167
1925,7,13,573,242,331,1925-7-13,-89
1925,7,14,212,212,0,1925-7-14,212
1925,7,15,180,180,0,1925-7-15,180
1925,7,16,191,179,12,1925-7-16,167
1925,7,17,277,168,109,1925-7-17,59
1925,7,18,238,135,103,1925-7-18,32
1925,7,19,145,92,53,1925-7-19,39
1925,7,20,105,66,39,1925-7-20,27
1925,7,21,126,80,46,1925-7-21,34
1925,7,22,85,55,30,1925-7-22,25
1925,7,23,12,12,0,1925-7-23,12
1925,7,24,194,60,134,1925-7-24,-74
1925,7,25,545,362,183,1925-7-25,179
1925,7,26,432,283,149,1925-7-26,134
1925,7,27,334,248,86,1925-7-27,162
1925,7,28,331,231,100,1925-7-28,131
1925,7,29,358,195,163,1925-7-29,32
1925,7,30,285,139,146,1925-7-30,-7
1925,7,31,426,107,319,1925-7-31,-212
1925,8,1,405,111,294,1925-8-1,-183
1925,8,2,439,117,322,1925-8-2,-205
1925,8,3,281,18,263,1925-8-3,-245
1925,8,4,147,0,147,1925-8-4,-147
1925,8,5,32,22,10,1925-8-5,12
1925,8,6,60,34,26,1925-8-6,8
1925,8,7,174,15,159,1925-8-7,-144
1925,8,8,367,205,162,1925-8-8,43
1925,8,9,608,538,70,1925-8-9,468
1925,8,10,753,730,23,1925-8-10,707
1925,8,11,995,981,14,1925-8-11,967
1925,8,12,1041,1006,35,1925-8-12,971
1925,8,13,877,857,20,1925-8-13,837
1925,8,14,468,448,20,1925-8-14,428
1925,8,15,0,0,0,1925-8-15,0
1925,8,16,0,0,0,1925-8-16,0
1925,8,17,13,13,0,1925-8-17,13
1925,8,18,47,47,0,1925-8-18,47
1925,8,19,197,94,103,1925-8-19,-9
1925,8,20,283,169,114,1925-8-20,55
1925,8,21,376,148,228,1925-8-21,-80
1925,8,22,483,0,483,1925-8-22,-483
1925,8,23,425,50,375,1925-8-23,-325
1925,8,24,547,100,447,1925-8-24,-347
1925,8,25,528,148,380,1925-8-25,-232
1925,8,26,620,284,336,1925-8-26,-52
1925,8,27,772,474,298,1925-8-27,176
1925,8,28,822,551,271,1925-8-28,280
1925,8,29,830,576,254,1925-8-29,322
1925,8,30,1139,897,242,1925-8-30,655
1925,8,31,957,751,206,1925-8-31,545
1925,9,1,955,712,243,1925-9-1,469
1925,9,2,751,482,269,1925-9-2,213
1925,9,3,728,616,112,1925-9-3,504
1925,9,4,347,268,79,1925-9-4,189
1925,9,5,208,104,104,1925-9-5,0
1925,9,6,218,171,47,1925-9-6,124
1925,9,7,192,174,18,1925-9-7,156
1925,9,8,322,322,0,1925-9-8,322
1925,9,9,368,368,0,1925-9-9,368
1925,9,10,465,465,0,1925-9-10,465
1925,9,11,919,906,13,1925-9-11,893
1925,9,12,1027,1020,7,1925-9-12,1013
1925,9,13,956,954,2,1925-9-13,952
1925,9,14,650,650,0,1925-9-14,650
1925,9,15,256,246,10,1925-9-15,236
1925,9,16,398,390,8,1925-9-16,382
1925,9,17,460,353,107,1925-9-17,246
1925,9,18,656,457,199,1925-9-18,258
1925,9,19,632,365,267,1925-9-19,98
1925,9,20,621,312,309,1925-9-20,3
1925,9,21,606,257,349,1925-9-21,-92
1925,9,22,705,252,453,1925-9-22,-201
1925,9,23,906,173,733,1925-9-23,-560
1925,9,24,899,167,732,1925-9-24,-565
1925,9,25,836,163,673,1925-9-25,-510
1925,9,26,1267,398,869,1925-9-26,-471
1925,9,27,1524,558,966,1925-9-27,-408
1925,9,28,1928,1003,925,1925-9-28,78
1925,9,29,1432,971,461,1925-9-29,510
1925,9,30,1560,884,676,1925-9-30,208
1925,10,1,1410,791,619,1925-10-1,172
1925,10,2,965,393,572,1925-10-2,-179
1925,10,3,815,413,402,1925-10-3,11
1925,10,4,798,333,465,1925-10-4,-132
1925,10,5,640,170,470,1925-10-5,-300
1925,10,6,502,183,319,1925-10-6,-136
1925,10,7,532,169,363,1925-10-7,-194
1925,10,8,320,123,197,1925-10-8,-74
1925,10,9,225,121,104,1925-10-9,17
1925,10,10,347,224,123,1925-10-10,101
1925,10,11,202,117,85,1925-10-11,32
1925,10,12,306,73,233,1925-10-12,-160
1925,10,13,860,559,301,1925-10-13,258
1925,10,14,2010,738,1272,1925-10-14,-534
1925,10,15,2166,560,1606,1925-10-15,-1046
1925,10,16,2349,815,1534,1925-10-16,-719
1925,10,17,2599,920,1679,1925-10-17,-759
1925,10,18,3058,1065,1993,1925-10-18,-928
1925,10,19,2755,879,1876,1925-10-19,-997
1925,10,20,2788,944,1844,1925-10-20,-900
1925,10,21,2774,930,1844,1925-10-21,-914
1925,10,22,2542,838,1704,1925-10-22,-866
1925,10,23,2238,820,1418,1925-10-23,-598
1925,10,24,1856,664,1192,1925-10-24,-528
1925,10,25,1579,542,1037,1925-10-25,-495
1925,10,26,1360,503,857,1925-10-26,-354
1925,10,27,642,551,91,1925-10-27,460
1925,10,28,656,573,83,1925-10-28,490
1925,10,29,472,424,48,1925-10-29,376
1925,10,30,406,336,70,1925-10-30,266
1925,10,31,280,244,36,1925-10-31,208
1925,11,1,186,171,15,1925-11-1,156
1925,11,2,140,132,8,1925-11-2,124
1925,11,3,134,124,10,1925-11-3,114
1925,11,4,139,139,0,1925-11-4,139
1925,11,5,215,111,104,1925-11-5,7
1925,11,6,130,41,89,1925-11-6,-48
1925,11,7,158,107,51,1925-11-7,56
1925,11,8,277,14,263,1925-11-8,-249
1925,11,9,674,26,648,1925-11-9,-622
1925,11,10,1035,4,1031,1925-11-10,-1027
1925,11,11,1336,0,1336,1925-11-11,-1336
1925,11,12,1414,16,1398,1925-11-12,-1382
1925,11,13,1195,38,1157,1925-11-13,-1119
1925,11,14,1121,30,1091,1925-11-14,-1061
1925,11,15,839,17,822,1925-11-15,-805
1925,11,16,960,70,890,1925-11-16,-820
1925,11,17,758,111,647,1925-11-17,-536
1925,11,18,1200,738,462,1925-11-18,276
1925,11,19,1360,955,405,1925-11-19,550
1925,11,20,1678,1404,274,1925-11-20,1130
1925,11,21,2278,2034,244,1925-11-21,1790
1925,11,22,2716,2497,219,1925-11-22,2278
1925,11,23,2773,2591,182,1925-11-23,2409
1925,11,24,3386,3218,168,1925-11-24,3050
1925,11,25,3540,3359,181,1925-11-25,3178
1925,11,26,3715,3472,243,1925-11-26,3229
1925,11,27,2702,2528,174,1925-11-27,2354
1925,11,28,2779,2779,0,1925-11-28,2779
1925,11,29,2495,2495,0,1925-11-29,2495
1925,11,30,1643,1643,0,1925-11-30,1643
1925,12,1,898,898,0,1925-12-1,898
1925,12,2,1019,1019,0,1925-12-2,1019
1925,12,3,1125,1113,12,1925-12-3,1101
1925,12,4,746,695,51,1925-12-4,644
1925,12,5,604,423,181,1925-12-5,242
1925,12,6,789,517,272,1925-12-6,245
1925,12,7,1159,566,593,1925-12-7,-27
1925,12,8,1321,443,878,1925-12-8,-435
1925,12,9,1270,316,954,1925-12-9,-638
1925,12,10,2169,1245,924,1925-12-10,321
1925,12,11,2622,1463,1159,1925-12-11,304
1925,12,12,3351,1969,1382,1925-12-12,587
1925,12,13,3590,2007,1583,1925-12-13,424
1925,12,14,3758,2439,1319,1925-12-14,1120
1925,12,15,3875,2828,1047,1925-12-15,1781
1925,12,16,3651,2954,697,1925-12-16,2257
1925,12,17,3273,2876,397,1925-12-17,2479
1925,12,18,2911,2429,482,1925-12-18,1947
1925,12,19,3197,2568,629,1925-12-19,1939
1925,12,20,4134,2909,1225,1925-12-20,1684
1925,12,21,3697,2261,1436,1925-12-21,825
1925,12,22,4183,2839,1344,1925-12-22,1495
1925,12,23,5126,3672,1454,1925-12-23,2218
1925,12,24,5110,3370,1740,1925-12-24,1630
1925,12,25,5268,3510,1758,1925-12-25,1752
1925,12,26,5612,3637,1975,1925-12-26,1662
1925,12,27,5662,3414,2248,1925-12-27,1166
1925,12,28,5068,2960,2108,1925-12-28,852
1925,12,29,5329,3274,2055,1925-12-29,1219
1925,12,30,5359,3329,2030,1925-12-30,1299
1925,12,31,5180,3455,1725,1925-12-31,1730
1926,1,1,3628,3103,525,1926-1-1,2578
1926,1,2,3175,3148,27,1926-1-2,3121
1926,1,3,3291,3193,98,1926-1-3,3095
1926,1,4,366,227,139,1926-1-4,88
1926,1,5,578,39,539,1926-1-5,-500
1926,1,6,1101,341,760,1926-1-6,-419
1926,1,7,1612,784,828,1926-1-7,-44
1926,1,8,1746,758,988,1926-1-8,-230
1926,1,9,1598,866,732,1926-1-9,134
1926,1,10,1635,775,860,1926-1-10,-85
1926,1,11,1942,1098,844,1926-1-11,254
1926,1,12,1405,1032,373,1926-1-12,659
1926,1,13,1056,911,145,1926-1-13,766
1926,1,14,839,736,103,1926-1-14,633
1926,1,15,706,562,144,1926-1-15,418
1926,1,16,1402,544,858,1926-1-16,-314
1926,1,17,1383,385,998,1926-1-17,-613
1926,1,18,2009,1077,932,1926-1-18,145
1926,1,19,5139,4034,1105,1926-1-19,2929
1926,1,20,5054,3897,1157,1926-1-20,2740
1926,1,21,4854,3713,1141,1926-1-21,2572
1926,1,22,4706,3626,1080,1926-1-22,2546
1926,1,23,4847,3747,1100,1926-1-23,2647
1926,1,24,4710,3534,1176,1926-1-24,2358
1926,1,25,4709,3425,1284,1926-1-25,2141
1926,1,26,4457,3155,1302,1926-1-26,1853
1926,1,27,4401,3133,1268,1926-1-27,1865
1926,1,28,4453,2990,1463,1926-1-28,1527
1926,1,29,3289,3078,211,1926-1-29,2867
1926,1,30,2932,2667,265,1926-1-30,2402
1926,1,31,522,185,337,1926-1-31,-152
1926,2,1,346,5,341,1926-2-1,-336
1926,2,2,404,81,323,1926-2-2,-242
1926,2,3,465,67,398,1926-2-3,-331
1926,2,4,493,113,380,1926-2-4,-267
1926,2,5,273,109,164,1926-2-5,-55
1926,2,6,220,94,126,1926-2-6,-32
1926,2,7,764,365,399,1926-2-7,-34
1926,2,8,1773,315,1458,1926-2-8,-1143
1926,2,9,1789,255,1534,1926-2-9,-1279
1926,2,10,1706,212,1494,1926-2-10,-1282
1926,2,11,2059,421,1638,1926-2-11,-1217
1926,2,12,2788,797,1991,1926-2-12,-1194
1926,2,13,3417,786,2631,1926-2-13,-1845
1926,2,14,3378,736,2642,1926-2-14,-1906
1926,2,15,3547,1105,2442,1926-2-15,-1337
1926,2,16,3689,1483,2206,1926-2-16,-723
1926,2,17,3346,1410,1936,1926-2-17,-526
1926,2,18,2796,1045,1751,1926-2-18,-706
1926,2,19,2635,948,1687,1926-2-19,-739
1926,2,20,2395,661,1734,1926-2-20,-1073
1926,2,21,1760,537,1223,1926-2-21,-686
1926,2,22,1256,385,871,1926-2-22,-486
1926,2,23,1111,394,717,1926-2-23,-323
1926,2,24,992,498,494,1926-2-24,4
1926,2,25,3002,796,2206,1926-2-25,-1410
1926,2,26,2975,1031,1944,1926-2-26,-913
1926,2,27,2293,297,1996,1926-2-27,-1699
1926,2,28,1971,41,1930,1926-2-28,-1889
1926,3,1,1968,136,1832,1926-3-1,-1696
1926,3,2,1986,109,1877,1926-3-2,-1768
1926,3,3,2492,297,2195,1926-3-3,-1898
1926,3,4,3110,615,2495,1926-3-4,-1880
1926,3,5,3019,620,2399,1926-3-5,-1779
1926,3,6,2927,663,2264,1926-3-6,-1601
1926,3,7,2556,539,2017,1926-3-7,-1478
1926,3,8,1729,445,1284,1926-3-8,-839
1926,3,9,1600,343,1257,1926-3-9,-914
1926,3,10,1502,281,1221,1926-3-10,-940
1926,3,11,549,185,364,1926-3-11,-179
1926,3,12,716,128,588,1926-3-12,-460
1926,3,13,903,238,665,1926-3-13,-427
1926,3,14,1009,296,713,1926-3-14,-417
1926,3,15,1071,344,727,1926-3-15,-383
1926,3,16,1409,487,922,1926-3-16,-435
1926,3,17,1292,470,822,1926-3-17,-352
1926,3,18,1203,357,846,1926-3-18,-489
1926,3,19,1186,275,911,1926-3-19,-636
1926,3,20,591,168,423,1926-3-20,-255
1926,3,21,530,119,411,1926-3-21,-292
1926,3,22,524,65,459,1926-3-22,-394
1926,3,23,525,86,439,1926-3-23,-353
1926,3,24,586,214,372,1926-3-24,-158
1926,3,25,594,561,33,1926-3-25,528
1926,3,26,704,525,179,1926-3-26,346
1926,3,27,801,537,264,1926-3-27,273
1926,3,28,605,419,186,1926-3-28,233
1926,3,29,596,394,202,1926-3-29,192
1926,3,30,618,405,213,1926-3-30,192
1926,3,31,555,386,169,1926-3-31,217
1926,4,1,459,372,87,1926-4-1,285
1926,4,2,404,308,96,1926-4-2,212
1926,4,3,262,159,103,1926-4-3,56
1926,4,4,167,90,77,1926-4-4,13
1926,4,5,170,80,90,1926-4-5,-10
1926,4,6,251,156,95,1926-4-6,61
1926,4,7,272,187,85,1926-4-7,102
1926,4,8,258,163,95,1926-4-8,68
1926,4,9,514,142,372,1926-4-9,-230
1926,4,10,528,170,358,1926-4-10,-188
1926,4,11,396,139,257,1926-4-11,-118
1926,4,12,679,156,523,1926-4-12,-367
1926,4,13,702,269,433,1926-4-13,-164
1926,4,14,604,221,383,1926-4-14,-162
1926,4,15,687,175,512,1926-4-15,-337
1926,4,16,774,190,584,1926-4-16,-394
1926,4,17,808,353,455,1926-4-17,-102
1926,4,18,753,363,390,1926-4-18,-27
1926,4,19,700,352,348,1926-4-19,4
1926,4,20,777,523,254,1926-4-20,269
1926,4,21,578,366,212,1926-4-21,154
1926,4,22,489,249,240,1926-4-22,9
1926,4,23,91,13,78,1926-4-23,-65
1926,4,24,71,24,47,1926-4-24,-23
1926,4,25,36,6,30,1926-4-25,-24
1926,4,26,46,41,5,1926-4-26,36
1926,4,27,42,36,6,1926-4-27,30
1926,4,28,100,52,48,1926-4-28,4
1926,4,29,812,341,471,1926-4-29,-130
1926,4,30,1641,500,1141,1926-4-30,-641
1926,5,1,1530,318,1212,1926-5-1,-894
1926,5,2,1396,262,1134,1926-5-2,-872
1926,5,3,1284,312,972,1926-5-3,-660
1926,5,4,1535,500,1035,1926-5-4,-535
1926,5,5,1503,495,1008,1926-5-5,-513
1926,5,6,1252,363,889,1926-5-6,-526
1926,5,7,1173,290,883,1926-5-7,-593
1926,5,8,1683,385,1298,1926-5-8,-913
1926,5,9,1732,458,1274,1926-5-9,-816
1926,5,10,1684,238,1446,1926-5-10,-1208
1926,5,11,1757,182,1575,1926-5-11,-1393
1926,5,12,1427,197,1230,1926-5-12,-1033
1926,5,13,1430,401,1029,1926-5-13,-628
1926,5,14,1308,442,866,1926-5-14,-424
1926,5,15,1375,539,836,1926-5-15,-297
1926,5,16,1269,547,722,1926-5-16,-175
1926,5,17,1427,511,916,1926-5-17,-405
1926,5,18,1233,54,1179,1926-5-18,-1125
1926,5,19,1292,25,1267,1926-5-19,-1242
1926,5,20,975,54,921,1926-5-20,-867
1926,5,21,671,162,509,1926-5-21,-347
1926,5,22,637,167,470,1926-5-22,-303
1926,5,23,435,65,370,1926-5-23,-305
1926,5,24,423,25,398,1926-5-24,-373
1926,5,25,330,13,317,1926-5-25,-304
1926,5,26,412,9,403,1926-5-26,-394
1926,5,27,166,25,141,1926-5-27,-116
1926,5,28,208,15,193,1926-5-28,-178
1926,5,29,694,34,660,1926-5-29,-626
1926,5,30,705,72,633,1926-5-30,-561
1926,5,31,717,137,580,1926-5-31,-443
1926,6,1,983,403,580,1926-6-1,-177
1926,6,2,813,289,524,1926-6-2,-235
1926,6,3,1101,672,429,1926-6-3,243
1926,6,4,1556,977,579,1926-6-4,398
1926,6,5,1428,947,481,1926-6-5,466
1926,6,6,1283,856,427,1926-6-6,429
1926,6,7,1087,716,371,1926-6-7,345
1926,6,8,1258,835,423,1926-6-8,412
1926,6,9,1560,1012,548,1926-6-9,464
1926,6,10,1671,1057,614,1926-6-10,443
1926,6,11,1425,913,512,1926-6-11,401
1926,6,12,1095,712,383,1926-6-12,329
1926,6,13,1137,756,381,1926-6-13,375
1926,6,14,1338,823,515,1926-6-14,308
1926,6,15,1001,634,367,1926-6-15,267
1926,6,16,528,191,337,1926-6-16,-146
1926,6,17,472,309,163,1926-6-17,146
1926,6,18,602,507,95,1926-6-18,412
1926,6,19,941,729,212,1926-6-19,517
1926,6,20,1082,898,184,1926-6-20,714
1926,6,21,908,780,128,1926-6-21,652
1926,6,22,638,554,84,1926-6-22,470
1926,6,23,1469,1360,109,1926-6-23,1251
1926,6,24,1876,1765,111,1926-6-24,1654
1926,6,25,2013,1953,60,1926-6-25,1893
1926,6,26,1794,1701,93,1926-6-26,1608
1926,6,27,2007,1942,65,1926-6-27,1877
1926,6,28,1816,1689,127,1926-6-28,1562
1926,6,29,1754,1672,82,1926-6-29,1590
1926,6,30,1680,1637,43,1926-6-30,1594
1926,7,1,1818,1759,59,1926-7-1,1700
1926,7,2,1339,1246,93,1926-7-2,1153
1926,7,3,1265,1207,58,1926-7-3,1149
1926,7,4,875,853,22,1926-7-4,831
1926,7,5,743,661,82,1926-7-5,579
1926,7,6,172,107,65,1926-7-6,42
1926,7,7,125,0,125,1926-7-7,-125
1926,7,8,89,0,89,1926-7-8,-89
1926,7,9,81,14,67,1926-7-9,-53
1926,7,10,87,0,87,1926-7-10,-87
1926,7,11,163,12,151,1926-7-11,-139
1926,7,12,30,0,30,1926-7-12,-30
1926,7,13,20,0,20,1926-7-13,-20
1926,7,14,40,0,40,1926-7-14,-40
1926,7,15,40,0,40,1926-7-15,-40
1926,7,16,0,0,0,1926-7-16,0
1926,7,17,12,12,0,1926-7-17,12
1926,7,18,0,0,0,1926-7-18,0
1926,7,19,51,51,0,1926-7-19,51
1926,7,20,287,278,9,1926-7-20,269
1926,7,21,368,361,7,1926-7-21,354
1926,7,22,387,379,8,1926-7-22,371
1926,7,23,401,306,95,1926-7-23,211
1926,7,24,1517,304,1213,1926-7-24,-909
1926,7,25,2436,339,2097,1926-7-25,-1758
1926,7,26,2517,384,2133,1926-7-26,-1749
1926,7,27,2761,521,2240,1926-7-27,-1719
1926,7,28,2615,463,2152,1926-7-28,-1689
1926,7,29,2292,437,1855,1926-7-29,-1418
1926,7,30,1978,385,1593,1926-7-30,-1208
1926,7,31,1607,205,1402,1926-7-31,-1197
1926,8,1,1393,145,1248,1926-8-1,-1103
1926,8,2,1049,118,931,1926-8-2,-813
1926,8,3,1772,126,1646,1926-8-3,-1520
1926,8,4,1801,223,1578,1926-8-4,-1355
1926,8,5,1114,207,907,1926-8-5,-700
1926,8,6,870,82,788,1926-8-6,-706
1926,8,7,679,33,646,1926-8-7,-613
1926,8,8,555,12,543,1926-8-8,-531
1926,8,9,565,26,539,1926-8-9,-513
1926,8,10,1234,0,1234,1926-8-10,-1234
1926,8,11,1192,0,1192,1926-8-11,-1192
1926,8,12,1348,0,1348,1926-8-12,-1348
1926,8,13,1300,0,1300,1926-8-13,-1300
1926,8,14,917,0,917,1926-8-14,-917
1926,8,15,748,10,738,1926-8-15,-728
1926,8,16,681,0,681,1926-8-16,-681
1926,8,17,625,0,625,1926-8-17,-625
1926,8,18,609,0,609,1926-8-18,-609
1926,8,19,847,107,740,1926-8-19,-633
1926,8,20,910,113,797,1926-8-20,-684
1926,8,21,756,64,692,1926-8-21,-628
1926,8,22,485,95,390,1926-8-22,-295
1926,8,23,827,450,377,1926-8-23,73
1926,8,24,1052,701,351,1926-8-24,350
1926,8,25,1169,814,355,1926-8-25,459
1926,8,26,878,492,386,1926-8-26,106
1926,8,27,386,36,350,1926-8-27,-314
1926,8,28,341,49,292,1926-8-28,-243
1926,8,29,327,44,283,1926-8-29,-239
1926,8,30,410,45,365,1926-8-30,-320
1926,8,31,270,40,230,1926-8-31,-190
1926,9,1,334,21,313,1926-9-1,-292
1926,9,2,224,2,222,1926-9-2,-220
1926,9,3,284,0,284,1926-9-3,-284
1926,9,4,122,17,105,1926-9-4,-88
1926,9,5,121,11,110,1926-9-5,-99
1926,9,6,133,7,126,1926-9-6,-119
1926,9,7,135,6,129,1926-9-7,-123
1926,9,8,108,0,108,1926-9-8,-108
1926,9,9,81,36,45,1926-9-9,-9
1926,9,10,480,451,29,1926-9-10,422
1926,9,11,642,642,0,1926-9-11,642
1926,9,12,505,505,0,1926-9-12,505
1926,9,13,1465,1465,0,1926-9-13,1465
1926,9,14,1681,1681,0,1926-9-14,1681
1926,9,15,2173,2118,55,1926-9-15,2063
1926,9,16,2129,2039,90,1926-9-16,1949
1926,9,17,2308,2184,124,1926-9-17,2060
1926,9,18,2375,2309,66,1926-9-18,2243
1926,9,19,2372,2268,104,1926-9-19,2164
1926,9,20,2375,2170,205,1926-9-20,1965
1926,9,21,2268,2014,254,1926-9-21,1760
1926,9,22,2598,2175,423,1926-9-22,1752
1926,9,23,2397,1858,539,1926-9-23,1319
1926,9,24,2310,1775,535,1926-9-24,1240
1926,9,25,2208,1865,343,1926-9-25,1522
1926,9,26,1585,1064,521,1926-9-26,543
1926,9,27,1207,677,530,1926-9-27,147
1926,9,28,815,224,591,1926-9-28,-367
1926,9,29,532,77,455,1926-9-29,-378
1926,9,30,522,27,495,1926-9-30,-468
1926,10,1,323,10,313,1926-10-1,-303
1926,10,2,42,0,42,1926-10-2,-42
1926,10,3,105,9,96,1926-10-3,-87
1926,10,4,276,204,72,1926-10-4,132
1926,10,5,1129,1057,72,1926-10-5,985
1926,10,6,1347,1037,310,1926-10-6,727
1926,10,7,1947,1501,446,1926-10-7,1055
1926,10,8,2607,2187,420,1926-10-8,1767
1926,10,9,2328,2152,176,1926-10-9,1976
1926,10,10,2635,2548,87,1926-10-10,2461
1926,10,11,2647,2569,78,1926-10-11,2491
1926,10,12,3056,2978,78,1926-10-12,2900
1926,10,13,3042,2935,107,1926-10-13,2828
1926,10,14,2585,2498,87,1926-10-14,2411
1926,10,15,2787,2608,179,1926-10-15,2429
1926,10,16,2582,2261,321,1926-10-16,1940
1926,10,17,2354,2060,294,1926-10-17,1766
1926,10,18,1049,831,218,1926-10-18,613
1926,10,19,945,714,231,1926-10-19,483
1926,10,20,834,631,203,1926-10-20,428
1926,10,21,686,521,165,1926-10-21,356
1926,10,22,681,537,144,1926-10-22,393
1926,10,23,691,523,168,1926-10-23,355
1926,10,24,940,219,721,1926-10-24,-502
1926,10,25,986,218,768,1926-10-25,-550
1926,10,26,1153,253,900,1926-10-26,-647
1926,10,27,1036,155,881,1926-10-27,-726
1926,10,28,865,111,754,1926-10-28,-643
1926,10,29,917,63,854,1926-10-29,-791
1926,10,30,851,40,811,1926-10-30,-771
1926,10,31,552,20,532,1926-10-31,-512
1926,11,1,609,150,459,1926-11-1,-309
1926,11,2,754,281,473,1926-11-2,-192
1926,11,3,583,159,424,1926-11-3,-265
1926,11,4,727,401,326,1926-11-4,75
1926,11,5,719,366,353,1926-11-5,13
1926,11,6,320,309,11,1926-11-6,298
1926,11,7,317,317,0,1926-11-7,317
1926,11,8,305,244,61,1926-11-8,183
1926,11,9,361,208,153,1926-11-9,55
1926,11,10,393,174,219,1926-11-10,-45
1926,11,11,450,304,146,1926-11-11,158
1926,11,12,468,360,108,1926-11-12,252
1926,11,13,356,258,98,1926-11-13,160
1926,11,14,257,180,77,1926-11-14,103
1926,11,15,200,162,38,1926-11-15,124
1926,11,16,159,156,3,1926-11-16,153
1926,11,17,177,149,28,1926-11-17,121
1926,11,18,318,303,15,1926-11-18,288
1926,11,19,237,198,39,1926-11-19,159
1926,11,20,515,337,178,1926-11-20,159
1926,11,21,929,304,625,1926-11-21,-321
1926,11,22,960,306,654,1926-11-22,-348
1926,11,23,1458,494,964,1926-11-23,-470
1926,11,24,1487,449,1038,1926-11-24,-589
1926,11,25,1183,293,890,1926-11-25,-597
1926,11,26,1056,217,839,1926-11-26,-622
1926,11,27,958,193,765,1926-11-27,-572
1926,11,28,936,167,769,1926-11-28,-602
1926,11,29,1075,185,890,1926-11-29,-705
1926,11,30,1243,399,844,1926-11-30,-445
1926,12,1,1417,522,895,1926-12-1,-373
1926,12,2,1207,510,697,1926-12-2,-187
1926,12,3,986,424,562,1926-12-3,-138
1926,12,4,1163,540,623,1926-12-4,-83
1926,12,5,1055,492,563,1926-12-5,-71
1926,12,6,800,630,170,1926-12-6,460
1926,12,7,943,769,174,1926-12-7,595
1926,12,8,809,485,324,1926-12-8,161
1926,12,9,1137,260,877,1926-12-9,-617
1926,12,10,1329,452,877,1926-12-10,-425
1926,12,11,1501,666,835,1926-12-11,-169
1926,12,12,1410,636,774,1926-12-12,-138
1926,12,13,1607,889,718,1926-12-13,171
1926,12,14,1735,988,747,1926-12-14,241
1926,12,15,2095,1449,646,1926-12-15,803
1926,12,16,2047,1479,568,1926-12-16,911
1926,12,17,1651,1292,359,1926-12-17,933
1926,12,18,2352,2299,53,1926-12-18,2246
1926,12,19,2384,2328,56,1926-12-19,2272
1926,12,20,2177,2008,169,1926-12-20,1839
1926,12,21,1967,1587,380,1926-12-21,1207
1926,12,22,1129,726,403,1926-12-22,323
1926,12,23,1097,590,507,1926-12-23,83
1926,12,24,1214,609,605,1926-12-24,4
1926,12,25,1097,457,640,1926-12-25,-183
1926,12,26,1173,465,708,1926-12-26,-243
1926,12,27,1279,489,790,1926-12-27,-301
1926,12,28,1742,961,781,1926-12-28,180
1926,12,29,1665,949,716,1926-12-29,233
1926,12,30,1397,751,646,1926-12-30,105
1926,12,31,1071,556,515,1926-12-31,41
1927,1,1,1271,610,661,1927-1-1,-51
1927,1,2,1366,523,843,1927-1-2,-320
1927,1,3,2445,562,1883,1927-1-3,-1321
1927,1,4,2437,692,1745,1927-1-4,-1053
1927,1,5,2191,497,1694,1927-1-5,-1197
1927,1,6,2311,357,1954,1927-1-6,-1597
1927,1,7,2079,363,1716,1927-1-7,-1353
1927,1,8,1618,273,1345,1927-1-8,-1072
1927,1,9,1699,342,1357,1927-1-9,-1015
1927,1,10,1857,417,1440,1927-1-10,-1023
1927,1,11,2044,679,1365,1927-1-11,-686
1927,1,12,1643,564,1079,1927-1-12,-515
1927,1,13,1587,606,981,1927-1-13,-375
1927,1,14,1830,1035,795,1927-1-14,240
1927,1,15,1968,1281,687,1927-1-15,594
1927,1,16,2244,1343,901,1927-1-16,442
1927,1,17,2328,1466,862,1927-1-17,604
1927,1,18,2382,1506,876,1927-1-18,630
1927,1,19,2090,1417,673,1927-1-19,744
1927,1,20,2173,1502,671,1927-1-20,831
1927,1,21,1872,1277,595,1927-1-21,682
1927,1,22,1834,1195,639,1927-1-22,556
1927,1,23,1702,1130,572,1927-1-23,558
1927,1,24,1561,975,586,1927-1-24,389
1927,1,25,1412,901,511,1927-1-25,390
1927,1,26,638,226,412,1927-1-26,-186
1927,1,27,906,517,389,1927-1-27,128
1927,1,28,537,323,214,1927-1-28,109
1927,1,29,1524,375,1149,1927-1-29,-774
1927,1,30,2079,252,1827,1927-1-30,-1575
1927,1,31,2482,256,2226,1927-1-31,-1970
1927,2,1,2706,395,2311,1927-2-1,-1916
1927,2,2,2504,593,1911,1927-2-2,-1318
1927,2,3,2444,507,1937,1927-2-3,-1430
1927,2,4,2725,547,2178,1927-2-4,-1631
1927,2,5,2534,724,1810,1927-2-5,-1086
1927,2,6,2479,875,1604,1927-2-6,-729
1927,2,7,2598,832,1766,1927-2-7,-934
1927,2,8,2510,797,1713,1927-2-8,-916
1927,2,9,2130,741,1389,1927-2-9,-648
1927,2,10,2131,781,1350,1927-2-10,-569
1927,2,11,1488,664,824,1927-2-11,-160
1927,2,12,1514,518,996,1927-2-12,-478
1927,2,13,1302,358,944,1927-2-13,-586
1927,2,14,1081,185,896,1927-2-14,-711
1927,2,15,1068,200,868,1927-2-15,-668
1927,2,16,752,520,232,1927-2-16,288
1927,2,17,664,441,223,1927-2-17,218
1927,2,18,482,267,215,1927-2-18,52
1927,2,19,428,116,312,1927-2-19,-196
1927,2,20,526,109,417,1927-2-20,-308
1927,2,21,590,165,425,1927-2-21,-260
1927,2,22,543,62,481,1927-2-22,-419
1927,2,23,532,88,444,1927-2-23,-356
1927,2,24,606,83,523,1927-2-24,-440
1927,2,25,487,101,386,1927-2-25,-285
1927,2,26,477,101,376,1927-2-26,-275
1927,2,27,485,152,333,1927-2-27,-181
1927,2,28,427,215,212,1927-2-28,3
1927,3,1,309,130,179,1927-3-1,-49
1927,3,2,441,276,165,1927-3-2,111
1927,3,3,692,207,485,1927-3-3,-278
1927,3,4,739,183,556,1927-3-4,-373
1927,3,5,666,125,541,1927-3-5,-416
1927,3,6,645,188,457,1927-3-6,-269
1927,3,7,650,192,458,1927-3-7,-266
1927,3,8,688,237,451,1927-3-8,-214
1927,3,9,624,105,519,1927-3-9,-414
1927,3,10,399,30,369,1927-3-10,-339
1927,3,11,721,279,442,1927-3-11,-163
1927,3,12,724,268,456,1927-3-12,-188
1927,3,13,927,475,452,1927-3-13,23
1927,3,14,2215,1682,533,1927-3-14,1149
1927,3,15,2326,1782,544,1927-3-15,1238
1927,3,16,2215,1733,482,1927-3-16,1251
1927,3,17,1999,1585,414,1927-3-17,1171
1927,3,18,1602,1289,313,1927-3-18,976
1927,3,19,1798,1384,414,1927-3-19,970
1927,3,20,1648,1317,331,1927-3-20,986
1927,3,21,1584,1280,304,1927-3-21,976
1927,3,22,1136,941,195,1927-3-22,746
1927,3,23,984,764,220,1927-3-23,544
1927,3,24,702,594,108,1927-3-24,486
1927,3,25,617,535,82,1927-3-25,453
1927,3,26,193,147,46,1927-3-26,101
1927,3,27,121,52,69,1927-3-27,-17
1927,3,28,53,11,42,1927-3-28,-31
1927,3,29,118,102,16,1927-3-29,86
1927,3,30,106,86,20,1927-3-30,66
1927,3,31,329,318,11,1927-3-31,307
1927,4,1,970,815,155,1927-4-1,660
1927,4,2,1288,923,365,1927-4-2,558
1927,4,3,1756,1173,583,1927-4-3,590
1927,4,4,1997,1151,846,1927-4-4,305
1927,4,5,1756,1024,732,1927-4-5,292
1927,4,6,2083,1066,1017,1927-4-6,49
1927,4,7,1985,980,1005,1927-4-7,-25
1927,4,8,1603,710,893,1927-4-8,-183
1927,4,9,1659,775,884,1927-4-9,-109
1927,4,10,1929,886,1043,1927-4-10,-157
1927,4,11,2195,1233,962,1927-4-11,271
1927,4,12,2460,1359,1101,1927-4-12,258
1927,4,13,1609,559,1050,1927-4-13,-491
1927,4,14,1628,498,1130,1927-4-14,-632
1927,4,15,1608,421,1187,1927-4-15,-766
1927,4,16,1756,501,1255,1927-4-16,-754
1927,4,17,1820,415,1405,1927-4-17,-990
1927,4,18,1534,401,1133,1927-4-18,-732
1927,4,19,1134,276,858,1927-4-19,-582
1927,4,20,1082,193,889,1927-4-20,-696
1927,4,21,918,97,821,1927-4-21,-724
1927,4,22,821,147,674,1927-4-22,-527
1927,4,23,904,197,707,1927-4-23,-510
1927,4,24,580,142,438,1927-4-24,-296
1927,4,25,770,342,428,1927-4-25,-86
1927,4,26,900,369,531,1927-4-26,-162
1927,4,27,1170,422,748,1927-4-27,-326
1927,4,28,612,296,316,1927-4-28,-20
1927,4,29,442,260,182,1927-4-29,78
1927,4,30,400,192,208,1927-4-30,-16
1927,5,1,425,138,287,1927-5-1,-149
1927,5,2,559,215,344,1927-5-2,-129
1927,5,3,666,130,536,1927-5-3,-406
1927,5,4,805,129,676,1927-5-4,-547
1927,5,5,1074,97,977,1927-5-5,-880
1927,5,6,1002,101,901,1927-5-6,-800
1927,5,7,914,154,760,1927-5-7,-606
1927,5,8,588,78,510,1927-5-8,-432
1927,5,9,770,54,716,1927-5-9,-662
1927,5,10,1020,311,709,1927-5-10,-398
1927,5,11,1740,757,983,1927-5-11,-226
1927,5,12,1650,1090,560,1927-5-12,530
1927,5,13,1483,1140,343,1927-5-13,797
1927,5,14,1682,1409,273,1927-5-14,1136
1927,5,15,1795,1431,364,1927-5-15,1067
1927,5,16,2063,1679,384,1927-5-16,1295
1927,5,17,1966,1618,348,1927-5-17,1270
1927,5,18,860,532,328,1927-5-18,204
1927,5,19,400,134,266,1927-5-19,-132
1927,5,20,686,129,557,1927-5-20,-428
1927,5,21,782,166,616,1927-5-21,-450
1927,5,22,698,150,548,1927-5-22,-398
1927,5,23,670,59,611,1927-5-23,-552
1927,5,24,791,73,718,1927-5-24,-645
1927,5,25,811,42,769,1927-5-25,-727
1927,5,26,986,37,949,1927-5-26,-912
1927,5,27,971,22,949,1927-5-27,-927
1927,5,28,679,9,670,1927-5-28,-661
1927,5,29,648,3,645,1927-5-29,-642
1927,5,30,424,0,424,1927-5-30,-424
1927,5,31,378,0,378,1927-5-31,-378
1927,6,1,364,0,364,1927-6-1,-364
1927,6,2,1244,973,271,1927-6-2,702
1927,6,3,1270,1069,201,1927-6-3,868
1927,6,4,1413,1258,155,1927-6-4,1103
1927,6,5,1212,1113,99,1927-6-5,1014
1927,6,6,1362,1328,34,1927-6-6,1294
1927,6,7,1334,1329,5,1927-6-7,1324
1927,6,8,1789,1750,39,1927-6-8,1711
1927,6,9,1572,1547,25,1927-6-9,1522
1927,6,10,1432,1290,142,1927-6-10,1148
1927,6,11,1237,1026,211,1927-6-11,815
1927,6,12,1027,749,278,1927-6-12,471
1927,6,13,989,721,268,1927-6-13,453
1927,6,14,646,451,195,1927-6-14,256
1927,6,15,199,7,192,1927-6-15,-185
1927,6,16,136,7,129,1927-6-16,-122
1927,6,17,179,0,179,1927-6-17,-179
1927,6,18,176,0,176,1927-6-18,-176
1927,6,19,230,0,230,1927-6-19,-230
1927,6,20,321,0,321,1927-6-20,-321
1927,6,21,342,0,342,1927-6-21,-342
1927,6,22,446,0,446,1927-6-22,-446
1927,6,23,508,0,508,1927-6-23,-508
1927,6,24,485,0,485,1927-6-24,-485
1927,6,25,664,16,648,1927-6-25,-632
1927,6,26,623,34,589,1927-6-26,-555
1927,6,27,949,284,665,1927-6-27,-381
1927,6,28,1117,337,780,1927-6-28,-443
1927,6,29,1492,864,628,1927-6-29,236
1927,6,30,1450,815,635,1927-6-30,180
1927,7,1,1888,1008,880,1927-7-1,128
1927,7,2,1877,1020,857,1927-7-2,163
1927,7,3,1792,929,863,1927-7-3,66
1927,7,4,1693,891,802,1927-7-4,89
1927,7,5,1574,805,769,1927-7-5,36
1927,7,6,1432,763,669,1927-7-6,94
1927,7,7,854,813,41,1927-7-7,772
1927,7,8,897,763,134,1927-7-8,629
1927,7,9,739,605,134,1927-7-9,471
1927,7,10,536,459,77,1927-7-10,382
1927,7,11,538,490,48,1927-7-11,442
1927,7,12,36,17,19,1927-7-12,-2
1927,7,13,254,15,239,1927-7-13,-224
1927,7,14,242,28,214,1927-7-14,-186
1927,7,15,289,32,257,1927-7-15,-225
1927,7,16,373,85,288,1927-7-16,-203
1927,7,17,497,103,394,1927-7-17,-291
1927,7,18,416,33,383,1927-7-18,-350
1927,7,19,315,130,185,1927-7-19,-55
1927,7,20,353,171,182,1927-7-20,-11
1927,7,21,723,161,562,1927-7-21,-401
1927,7,22,925,138,787,1927-7-22,-649
1927,7,23,883,127,756,1927-7-23,-629
1927,7,24,935,187,748,1927-7-24,-561
1927,7,25,881,259,622,1927-7-25,-363
1927,7,26,809,187,622,1927-7-26,-435
1927,7,27,902,205,697,1927-7-27,-492
1927,7,28,654,147,507,1927-7-28,-360
1927,7,29,636,105,531,1927-7-29,-426
1927,7,30,614,115,499,1927-7-30,-384
1927,7,31,608,86,522,1927-7-31,-436
1927,8,1,690,160,530,1927-8-1,-370
1927,8,2,677,141,536,1927-8-2,-395
1927,8,3,315,186,129,1927-8-3,57
1927,8,4,567,410,157,1927-8-4,253
1927,8,5,383,16,367,1927-8-5,-351
1927,8,6,502,51,451,1927-8-6,-400
1927,8,7,239,0,239,1927-8-7,-239
1927,8,8,250,0,250,1927-8-8,-250
1927,8,9,520,0,520,1927-8-9,-520
1927,8,10,475,0,475,1927-8-10,-475
1927,8,11,375,0,375,1927-8-11,-375
1927,8,12,201,0,201,1927-8-12,-201
1927,8,13,340,14,326,1927-8-13,-312
1927,8,14,697,0,697,1927-8-14,-697
1927,8,15,1229,19,1210,1927-8-15,-1191
1927,8,16,1528,48,1480,1927-8-16,-1432
1927,8,17,1711,65,1646,1927-8-17,-1581
1927,8,18,2236,75,2161,1927-8-18,-2086
1927,8,19,2306,48,2258,1927-8-19,-2210
1927,8,20,1960,22,1938,1927-8-20,-1916
1927,8,21,772,161,611,1927-8-21,-450
1927,8,22,1433,361,1072,1927-8-22,-711
1927,8,23,1543,480,1063,1927-8-23,-583
1927,8,24,1714,492,1222,1927-8-24,-730
1927,8,25,1688,534,1154,1927-8-25,-620
1927,8,26,1549,428,1121,1927-8-26,-693
1927,8,27,1251,28,1223,1927-8-27,-1195
1927,8,28,1239,30,1209,1927-8-28,-1179
1927,8,29,1324,25,1299,1927-8-29,-1274
1927,8,30,1205,9,1196,1927-8-30,-1187
1927,8,31,1015,0,1015,1927-8-31,-1015
1927,9,1,983,0,983,1927-9-1,-983
1927,9,2,1110,0,1110,1927-9-2,-1110
1927,9,3,878,0,878,1927-9-3,-878
1927,9,4,842,0,842,1927-9-4,-842
1927,9,5,760,0,760,1927-9-5,-760
1927,9,6,646,0,646,1927-9-6,-646
1927,9,7,637,29,608,1927-9-7,-579
1927,9,8,578,8,570,1927-9-8,-562
1927,9,9,439,0,439,1927-9-9,-439
1927,9,10,364,0,364,1927-9-10,-364
1927,9,11,547,56,491,1927-9-11,-435
1927,9,12,1094,30,1064,1927-9-12,-1034
1927,9,13,2105,290,1815,1927-9-13,-1525
1927,9,14,2505,303,2202,1927-9-14,-1899
1927,9,15,2935,308,2627,1927-9-15,-2319
1927,9,16,2886,299,2587,1927-9-16,-2288
1927,9,17,2826,221,2605,1927-9-17,-2384
1927,9,18,2779,244,2535,1927-9-18,-2291
1927,9,19,2844,192,2652,1927-9-19,-2460
1927,9,20,1292,258,1034,1927-9-20,-776
1927,9,21,462,271,191,1927-9-21,80
1927,9,22,705,280,425,1927-9-22,-145
1927,9,23,887,482,405,1927-9-23,77
1927,9,24,1006,535,471,1927-9-24,64
1927,9,25,995,457,538,1927-9-25,-81
1927,9,26,670,154,516,1927-9-26,-362
1927,9,27,509,81,428,1927-9-27,-347
1927,9,28,349,8,341,1927-9-28,-333
1927,9,29,290,26,264,1927-9-29,-238
1927,9,30,269,18,251,1927-9-30,-233
1927,10,1,356,44,312,1927-10-1,-268
1927,10,2,636,239,397,1927-10-2,-158
1927,10,3,693,323,370,1927-10-3,-47
1927,10,4,1072,455,617,1927-10-4,-162
1927,10,5,1223,502,721,1927-10-5,-219
1927,10,6,1117,403,714,1927-10-6,-311
1927,10,7,1102,420,682,1927-10-7,-262
1927,10,8,1213,456,757,1927-10-8,-301
1927,10,9,1231,329,902,1927-10-9,-573
1927,10,10,1555,434,1121,1927-10-10,-687
1927,10,11,1213,345,868,1927-10-11,-523
1927,10,12,1028,224,804,1927-10-12,-580
1927,10,13,917,207,710,1927-10-13,-503
1927,10,14,948,254,694,1927-10-14,-440
1927,10,15,818,254,564,1927-10-15,-310
1927,10,16,495,138,357,1927-10-16,-219
1927,10,17,639,142,497,1927-10-17,-355
1927,10,18,602,156,446,1927-10-18,-290
1927,10,19,822,157,665,1927-10-19,-508
1927,10,20,598,110,488,1927-10-20,-378
1927,10,21,742,109,633,1927-10-21,-524
1927,10,22,778,87,691,1927-10-22,-604
1927,10,23,1097,197,900,1927-10-23,-703
1927,10,24,1217,0,1217,1927-10-24,-1217
1927,10,25,1026,49,977,1927-10-25,-928
1927,10,26,572,31,541,1927-10-26,-510
1927,10,27,194,13,181,1927-10-27,-168
1927,10,28,134,6,128,1927-10-28,-122
1927,10,29,247,138,109,1927-10-29,29
1927,10,30,552,496,56,1927-10-30,440
1927,10,31,562,482,80,1927-10-31,402
1927,11,1,416,344,72,1927-11-1,272
1927,11,2,298,244,54,1927-11-2,190
1927,11,3,198,162,36,1927-11-3,126
1927,11,4,158,151,7,1927-11-4,144
1927,11,5,222,222,0,1927-11-5,222
1927,11,6,199,165,34,1927-11-6,131
1927,11,7,82,52,30,1927-11-7,22
1927,11,8,95,4,91,1927-11-8,-87
1927,11,9,909,41,868,1927-11-9,-827
1927,11,10,1745,101,1644,1927-11-10,-1543
1927,11,11,2103,219,1884,1927-11-11,-1665
1927,11,12,1988,246,1742,1927-11-12,-1496
1927,11,13,1951,192,1759,1927-11-13,-1567
1927,11,14,1874,234,1640,1927-11-14,-1406
1927,11,15,1677,293,1384,1927-11-15,-1091
1927,11,16,1547,364,1183,1927-11-16,-819
1927,11,17,856,367,489,1927-11-17,-122
1927,11,18,1073,462,611,1927-11-18,-149
1927,11,19,952,356,596,1927-11-19,-240
1927,11,20,961,314,647,1927-11-20,-333
1927,11,21,831,257,574,1927-11-21,-317
1927,11,22,654,286,368,1927-11-22,-82
1927,11,23,761,299,462,1927-11-23,-163
1927,11,24,944,226,718,1927-11-24,-492
1927,11,25,1136,197,939,1927-11-25,-742
1927,11,26,1241,197,1044,1927-11-26,-847
1927,11,27,1111,175,936,1927-11-27,-761
1927,11,28,963,6,957,1927-11-28,-951
1927,11,29,1100,0,1100,1927-11-29,-1100
1927,11,30,1212,7,1205,1927-11-30,-1198
1927,12,1,1258,0,1258,1927-12-1,-1258
1927,12,2,121,35,86,1927-12-2,-51
1927,12,3,60,20,40,1927-12-3,-20
1927,12,4,24,13,11,1927-12-4,2
1927,12,5,313,123,190,1927-12-5,-67
1927,12,6,544,120,424,1927-12-6,-304
1927,12,7,423,109,314,1927-12-7,-205
1927,12,8,610,261,349,1927-12-8,-88
1927,12,9,680,244,436,1927-12-9,-192
1927,12,10,923,195,728,1927-12-10,-533
1927,12,11,1120,171,949,1927-12-11,-778
1927,12,12,1370,200,1170,1927-12-12,-970
1927,12,13,1641,176,1465,1927-12-13,-1289
1927,12,14,1403,177,1226,1927-12-14,-1049
1927,12,15,529,166,363,1927-12-15,-197
1927,12,16,157,139,18,1927-12-16,121
1927,12,17,179,142,37,1927-12-17,105
1927,12,18,114,114,0,1927-12-18,114
1927,12,19,121,121,0,1927-12-19,121
1927,12,20,41,41,0,1927-12-20,41
1927,12,21,72,61,11,1927-12-21,50
1927,12,22,71,65,6,1927-12-22,59
1927,12,23,203,184,19,1927-12-23,165
1927,12,24,349,144,205,1927-12-24,-61
1927,12,25,428,143,285,1927-12-25,-142
1927,12,26,504,282,222,1927-12-26,60
1927,12,27,635,369,266,1927-12-27,103
1927,12,28,1034,422,612,1927-12-28,-190
1927,12,29,1575,696,879,1927-12-29,-183
1927,12,30,1522,706,816,1927-12-30,-110
1927,12,31,1292,434,858,1927-12-31,-424
1928,1,1,1311,407,904,1928-1-1,-497
1928,1,2,1246,276,970,1928-1-2,-694
1928,1,3,1199,24,1175,1928-1-3,-1151
1928,1,4,1318,57,1261,1928-1-4,-1204
1928,1,5,1265,77,1188,1928-1-5,-1111
1928,1,6,1182,255,927,1928-1-6,-672
1928,1,7,1016,209,807,1928-1-7,-598
1928,1,8,943,223,720,1928-1-8,-497
1928,1,9,955,236,719,1928-1-9,-483
1928,1,10,567,294,273,1928-1-10,21
1928,1,11,983,407,576,1928-1-11,-169
1928,1,12,946,294,652,1928-1-12,-358
1928,1,13,874,264,610,1928-1-13,-346
1928,1,14,882,258,624,1928-1-14,-366
1928,1,15,857,399,458,1928-1-15,-59
1928,1,16,1305,875,430,1928-1-16,445
1928,1,17,2015,1700,315,1928-1-17,1385
1928,1,18,1772,1553,219,1928-1-18,1334
1928,1,19,1756,1617,139,1928-1-19,1478
1928,1,20,1615,1615,0,1928-1-20,1615
1928,1,21,1584,1577,7,1928-1-21,1570
1928,1,22,1544,1514,30,1928-1-22,1484
1928,1,23,1401,1390,11,1928-1-23,1379
1928,1,24,2498,1296,1202,1928-1-24,94
1928,1,25,2751,1479,1272,1928-1-25,207
1928,1,26,2750,1372,1378,1928-1-26,-6
1928,1,27,2703,1505,1198,1928-1-27,307
1928,1,28,1979,984,995,1928-1-28,-11
1928,1,29,1640,667,973,1928-1-29,-306
1928,1,30,1838,793,1045,1928-1-30,-252
1928,1,31,2089,1051,1038,1928-1-31,13
1928,2,1,982,57,925,1928-2-1,-868
1928,2,2,1067,55,1012,1928-2-2,-957
1928,2,3,834,66,768,1928-2-3,-702
1928,2,4,842,17,825,1928-2-4,-808
1928,2,5,755,0,755,1928-2-5,-755
1928,2,6,137,22,115,1928-2-6,-93
1928,2,7,171,18,153,1928-2-7,-135
1928,2,8,84,0,84,1928-2-8,-84
1928,2,9,76,0,76,1928-2-9,-76
1928,2,10,83,10,73,1928-2-10,-63
1928,2,11,140,76,64,1928-2-11,12
1928,2,12,397,397,0,1928-2-12,397
1928,2,13,568,502,66,1928-2-13,436
1928,2,14,665,617,48,1928-2-14,569
1928,2,15,2106,2044,62,1928-2-15,1982
1928,2,16,1636,1543,93,1928-2-16,1450
1928,2,17,1716,1472,244,1928-2-17,1228
1928,2,18,1690,1443,247,1928-2-18,1196
1928,2,19,1893,1361,532,1928-2-19,829
1928,2,20,1933,1013,920,1928-2-20,93
1928,2,21,1868,835,1033,1928-2-21,-198
1928,2,22,1799,751,1048,1928-2-22,-297
1928,2,23,1434,554,880,1928-2-23,-326
1928,2,24,1296,525,771,1928-2-24,-246
1928,2,25,1408,515,893,1928-2-25,-378
1928,2,26,1666,427,1239,1928-2-26,-812
1928,2,27,2039,373,1666,1928-2-27,-1293
1928,2,28,2033,0,2033,1928-2-28,-2033
1928,2,29,1922,0,1922,1928-2-29,-1922
1928,3,1,1941,0,1941,1928-3-1,-1941
1928,3,2,1632,16,1616,1928-3-2,-1600
1928,3,3,653,16,637,1928-3-3,-621
1928,3,4,751,234,517,1928-3-4,-283
1928,3,5,852,530,322,1928-3-5,208
1928,3,6,956,648,308,1928-3-6,340
1928,3,7,1234,919,315,1928-3-7,604
1928,3,8,1147,818,329,1928-3-8,489
1928,3,9,1680,1027,653,1928-3-9,374
1928,3,10,1829,1246,583,1928-3-10,663
1928,3,11,2213,1487,726,1928-3-11,761
1928,3,12,2961,1607,1354,1928-3-12,253
1928,3,13,2746,1486,1260,1928-3-13,226
1928,3,14,2681,1427,1254,1928-3-14,173
1928,3,15,2476,1302,1174,1928-3-15,128
1928,3,16,2461,1238,1223,1928-3-16,15
1928,3,17,2441,1279,1162,1928-3-17,117
1928,3,18,2288,1441,847,1928-3-18,594
1928,3,19,2261,1369,892,1928-3-19,477
1928,3,20,2355,1504,851,1928-3-20,653
1928,3,21,2214,1433,781,1928-3-21,652
1928,3,22,2276,1481,795,1928-3-22,686
1928,3,23,2109,1503,606,1928-3-23,897
1928,3,24,2194,1493,701,1928-3-24,792
1928,3,25,1039,466,573,1928-3-25,-107
1928,3,26,634,79,555,1928-3-26,-476
1928,3,27,1119,537,582,1928-3-27,-45
1928,3,28,809,419,390,1928-3-28,29
1928,3,29,994,650,344,1928-3-29,306
1928,3,30,807,485,322,1928-3-30,163
1928,3,31,770,529,241,1928-3-31,288
1928,4,1,843,528,315,1928-4-1,213
1928,4,2,1355,475,880,1928-4-2,-405
1928,4,3,1774,553,1221,1928-4-3,-668
1928,4,4,1833,776,1057,1928-4-4,-281
1928,4,5,1883,776,1107,1928-4-5,-331
1928,4,6,2078,730,1348,1928-4-6,-618
1928,4,7,2137,640,1497,1928-4-7,-857
1928,4,8,2315,671,1644,1928-4-8,-973
1928,4,9,2113,589,1524,1928-4-9,-935
1928,4,10,2529,825,1704,1928-4-10,-879
1928,4,11,2618,880,1738,1928-4-11,-858
1928,4,12,2073,650,1423,1928-4-12,-773
1928,4,13,1757,475,1282,1928-4-13,-807
1928,4,14,1657,469,1188,1928-4-14,-719
1928,4,15,1448,465,983,1928-4-15,-518
1928,4,16,884,561,323,1928-4-16,238
1928,4,17,573,325,248,1928-4-17,77
1928,4,18,445,251,194,1928-4-18,57
1928,4,19,836,238,598,1928-4-19,-360
1928,4,20,702,219,483,1928-4-20,-264
1928,4,21,678,205,473,1928-4-21,-268
1928,4,22,630,304,326,1928-4-22,-22
1928,4,23,348,45,303,1928-4-23,-258
1928,4,24,645,44,601,1928-4-24,-557
1928,4,25,814,51,763,1928-4-25,-712
1928,4,26,954,38,916,1928-4-26,-878
1928,4,27,1239,205,1034,1928-4-27,-829
1928,4,28,1269,330,939,1928-4-28,-609
1928,4,29,1169,492,677,1928-4-29,-185
1928,4,30,1444,464,980,1928-4-30,-516
1928,5,1,1490,545,945,1928-5-1,-400
1928,5,2,2115,657,1458,1928-5-2,-801
1928,5,3,2855,619,2236,1928-5-3,-1617
1928,5,4,2580,497,2083,1928-5-4,-1586
1928,5,5,2630,462,2168,1928-5-5,-1706
1928,5,6,2571,467,2104,1928-5-6,-1637
1928,5,7,2442,542,1900,1928-5-7,-1358
1928,5,8,2313,406,1907,1928-5-8,-1501
1928,5,9,2276,345,1931,1928-5-9,-1586
1928,5,10,2011,100,1911,1928-5-10,-1811
1928,5,11,1300,33,1267,1928-5-11,-1234
1928,5,12,1537,8,1529,1928-5-12,-1521
1928,5,13,979,7,972,1928-5-13,-965
1928,5,14,308,0,308,1928-5-14,-308
1928,5,15,177,18,159,1928-5-15,-141
1928,5,16,57,0,57,1928-5-16,-57
1928,5,17,29,0,29,1928-5-17,-29
1928,5,18,19,0,19,1928-5-18,-19
1928,5,19,24,0,24,1928-5-19,-24
1928,5,20,5,0,5,1928-5-20,-5
1928,5,21,114,0,114,1928-5-21,-114
1928,5,22,180,69,111,1928-5-22,-42
1928,5,23,227,77,150,1928-5-23,-73
1928,5,24,318,148,170,1928-5-24,-22
1928,5,25,303,142,161,1928-5-25,-19
1928,5,26,378,92,286,1928-5-26,-194
1928,5,27,777,61,716,1928-5-27,-655
1928,5,28,2152,540,1612,1928-5-28,-1072
1928,5,29,2477,755,1722,1928-5-29,-967
1928,5,30,2193,714,1479,1928-5-30,-765
1928,5,31,1700,526,1174,1928-5-31,-648
1928,6,1,1579,583,996,1928-6-1,-413
1928,6,2,1257,492,765,1928-6-2,-273
1928,6,3,999,442,557,1928-6-3,-115
1928,6,4,779,430,349,1928-6-4,81
1928,6,5,1097,534,563,1928-6-5,-29
1928,6,6,1197,769,428,1928-6-6,341
1928,6,7,1395,963,432,1928-6-7,531
1928,6,8,1004,794,210,1928-6-8,584
1928,6,9,839,749,90,1928-6-9,659
1928,6,10,715,657,58,1928-6-10,599
1928,6,11,448,423,25,1928-6-11,398
1928,6,12,48,32,16,1928-6-12,16
1928,6,13,110,43,67,1928-6-13,-24
1928,6,14,289,262,27,1928-6-14,235
1928,6,15,449,404,45,1928-6-15,359
1928,6,16,671,379,292,1928-6-16,87
1928,6,17,1088,707,381,1928-6-17,326
1928,6,18,1013,750,263,1928-6-18,487
1928,6,19,1377,1147,230,1928-6-19,917
1928,6,20,1301,1084,217,1928-6-20,867
1928,6,21,1519,1148,371,1928-6-21,777
1928,6,22,1744,1220,524,1928-6-22,696
1928,6,23,2270,1449,821,1928-6-23,628
1928,6,24,2692,1824,868,1928-6-24,956
1928,6,25,2896,2005,891,1928-6-25,1114
1928,6,26,2598,1785,813,1928-6-26,972
1928,6,27,2700,1742,958,1928-6-27,784
1928,6,28,2754,1825,929,1928-6-28,896
1928,6,29,2201,1313,888,1928-6-29,425
1928,6,30,1738,723,1015,1928-6-30,-292
1928,7,1,2102,428,1674,1928-7-1,-1246
1928,7,2,2239,284,1955,1928-7-2,-1671
1928,7,3,2172,208,1964,1928-7-3,-1756
1928,7,4,1645,182,1463,1928-7-4,-1281
1928,7,5,959,41,918,1928-7-5,-877
1928,7,6,1197,400,797,1928-7-6,-397
1928,7,7,1686,824,862,1928-7-7,-38
1928,7,8,2029,1296,733,1928-7-8,563
1928,7,9,1890,1279,611,1928-7-9,668
1928,7,10,1809,1324,485,1928-7-10,839
1928,7,11,1769,1320,449,1928-7-11,871
1928,7,12,1841,1303,538,1928-7-12,765
1928,7,13,2553,1882,671,1928-7-13,1211
1928,7,14,2991,2116,875,1928-7-14,1241
1928,7,15,3144,1929,1215,1928-7-15,714
1928,7,16,3246,1927,1319,1928-7-16,608
1928,7,17,3374,1918,1456,1928-7-17,462
1928,7,18,3341,1911,1430,1928-7-18,481
1928,7,19,2439,1154,1285,1928-7-19,-131
1928,7,20,2429,1305,1124,1928-7-20,181
1928,7,21,2035,1062,973,1928-7-21,89
1928,7,22,1624,776,848,1928-7-22,-72
1928,7,23,1040,673,367,1928-7-23,306
1928,7,24,861,628,233,1928-7-24,395
1928,7,25,1410,598,812,1928-7-25,-214
1928,7,26,1152,510,642,1928-7-26,-132
1928,7,27,984,463,521,1928-7-27,-58
1928,7,28,1133,640,493,1928-7-28,147
1928,7,29,1485,1085,400,1928-7-29,685
1928,7,30,1700,1374,326,1928-7-30,1048
1928,7,31,1750,1540,210,1928-7-31,1330
1928,8,1,1588,1440,148,1928-8-1,1292
1928,8,2,1599,1453,146,1928-8-2,1307
1928,8,3,1694,1441,253,1928-8-3,1188
1928,8,4,1528,1257,271,1928-8-4,986
1928,8,5,1310,1164,146,1928-8-5,1018
1928,8,6,1162,995,167,1928-8-6,828
1928,8,7,879,397,482,1928-8-7,-85
1928,8,8,1120,289,831,1928-8-8,-542
1928,8,9,1096,313,783,1928-8-9,-470
1928,8,10,1242,530,712,1928-8-10,-182
1928,8,11,1103,534,569,1928-8-11,-35
1928,8,12,1083,567,516,1928-8-12,51
1928,8,13,1133,672,461,1928-8-13,211
1928,8,14,950,649,301,1928-8-14,348
1928,8,15,657,337,320,1928-8-15,17
1928,8,16,871,259,612,1928-8-16,-353
1928,8,17,530,239,291,1928-8-17,-52
1928,8,18,721,512,209,1928-8-18,303
1928,8,19,606,417,189,1928-8-19,228
1928,8,20,1116,394,722,1928-8-20,-328
1928,8,21,1716,551,1165,1928-8-21,-614
1928,8,22,1823,587,1236,1928-8-22,-649
1928,8,23,1957,634,1323,1928-8-23,-689
1928,8,24,2381,994,1387,1928-8-24,-393
1928,8,25,2507,1070,1437,1928-8-25,-367
1928,8,26,2383,984,1399,1928-8-26,-415
1928,8,27,2266,1069,1197,1928-8-27,-128
1928,8,28,1269,975,294,1928-8-28,681
1928,8,29,1183,1008,175,1928-8-29,833
1928,8,30,1014,832,182,1928-8-30,650
1928,8,31,801,663,138,1928-8-31,525
1928,9,1,626,527,99,1928-9-1,428
1928,9,2,634,547,87,1928-9-2,460
1928,9,3,829,572,257,1928-9-3,315
1928,9,4,528,184,344,1928-9-4,-160
1928,9,5,460,161,299,1928-9-5,-138
1928,9,6,718,404,314,1928-9-6,90
1928,9,7,873,747,126,1928-9-7,621
1928,9,8,982,912,70,1928-9-8,842
1928,9,9,1401,1341,60,1928-9-9,1281
1928,9,10,1518,1473,45,1928-9-10,1428
1928,9,11,1904,1582,322,1928-9-11,1260
1928,9,12,1730,1389,341,1928-9-12,1048
1928,9,13,1612,1288,324,1928-9-13,964
1928,9,14,1431,1143,288,1928-9-14,855
1928,9,15,1502,1267,235,1928-9-15,1032
1928,9,16,1621,1402,219,1928-9-16,1183
1928,9,17,2045,1569,476,1928-9-17,1093
1928,9,18,3911,3033,878,1928-9-18,2155
1928,9,19,3678,2403,1275,1928-9-19,1128
1928,9,20,3110,1824,1286,1928-9-20,538
1928,9,21,2943,1716,1227,1928-9-21,489
1928,9,22,3108,1414,1694,1928-9-22,-280
1928,9,23,3955,1526,2429,1928-9-23,-903
1928,9,24,3699,1292,2407,1928-9-24,-1115
1928,9,25,4222,1356,2866,1928-9-25,-1510
1928,9,26,4266,1338,2928,1928-9-26,-1590
1928,9,27,4092,1135,2957,1928-9-27,-1822
1928,9,28,3488,901,2587,1928-9-28,-1686
1928,9,29,2944,822,2122,1928-9-29,-1300
1928,9,30,2574,674,1900,1928-9-30,-1226
1928,10,1,1799,97,1702,1928-10-1,-1605
1928,10,2,1384,114,1270,1928-10-2,-1156
1928,10,3,773,429,344,1928-10-3,85
1928,10,4,474,425,49,1928-10-4,376
1928,10,5,409,334,75,1928-10-5,259
1928,10,6,659,595,64,1928-10-6,531
1928,10,7,878,826,52,1928-10-7,774
1928,10,8,933,867,66,1928-10-8,801
1928,10,9,1145,1094,51,1928-10-9,1043
1928,10,10,1525,1494,31,1928-10-10,1463
1928,10,11,1679,1663,16,1928-10-11,1647
1928,10,12,1335,1329,6,1928-10-12,1323
1928,10,13,1303,1243,60,1928-10-13,1183
1928,10,14,1104,1070,34,1928-10-14,1036
1928,10,15,1419,1334,85,1928-10-15,1249
1928,10,16,1014,916,98,1928-10-16,818
1928,10,17,1307,1267,40,1928-10-17,1227
1928,10,18,1256,1245,11,1928-10-18,1234
1928,10,19,1136,1062,74,1928-10-19,988
1928,10,20,965,890,75,1928-10-20,815
1928,10,21,815,760,55,1928-10-21,705
1928,10,22,957,929,28,1928-10-22,901
1928,10,23,1300,893,407,1928-10-23,486
1928,10,24,1181,806,375,1928-10-24,431
1928,10,25,871,538,333,1928-10-25,205
1928,10,26,815,468,347,1928-10-26,121
1928,10,27,765,460,305,1928-10-27,155
1928,10,28,403,94,309,1928-10-28,-215
1928,10,29,286,0,286,1928-10-29,-286
1928,10,30,416,187,229,1928-10-30,-42
1928,10,31,462,231,231,1928-10-31,0
1928,11,1,458,251,207,1928-11-1,44
1928,11,2,429,234,195,1928-11-2,39
1928,11,3,1025,270,755,1928-11-3,-485
1928,11,4,1364,232,1132,1928-11-4,-900
1928,11,5,1489,529,960,1928-11-5,-431
1928,11,6,1634,529,1105,1928-11-6,-576
1928,11,7,1588,505,1083,1928-11-7,-578
1928,11,8,1554,463,1091,1928-11-8,-628
1928,11,9,1275,506,769,1928-11-9,-263
1928,11,10,1405,645,760,1928-11-10,-115
1928,11,11,1729,907,822,1928-11-11,85
1928,11,12,1687,947,740,1928-11-12,207
1928,11,13,1518,797,721,1928-11-13,76
1928,11,14,1155,608,547,1928-11-14,61
1928,11,15,791,379,412,1928-11-15,-33
1928,11,16,530,308,222,1928-11-16,86
1928,11,17,696,442,254,1928-11-17,188
1928,11,18,741,539,202,1928-11-18,337
1928,11,19,570,325,245,1928-11-19,80
1928,11,20,529,324,205,1928-11-20,119
1928,11,21,273,151,122,1928-11-21,29
1928,11,22,127,121,6,1928-11-22,115
1928,11,23,206,191,15,1928-11-23,176
1928,11,24,129,127,2,1928-11-24,125
1928,11,25,4,0,4,1928-11-25,-4
1928,11,26,24,17,7,1928-11-26,10
1928,11,27,128,106,22,1928-11-27,84
1928,11,28,330,297,33,1928-11-28,264
1928,11,29,16,16,0,1928-11-29,16
1928,11,30,428,238,190,1928-11-30,48
1928,12,1,981,783,198,1928-12-1,585
1928,12,2,1136,954,182,1928-12-2,772
1928,12,3,1313,1120,193,1928-12-3,927
1928,12,4,1403,1135,268,1928-12-4,867
1928,12,5,2017,1504,513,1928-12-5,991
1928,12,6,1967,1417,550,1928-12-6,867
1928,12,7,2074,1436,638,1928-12-7,798
1928,12,8,2169,1238,931,1928-12-8,307
1928,12,9,2436,1461,975,1928-12-9,486
1928,12,10,2874,1868,1006,1928-12-10,862
1928,12,11,3186,2275,911,1928-12-11,1364
1928,12,12,1604,549,1055,1928-12-12,-506
1928,12,13,1219,449,770,1928-12-13,-321
1928,12,14,914,594,320,1928-12-14,274
1928,12,15,756,607,149,1928-12-15,458
1928,12,16,881,731,150,1928-12-16,581
1928,12,17,1054,946,108,1928-12-17,838
1928,12,18,440,348,92,1928-12-18,256
1928,12,19,163,156,7,1928-12-19,149
1928,12,20,128,125,3,1928-12-20,122
1928,12,21,203,158,45,1928-12-21,113
1928,12,22,164,146,18,1928-12-22,128
1928,12,23,202,151,51,1928-12-23,100
1928,12,24,40,40,0,1928-12-24,40
1928,12,25,64,64,0,1928-12-25,64
1928,12,26,607,607,0,1928-12-26,607
1928,12,27,897,897,0,1928-12-27,897
1928,12,28,698,698,0,1928-12-28,698
1928,12,29,589,541,48,1928-12-29,493
1928,12,30,644,573,71,1928-12-30,502
1928,12,31,610,541,69,1928-12-31,472
1929,1,1,642,588,54,1929-1-1,534
1929,1,2,1123,973,150,1929-1-2,823
1929,1,3,1044,981,63,1929-1-3,918
1929,1,4,860,831,29,1929-1-4,802
1929,1,5,616,608,8,1929-1-5,600
1929,1,6,507,496,11,1929-1-6,485
1929,1,7,499,384,115,1929-1-7,269
1929,1,8,575,367,208,1929-1-8,159
1929,1,9,787,619,168,1929-1-9,451
1929,1,10,601,476,125,1929-1-10,351
1929,1,11,550,489,61,1929-1-11,428
1929,1,12,923,741,182,1929-1-12,559
1929,1,13,1135,975,160,1929-1-13,815
1929,1,14,976,807,169,1929-1-14,638
1929,1,15,1346,996,350,1929-1-15,646
1929,1,16,2249,1428,821,1929-1-16,607
1929,1,17,1823,1266,557,1929-1-17,709
1929,1,18,1722,1139,583,1929-1-18,556
1929,1,19,1716,990,726,1929-1-19,264
1929,1,20,1611,916,695,1929-1-20,221
1929,1,21,1819,1263,556,1929-1-21,707
1929,1,22,1560,1174,386,1929-1-22,788
1929,1,23,1460,991,469,1929-1-23,522
1929,1,24,1082,718,364,1929-1-24,354
1929,1,25,822,535,287,1929-1-25,248
1929,1,26,614,295,319,1929-1-26,-24
1929,1,27,599,296,303,1929-1-27,-7
1929,1,28,275,250,25,1929-1-28,225
1929,1,29,236,236,0,1929-1-29,236
1929,1,30,184,134,50,1929-1-30,84
1929,1,31,427,192,235,1929-1-31,-43
1929,2,1,407,174,233,1929-2-1,-59
1929,2,2,248,27,221,1929-2-2,-194
1929,2,3,214,57,157,1929-2-3,-100
1929,2,4,278,97,181,1929-2-4,-84
1929,2,5,421,176,245,1929-2-5,-69
1929,2,6,813,256,557,1929-2-6,-301
1929,2,7,1206,205,1001,1929-2-7,-796
1929,2,8,1408,237,1171,1929-2-8,-934
1929,2,9,1496,240,1256,1929-2-9,-1016
1929,2,10,1465,170,1295,1929-2-10,-1125
1929,2,11,1353,92,1261,1929-2-11,-1169
1929,2,12,1277,85,1192,1929-2-12,-1107
1929,2,13,1241,0,1241,1929-2-13,-1241
1929,2,14,1472,0,1472,1929-2-14,-1472
1929,2,15,1358,17,1341,1929-2-15,-1324
1929,2,16,1016,51,965,1929-2-16,-914
1929,2,17,1039,100,939,1929-2-17,-839
1929,2,18,542,164,378,1929-2-18,-214
1929,2,19,198,152,46,1929-2-19,106
1929,2,20,516,425,91,1929-2-20,334
1929,2,21,642,473,169,1929-2-21,304
1929,2,22,626,481,145,1929-2-22,336
1929,2,23,857,476,381,1929-2-23,95
1929,2,24,734,374,360,1929-2-24,14
1929,2,25,727,341,386,1929-2-25,-45
1929,2,26,559,231,328,1929-2-26,-97
1929,2,27,563,157,406,1929-2-27,-249
1929,2,28,328,66,262,1929-2-28,-196
1929,3,1,542,64,478,1929-3-1,-414
1929,3,2,1036,111,925,1929-3-2,-814
1929,3,3,1104,220,884,1929-3-3,-664
1929,3,4,1446,150,1296,1929-3-4,-1146
1929,3,5,2118,277,1841,1929-3-5,-1564
1929,3,6,2100,219,1881,1929-3-6,-1662
1929,3,7,1935,102,1833,1929-3-7,-1731
1929,3,8,1788,132,1656,1929-3-8,-1524
1929,3,9,1884,119,1765,1929-3-9,-1646
1929,3,10,1821,133,1688,1929-3-10,-1555
1929,3,11,1900,88,1812,1929-3-11,-1724
1929,3,12,1784,66,1718,1929-3-12,-1652
1929,3,13,1703,32,1671,1929-3-13,-1639
1929,3,14,1530,13,1517,1929-3-14,-1504
1929,3,15,1363,133,1230,1929-3-15,-1097
1929,3,16,1509,442,1067,1929-3-16,-625
1929,3,17,729,627,102,1929-3-17,525
1929,3,18,473,429,44,1929-3-18,385
1929,3,19,427,427,0,1929-3-19,427
1929,3,20,401,401,0,1929-3-20,401
1929,3,21,383,383,0,1929-3-21,383
1929,3,22,356,356,0,1929-3-22,356
1929,3,23,542,328,214,1929-3-23,114
1929,3,24,496,307,189,1929-3-24,118
1929,3,25,495,312,183,1929-3-25,129
1929,3,26,525,276,249,1929-3-26,27
1929,3,27,523,264,259,1929-3-27,5
1929,3,28,232,6,226,1929-3-28,-220
1929,3,29,241,0,241,1929-3-29,-241
1929,3,30,323,108,215,1929-3-30,-107
1929,3,31,1090,257,833,1929-3-31,-576
1929,4,1,1037,238,799,1929-4-1,-561
1929,4,2,878,203,675,1929-4-2,-472
1929,4,3,786,251,535,1929-4-3,-284
1929,4,4,536,163,373,1929-4-4,-210
1929,4,5,611,106,505,1929-4-5,-399
1929,4,6,741,0,741,1929-4-6,-741
1929,4,7,1012,0,1012,1929-4-7,-1012
1929,4,8,959,0,959,1929-4-8,-959
1929,4,9,1166,324,842,1929-4-9,-518
1929,4,10,1397,525,872,1929-4-10,-347
1929,4,11,1929,754,1175,1929-4-11,-421
1929,4,12,1803,628,1175,1929-4-12,-547
1929,4,13,1864,654,1210,1929-4-13,-556
1929,4,14,1313,592,721,1929-4-14,-129
1929,4,15,1097,550,547,1929-4-15,3
1929,4,16,855,571,284,1929-4-16,287
1929,4,17,690,575,115,1929-4-17,460
1929,4,18,771,634,137,1929-4-18,497
1929,4,19,885,759,126,1929-4-19,633
1929,4,20,1464,1323,141,1929-4-20,1182
1929,4,21,1565,1459,106,1929-4-21,1353
1929,4,22,1052,1019,33,1929-4-22,986
1929,4,23,1048,1023,25,1929-4-23,998
1929,4,24,544,524,20,1929-4-24,504
1929,4,25,829,795,34,1929-4-25,761
1929,4,26,734,718,16,1929-4-26,702
1929,4,27,914,689,225,1929-4-27,464
1929,4,28,962,490,472,1929-4-28,18
1929,4,29,731,200,531,1929-4-29,-331
1929,4,30,936,153,783,1929-4-30,-630
1929,5,1,1061,115,946,1929-5-1,-831
1929,5,2,1180,190,990,1929-5-2,-800
1929,5,3,1036,125,911,1929-5-3,-786
1929,5,4,898,150,748,1929-5-4,-598
1929,5,5,1036,376,660,1929-5-5,-284
1929,5,6,1230,606,624,1929-5-6,-18
1929,5,7,1154,551,603,1929-5-7,-52
1929,5,8,1362,779,583,1929-5-8,196
1929,5,9,1219,738,481,1929-5-9,257
1929,5,10,742,557,185,1929-5-10,372
1929,5,11,678,498,180,1929-5-11,318
1929,5,12,838,540,298,1929-5-12,242
1929,5,13,1282,511,771,1929-5-13,-260
1929,5,14,1337,519,818,1929-5-14,-299
1929,5,15,1271,475,796,1929-5-15,-321
1929,5,16,502,436,66,1929-5-16,370
1929,5,17,348,330,18,1929-5-17,312
1929,5,18,358,328,30,1929-5-18,298
1929,5,19,316,302,14,1929-5-19,288
1929,5,20,265,247,18,1929-5-20,229
1929,5,21,117,113,4,1929-5-21,109
1929,5,22,451,448,3,1929-5-22,445
1929,5,23,742,722,20,1929-5-23,702
1929,5,24,913,894,19,1929-5-24,875
1929,5,25,1140,1058,82,1929-5-25,976
1929,5,26,1000,1000,0,1929-5-26,1000
1929,5,27,1034,1034,0,1929-5-27,1034
1929,5,28,809,800,9,1929-5-28,791
1929,5,29,715,715,0,1929-5-29,715
1929,5,30,571,571,0,1929-5-30,571
1929,5,31,726,713,13,1929-5-31,700
1929,6,1,618,606,12,1929-6-1,594
1929,6,2,693,640,53,1929-6-2,587
1929,6,3,758,623,135,1929-6-3,488
1929,6,4,487,285,202,1929-6-4,83
1929,6,5,616,315,301,1929-6-5,14
1929,6,6,993,242,751,1929-6-6,-509
1929,6,7,1052,219,833,1929-6-7,-614
1929,6,8,876,210,666,1929-6-8,-456
1929,6,9,803,169,634,1929-6-9,-465
1929,6,10,782,161,621,1929-6-10,-460
1929,6,11,880,235,645,1929-6-11,-410
1929,6,12,920,283,637,1929-6-12,-354
1929,6,13,875,228,647,1929-6-13,-419
1929,6,14,996,233,763,1929-6-14,-530
1929,6,15,679,219,460,1929-6-15,-241
1929,6,16,485,238,247,1929-6-16,-9
1929,6,17,376,179,197,1929-6-17,-18
1929,6,18,1863,853,1010,1929-6-18,-157
1929,6,19,1825,938,887,1929-6-19,51
1929,6,20,1904,915,989,1929-6-20,-74
1929,6,21,1732,701,1031,1929-6-21,-330
1929,6,22,1973,628,1345,1929-6-22,-717
1929,6,23,2081,547,1534,1929-6-23,-987
1929,6,24,1977,509,1468,1929-6-24,-959
1929,6,25,1921,518,1403,1929-6-25,-885
1929,6,26,1878,481,1397,1929-6-26,-916
1929,6,27,1590,473,1117,1929-6-27,-644
1929,6,28,1420,476,944,1929-6-28,-468
1929,6,29,1541,764,777,1929-6-29,-13
1929,6,30,1375,574,801,1929-6-30,-227
1929,7,1,1478,266,1212,1929-7-1,-946
1929,7,2,1500,260,1240,1929-7-2,-980
1929,7,3,1261,234,1027,1929-7-3,-793
1929,7,4,1246,433,813,1929-7-4,-380
1929,7,5,743,286,457,1929-7-5,-171
1929,7,6,1159,405,754,1929-7-6,-349
1929,7,7,963,296,667,1929-7-7,-371
1929,7,8,711,249,462,1929-7-8,-213
1929,7,9,467,200,267,1929-7-9,-67
1929,7,10,743,168,575,1929-7-10,-407
1929,7,11,1661,26,1635,1929-7-11,-1609
1929,7,12,1869,24,1845,1929-7-12,-1821
1929,7,13,1772,20,1752,1929-7-13,-1732
1929,7,14,1757,49,1708,1929-7-14,-1659
1929,7,15,2077,288,1789,1929-7-15,-1501
1929,7,16,2057,366,1691,1929-7-16,-1325
1929,7,17,1128,300,828,1929-7-17,-528
1929,7,18,1035,252,783,1929-7-18,-531
1929,7,19,933,201,732,1929-7-19,-531
1929,7,20,1030,212,818,1929-7-20,-606
1929,7,21,1016,260,756,1929-7-21,-496
1929,7,22,911,231,680,1929-7-22,-449
1929,7,23,473,116,357,1929-7-23,-241
1929,7,24,251,90,161,1929-7-24,-71
1929,7,25,403,81,322,1929-7-25,-241
1929,7,26,394,80,314,1929-7-26,-234
1929,7,27,527,76,451,1929-7-27,-375
1929,7,28,549,78,471,1929-7-28,-393
1929,7,29,467,108,359,1929-7-29,-251
1929,7,30,461,69,392,1929-7-30,-323
1929,7,31,793,103,690,1929-7-31,-587
1929,8,1,718,133,585,1929-8-1,-452
1929,8,2,539,40,499,1929-8-2,-459
1929,8,3,371,43,328,1929-8-3,-285
1929,8,4,321,10,311,1929-8-4,-301
1929,8,5,486,7,479,1929-8-5,-472
1929,8,6,594,4,590,1929-8-6,-586
1929,8,7,719,12,707,1929-8-7,-695
1929,8,8,696,15,681,1929-8-8,-666
1929,8,9,784,149,635,1929-8-9,-486
1929,8,10,871,262,609,1929-8-10,-347
1929,8,11,753,161,592,1929-8-11,-431
1929,8,12,596,179,417,1929-8-12,-238
1929,8,13,664,135,529,1929-8-13,-394
1929,8,14,1064,259,805,1929-8-14,-546
1929,8,15,1518,356,1162,1929-8-15,-806
1929,8,16,1733,514,1219,1929-8-16,-705
1929,8,17,1654,419,1235,1929-8-17,-816
1929,8,18,1443,431,1012,1929-8-18,-581
1929,8,19,1552,442,1110,1929-8-19,-668
1929,8,20,1205,283,922,1929-8-20,-639
1929,8,21,862,177,685,1929-8-21,-508
1929,8,22,614,158,456,1929-8-22,-298
1929,8,23,604,180,424,1929-8-23,-244
1929,8,24,571,125,446,1929-8-24,-321
1929,8,25,557,94,463,1929-8-25,-369
1929,8,26,660,90,570,1929-8-26,-480
1929,8,27,410,23,387,1929-8-27,-364
1929,8,28,278,13,265,1929-8-28,-252
1929,8,29,106,7,99,1929-8-29,-92
1929,8,30,94,14,80,1929-8-30,-66
1929,8,31,28,0,28,1929-8-31,-28
1929,9,1,21,0,21,1929-9-1,-21
1929,9,2,31,21,10,1929-9-2,11
1929,9,3,205,177,28,1929-9-3,149
1929,9,4,131,126,5,1929-9-4,121
1929,9,5,275,98,177,1929-9-5,-79
1929,9,6,575,94,481,1929-9-6,-387
1929,9,7,547,163,384,1929-9-7,-221
1929,9,8,465,144,321,1929-9-8,-177
1929,9,9,545,158,387,1929-9-9,-229
1929,9,10,387,105,282,1929-9-10,-177
1929,9,11,99,75,24,1929-9-11,51
1929,9,12,72,56,16,1929-9-12,40
1929,9,13,126,115,11,1929-9-13,104
1929,9,14,141,58,83,1929-9-14,-25
1929,9,15,193,93,100,1929-9-15,-7
1929,9,16,467,146,321,1929-9-16,-175
1929,9,17,376,25,351,1929-9-17,-326
1929,9,18,283,5,278,1929-9-18,-273
1929,9,19,294,5,289,1929-9-19,-284
1929,9,20,493,79,414,1929-9-20,-335
1929,9,21,514,84,430,1929-9-21,-346
1929,9,22,448,15,433,1929-9-22,-418
1929,9,23,259,18,241,1929-9-23,-223
1929,9,24,179,0,179,1929-9-24,-179
1929,9,25,98,0,98,1929-9-25,-98
1929,9,26,76,49,27,1929-9-26,22
1929,9,27,73,68,5,1929-9-27,63
1929,9,28,102,102,0,1929-9-28,102
1929,9,29,367,363,4,1929-9-29,359
1929,9,30,499,495,4,1929-9-30,491
1929,10,1,688,688,0,1929-10-1,688
1929,10,2,875,875,0,1929-10-2,875
1929,10,3,1034,1034,0,1929-10-3,1034
1929,10,4,937,937,0,1929-10-4,937
1929,10,5,897,897,0,1929-10-5,897
1929,10,6,961,918,43,1929-10-6,875
1929,10,7,1362,773,589,1929-10-7,184
1929,10,8,1694,892,802,1929-10-8,90
1929,10,9,2017,910,1107,1929-10-9,-197
1929,10,10,2388,961,1427,1929-10-10,-466
1929,10,11,2386,529,1857,1929-10-11,-1328
1929,10,12,2491,679,1812,1929-10-12,-1133
1929,10,13,2451,571,1880,1929-10-13,-1309
1929,10,14,2384,520,1864,1929-10-14,-1344
1929,10,15,2256,449,1807,1929-10-15,-1358
1929,10,16,1948,386,1562,1929-10-16,-1176
1929,10,17,1268,275,993,1929-10-17,-718
1929,10,18,1213,309,904,1929-10-18,-595
1929,10,19,939,5,934,1929-10-19,-929
1929,10,20,78,0,78,1929-10-20,-78
1929,10,21,173,73,100,1929-10-21,-27
1929,10,22,162,101,61,1929-10-22,40
1929,10,23,162,93,69,1929-10-23,24
1929,10,24,74,74,0,1929-10-24,74
1929,10,25,862,862,0,1929-10-25,862
1929,10,26,924,924,0,1929-10-26,924
1929,10,27,1256,1256,0,1929-10-27,1256
1929,10,28,1506,1479,27,1929-10-28,1452
1929,10,29,1773,1753,20,1929-10-29,1733
1929,10,30,1739,1731,8,1929-10-30,1723
1929,10,31,1710,1710,0,1929-10-31,1710
1929,11,1,1638,1638,0,1929-11-1,1638
1929,11,2,2131,2116,15,1929-11-2,2101
1929,11,3,2892,2109,783,1929-11-3,1326
1929,11,4,2692,1962,730,1929-11-4,1232
1929,11,5,3021,2203,818,1929-11-5,1385
1929,11,6,2348,1448,900,1929-11-6,548
1929,11,7,2883,1640,1243,1929-11-7,397
1929,11,8,3411,2071,1340,1929-11-8,731
1929,11,9,3522,2288,1234,1929-11-9,1054
1929,11,10,2167,940,1227,1929-11-10,-287
1929,11,11,1876,627,1249,1929-11-11,-622
1929,11,12,1806,650,1156,1929-11-12,-506
1929,11,13,1809,495,1314,1929-11-13,-819
1929,11,14,2215,544,1671,1929-11-14,-1127
1929,11,15,2322,521,1801,1929-11-15,-1280
1929,11,16,1990,756,1234,1929-11-16,-478
1929,11,17,1565,691,874,1929-11-17,-183
1929,11,18,1466,692,774,1929-11-18,-82
1929,11,19,1005,599,406,1929-11-19,193
1929,11,20,1042,708,334,1929-11-20,374
1929,11,21,1932,1624,308,1929-11-21,1316
1929,11,22,1848,1458,390,1929-11-22,1068
1929,11,23,1538,1216,322,1929-11-23,894
1929,11,24,3123,2820,303,1929-11-24,2517
1929,11,25,3395,3056,339,1929-11-25,2717
1929,11,26,3314,3033,281,1929-11-26,2752
1929,11,27,3751,3469,282,1929-11-27,3187
1929,11,28,3379,3101,278,1929-11-28,2823
1929,11,29,4021,3681,340,1929-11-29,3341
1929,11,30,4261,3958,303,1929-11-30,3655
1929,12,1,4632,4095,537,1929-12-1,3558
1929,12,2,4446,3977,469,1929-12-2,3508
1929,12,3,3995,3598,397,1929-12-3,3201
1929,12,4,3731,3340,391,1929-12-4,2949
1929,12,5,3193,2884,309,1929-12-5,2575
1929,12,6,3015,2537,478,1929-12-6,2059
1929,12,7,3320,1930,1390,1929-12-7,540
1929,12,8,1458,333,1125,1929-12-8,-792
1929,12,9,1753,372,1381,1929-12-9,-1009
1929,12,10,3139,1648,1491,1929-12-10,157
1929,12,11,3487,1954,1533,1929-12-11,421
1929,12,12,4095,2224,1871,1929-12-12,353
1929,12,13,4269,2098,2171,1929-12-13,-73
1929,12,14,3916,2146,1770,1929-12-14,376
1929,12,15,3770,2019,1751,1929-12-15,268
1929,12,16,3828,1997,1831,1929-12-16,166
1929,12,17,3554,1956,1598,1929-12-17,358
1929,12,18,3094,1932,1162,1929-12-18,770
1929,12,19,3339,2343,996,1929-12-19,1347
1929,12,20,3251,2423,828,1929-12-20,1595
1929,12,21,3224,2486,738,1929-12-21,1748
1929,12,22,4537,3903,634,1929-12-22,3269
1929,12,23,3066,2958,108,1929-12-23,2850
1929,12,24,2680,2579,101,1929-12-24,2478
1929,12,25,3066,2954,112,1929-12-25,2842
1929,12,26,2664,2557,107,1929-12-26,2450
1929,12,27,2320,2320,0,1929-12-27,2320
1929,12,28,1802,1782,20,1929-12-28,1762
1929,12,29,1277,1262,15,1929-12-29,1247
1929,12,30,1045,1038,7,1929-12-30,1031
1929,12,31,647,647,0,1929-12-31,647
1930,1,1,720,720,0,1930-1-1,720
1930,1,2,1203,807,396,1930-1-2,411
1930,1,3,848,514,334,1930-1-3,180
1930,1,4,536,179,357,1930-1-4,-178
1930,1,5,645,187,458,1930-1-5,-271
1930,1,6,1421,871,550,1930-1-6,321
1930,1,7,1285,829,456,1930-1-7,373
1930,1,8,1399,827,572,1930-1-8,255
1930,1,9,1361,797,564,1930-1-9,233
1930,1,10,1349,736,613,1930-1-10,123
1930,1,11,1363,766,597,1930-1-11,169
1930,1,12,1580,974,606,1930-1-12,368
1930,1,13,1769,1091,678,1930-1-13,413
1930,1,14,1905,1252,653,1930-1-14,599
1930,1,15,1910,1231,679,1930-1-15,552
1930,1,16,2009,1254,755,1930-1-16,499
1930,1,17,2141,1518,623,1930-1-17,895
1930,1,18,2001,1467,534,1930-1-18,933
1930,1,19,1114,984,130,1930-1-19,854
1930,1,20,895,860,35,1930-1-20,825
1930,1,21,941,936,5,1930-1-21,931
1930,1,22,1224,1224,0,1930-1-22,1224
1930,1,23,877,877,0,1930-1-23,877
1930,1,24,892,892,0,1930-1-24,892
1930,1,25,463,463,0,1930-1-25,463
1930,1,26,299,299,0,1930-1-26,299
1930,1,27,333,328,5,1930-1-27,323
1930,1,28,444,444,0,1930-1-28,444
1930,1,29,507,507,0,1930-1-29,507
1930,1,30,991,991,0,1930-1-30,991
1930,1,31,955,955,0,1930-1-31,955
1930,2,1,1308,734,574,1930-2-1,160
1930,2,2,1386,896,490,1930-2-2,406
1930,2,3,1412,940,472,1930-2-3,468
1930,2,4,1344,813,531,1930-2-4,282
1930,2,5,1322,508,814,1930-2-5,-306
1930,2,6,1129,406,723,1930-2-6,-317
1930,2,7,1257,410,847,1930-2-7,-437
1930,2,8,1171,306,865,1930-2-8,-559
1930,2,9,1038,345,693,1930-2-9,-348
1930,2,10,576,244,332,1930-2-10,-88
1930,2,11,974,342,632,1930-2-11,-290
1930,2,12,926,217,709,1930-2-12,-492
1930,2,13,707,212,495,1930-2-13,-283
1930,2,14,536,310,226,1930-2-14,84
1930,2,15,286,201,85,1930-2-15,116
1930,2,16,104,94,10,1930-2-16,84
1930,2,17,165,159,6,1930-2-17,153
1930,2,18,296,290,6,1930-2-18,284
1930,2,19,150,150,0,1930-2-19,150
1930,2,20,116,116,0,1930-2-20,116
1930,2,21,133,133,0,1930-2-21,133
1930,2,22,152,152,0,1930-2-22,152
1930,2,23,365,103,262,1930-2-23,-159
1930,2,24,411,102,309,1930-2-24,-207
1930,2,25,386,0,386,1930-2-25,-386
1930,2,26,392,0,392,1930-2-26,-392
1930,2,27,303,0,303,1930-2-27,-303
1930,2,28,799,0,799,1930-2-28,-799
1930,3,1,848,0,848,1930-3-1,-848
1930,3,2,1118,0,1118,1930-3-2,-1118
1930,3,3,1317,6,1311,1930-3-3,-1305
1930,3,4,1398,0,1398,1930-3-4,-1398
1930,3,5,1203,0,1203,1930-3-5,-1203
1930,3,6,1094,0,1094,1930-3-6,-1094
1930,3,7,1039,53,986,1930-3-7,-933
1930,3,8,874,23,851,1930-3-8,-828
1930,3,9,929,19,910,1930-3-9,-891
1930,3,10,700,0,700,1930-3-10,-700
1930,3,11,617,36,581,1930-3-11,-545
1930,3,12,609,65,544,1930-3-12,-479
1930,3,13,770,122,648,1930-3-13,-526
1930,3,14,121,121,0,1930-3-14,121
1930,3,15,122,122,0,1930-3-15,122
1930,3,16,404,378,26,1930-3-16,352
1930,3,17,598,561,37,1930-3-17,524
1930,3,18,801,654,147,1930-3-18,507
1930,3,19,527,444,83,1930-3-19,361
1930,3,20,319,268,51,1930-3-20,217
1930,3,21,313,291,22,1930-3-21,269
1930,3,22,492,455,37,1930-3-22,418
1930,3,23,163,152,11,1930-3-23,141
1930,3,24,227,227,0,1930-3-24,227
1930,3,25,195,195,0,1930-3-25,195
1930,3,26,560,204,356,1930-3-26,-152
1930,3,27,612,173,439,1930-3-27,-266
1930,3,28,594,119,475,1930-3-28,-356
1930,3,29,545,81,464,1930-3-29,-383
1930,3,30,587,89,498,1930-3-30,-409
1930,3,31,662,92,570,1930-3-31,-478
1930,4,1,695,71,624,1930-4-1,-553
1930,4,2,1360,836,524,1930-4-2,312
1930,4,3,1370,856,514,1930-4-3,342
1930,4,4,1113,670,443,1930-4-4,227
1930,4,5,1093,690,403,1930-4-5,287
1930,4,6,1109,683,426,1930-4-6,257
1930,4,7,1105,732,373,1930-4-7,359
1930,4,8,708,697,11,1930-4-8,686
1930,4,9,671,637,34,1930-4-9,603
1930,4,10,771,722,49,1930-4-10,673
1930,4,11,773,700,73,1930-4-11,627
1930,4,12,773,710,63,1930-4-12,647
1930,4,13,756,666,90,1930-4-13,576
1930,4,14,283,160,123,1930-4-14,37
1930,4,15,104,68,36,1930-4-15,32
1930,4,16,100,40,60,1930-4-16,-20
1930,4,17,124,24,100,1930-4-17,-76
1930,4,18,80,33,47,1930-4-18,-14
1930,4,19,59,11,48,1930-4-19,-37
1930,4,20,110,69,41,1930-4-20,28
1930,4,21,105,68,37,1930-4-21,31
1930,4,22,372,37,335,1930-4-22,-298
1930,4,23,355,13,342,1930-4-23,-329
1930,4,24,330,23,307,1930-4-24,-284
1930,4,25,381,13,368,1930-4-25,-355
1930,4,26,317,32,285,1930-4-26,-253
1930,4,27,330,54,276,1930-4-27,-222
1930,4,28,404,74,330,1930-4-28,-256
1930,4,29,465,194,271,1930-4-29,-77
1930,4,30,630,362,268,1930-4-30,94
1930,5,1,691,402,289,1930-5-1,113
1930,5,2,557,279,278,1930-5-2,1
1930,5,3,475,195,280,1930-5-3,-85
1930,5,4,552,265,287,1930-5-4,-22
1930,5,5,470,426,44,1930-5-5,382
1930,5,6,632,632,0,1930-5-6,632
1930,5,7,640,640,0,1930-5-7,640
1930,5,8,756,756,0,1930-5-8,756
1930,5,9,660,660,0,1930-5-9,660
1930,5,10,668,668,0,1930-5-10,668
1930,5,11,634,634,0,1930-5-11,634
1930,5,12,688,688,0,1930-5-12,688
1930,5,13,540,540,0,1930-5-13,540
1930,5,14,233,224,9,1930-5-14,215
1930,5,15,193,117,76,1930-5-15,41
1930,5,16,253,118,135,1930-5-16,-17
1930,5,17,256,16,240,1930-5-17,-224
1930,5,18,281,0,281,1930-5-18,-281
1930,5,19,446,0,446,1930-5-19,-446
1930,5,20,453,0,453,1930-5-20,-453
1930,5,21,445,0,445,1930-5-21,-445
1930,5,22,541,0,541,1930-5-22,-541
1930,5,23,570,218,352,1930-5-23,-134
1930,5,24,434,173,261,1930-5-24,-88
1930,5,25,340,149,191,1930-5-25,-42
1930,5,26,308,166,142,1930-5-26,24
1930,5,27,340,169,171,1930-5-27,-2
1930,5,28,473,458,15,1930-5-28,443
1930,5,29,612,576,36,1930-5-29,540
1930,5,30,581,537,44,1930-5-30,493
1930,5,31,478,466,12,1930-5-31,454
1930,6,1,335,335,0,1930-6-1,335
1930,6,2,279,279,0,1930-6-2,279
1930,6,3,273,273,0,1930-6-3,273
1930,6,4,270,263,7,1930-6-4,256
1930,6,5,239,230,9,1930-6-5,221
1930,6,6,333,205,128,1930-6-6,77
1930,6,7,728,217,511,1930-6-7,-294
1930,6,8,806,242,564,1930-6-8,-322
1930,6,9,758,244,514,1930-6-9,-270
1930,6,10,465,76,389,1930-6-10,-313
1930,6,11,567,361,206,1930-6-11,155
1930,6,12,592,396,196,1930-6-12,200
1930,6,13,578,361,217,1930-6-13,144
1930,6,14,333,290,43,1930-6-14,247
1930,6,15,244,244,0,1930-6-15,244
1930,6,16,192,192,0,1930-6-16,192
1930,6,17,143,140,3,1930-6-17,137
1930,6,18,90,90,0,1930-6-18,90
1930,6,19,91,91,0,1930-6-19,91
1930,6,20,13,13,0,1930-6-20,13
1930,6,21,35,35,0,1930-6-21,35
1930,6,22,17,6,11,1930-6-22,-5
1930,6,23,22,22,0,1930-6-23,22
1930,6,24,18,18,0,1930-6-24,18
1930,6,25,46,46,0,1930-6-25,46
1930,6,26,19,19,0,1930-6-26,19
1930,6,27,169,169,0,1930-6-27,169
1930,6,28,253,253,0,1930-6-28,253
1930,6,29,263,263,0,1930-6-29,263
1930,6,30,190,190,0,1930-6-30,190
1930,7,1,72,72,0,1930-7-1,72
1930,7,2,113,76,37,1930-7-2,39
1930,7,3,117,85,32,1930-7-3,53
1930,7,4,83,74,9,1930-7-4,65
1930,7,5,60,30,30,1930-7-5,0
1930,7,6,58,28,30,1930-7-6,-2
1930,7,7,45,26,19,1930-7-7,7
1930,7,8,34,4,30,1930-7-8,-26
1930,7,9,223,183,40,1930-7-9,143
1930,7,10,394,386,8,1930-7-10,378
1930,7,11,305,298,7,1930-7-11,291
1930,7,12,139,93,46,1930-7-12,47
1930,7,13,100,0,100,1930-7-13,-100
1930,7,14,270,0,270,1930-7-14,-270
1930,7,15,222,17,205,1930-7-15,-188
1930,7,16,252,20,232,1930-7-16,-212
1930,7,17,204,11,193,1930-7-17,-182
1930,7,18,179,0,179,1930-7-18,-179
1930,7,19,182,0,182,1930-7-19,-182
1930,7,20,153,0,153,1930-7-20,-153
1930,7,21,327,101,226,1930-7-21,-125
1930,7,22,89,76,13,1930-7-22,63
1930,7,23,108,83,25,1930-7-23,58
1930,7,24,195,189,6,1930-7-24,183
1930,7,25,130,127,3,1930-7-25,124
1930,7,26,146,146,0,1930-7-26,146
1930,7,27,129,129,0,1930-7-27,129
1930,7,28,150,127,23,1930-7-28,104
1930,7,29,123,114,9,1930-7-29,105
1930,7,30,62,62,0,1930-7-30,62
1930,7,31,77,62,15,1930-7-31,47
1930,8,1,40,31,9,1930-8-1,22
1930,8,2,39,29,10,1930-8-2,19
1930,8,3,9,4,5,1930-8-3,-1
1930,8,4,5,0,5,1930-8-4,-5
1930,8,5,0,0,0,1930-8-5,0
1930,8,6,333,43,290,1930-8-6,-247
1930,8,7,380,31,349,1930-8-7,-318
1930,8,8,357,8,349,1930-8-8,-341
1930,8,9,337,0,337,1930-8-9,-337
1930,8,10,411,58,353,1930-8-10,-295
1930,8,11,361,24,337,1930-8-11,-313
1930,8,12,340,17,323,1930-8-12,-306
1930,8,13,387,0,387,1930-8-13,-387
1930,8,14,382,0,382,1930-8-14,-382
1930,8,15,381,0,381,1930-8-15,-381
1930,8,16,349,0,349,1930-8-16,-349
1930,8,17,361,0,361,1930-8-17,-361
1930,8,18,539,73,466,1930-8-18,-393
1930,8,19,240,150,90,1930-8-19,60
1930,8,20,314,222,92,1930-8-20,130
1930,8,21,281,197,84,1930-8-21,113
1930,8,22,265,169,96,1930-8-22,73
1930,8,23,277,165,112,1930-8-23,53
1930,8,24,191,97,94,1930-8-24,3
1930,8,25,257,124,133,1930-8-25,-9
1930,8,26,168,111,57,1930-8-26,54
1930,8,27,270,241,29,1930-8-27,212
1930,8,28,400,377,23,1930-8-28,354
1930,8,29,424,366,58,1930-8-29,308
1930,8,30,402,307,95,1930-8-30,212
1930,8,31,275,160,115,1930-8-31,45
1930,9,1,354,236,118,1930-9-1,118
1930,9,2,369,194,175,1930-9-2,19
1930,9,3,340,158,182,1930-9-3,-24
1930,9,4,694,532,162,1930-9-4,370
1930,9,5,889,708,181,1930-9-5,527
1930,9,6,957,811,146,1930-9-6,665
1930,9,7,913,776,137,1930-9-7,639
1930,9,8,751,650,101,1930-9-8,549
1930,9,9,762,655,107,1930-9-9,548
1930,9,10,651,579,72,1930-9-10,507
1930,9,11,387,273,114,1930-9-11,159
1930,9,12,332,275,57,1930-9-12,218
1930,9,13,503,309,194,1930-9-13,115
1930,9,14,306,229,77,1930-9-14,152
1930,9,15,221,164,57,1930-9-15,107
1930,9,16,54,22,32,1930-9-16,-10
1930,9,17,23,0,23,1930-9-17,-23
1930,9,18,5,0,5,1930-9-18,-5
1930,9,19,10,0,10,1930-9-19,-10
1930,9,20,12,12,0,1930-9-20,12
1930,9,21,8,8,0,1930-9-21,8
1930,9,22,25,25,0,1930-9-22,25
1930,9,23,29,29,0,1930-9-23,29
1930,9,24,27,27,0,1930-9-24,27
1930,9,25,282,263,19,1930-9-25,244
1930,9,26,403,342,61,1930-9-26,281
1930,9,27,519,365,154,1930-9-27,211
1930,9,28,473,279,194,1930-9-28,85
1930,9,29,390,216,174,1930-9-29,42
1930,9,30,356,190,166,1930-9-30,24
1930,10,1,339,171,168,1930-10-1,3
1930,10,2,426,171,255,1930-10-2,-84
1930,10,3,366,140,226,1930-10-3,-86
1930,10,4,694,556,138,1930-10-4,418
1930,10,5,1366,1244,122,1930-10-5,1122
1930,10,6,1759,1617,142,1930-10-6,1475
1930,10,7,1545,1454,91,1930-10-7,1363
1930,10,8,1234,1213,21,1930-10-8,1192
1930,10,9,1283,1283,0,1930-10-9,1283
1930,10,10,1317,1317,0,1930-10-10,1317
1930,10,11,1068,1068,0,1930-10-11,1068
1930,10,12,773,773,0,1930-10-12,773
1930,10,13,741,741,0,1930-10-13,741
1930,10,14,516,516,0,1930-10-14,516
1930,10,15,436,436,0,1930-10-15,436
1930,10,16,219,219,0,1930-10-16,219
1930,10,17,38,38,0,1930-10-17,38
1930,10,18,70,70,0,1930-10-18,70
1930,10,19,178,178,0,1930-10-19,178
1930,10,20,147,147,0,1930-10-20,147
1930,10,21,25,25,0,1930-10-21,25
1930,10,22,279,0,279,1930-10-22,-279
1930,10,23,436,0,436,1930-10-23,-436
1930,10,24,509,0,509,1930-10-24,-509
1930,10,25,594,52,542,1930-10-25,-490
1930,10,26,669,196,473,1930-10-26,-277
1930,10,27,823,218,605,1930-10-27,-387
1930,10,28,971,384,587,1930-10-28,-203
1930,10,29,720,95,625,1930-10-29,-530
1930,10,30,698,0,698,1930-10-30,-698
1930,10,31,911,0,911,1930-10-31,-911
1930,11,1,966,0,966,1930-11-1,-966
1930,11,2,940,0,940,1930-11-2,-940
1930,11,3,854,73,781,1930-11-3,-708
1930,11,4,515,138,377,1930-11-4,-239
1930,11,5,107,107,0,1930-11-5,107
1930,11,6,80,80,0,1930-11-6,80
1930,11,7,103,103,0,1930-11-7,103
1930,11,8,81,81,0,1930-11-8,81
1930,11,9,80,80,0,1930-11-9,80
1930,11,10,27,27,0,1930-11-10,27
1930,11,11,23,23,0,1930-11-11,23
1930,11,12,25,25,0,1930-11-12,25
1930,11,13,0,0,0,1930-11-13,0
1930,11,14,213,213,0,1930-11-14,213
1930,11,15,395,395,0,1930-11-15,395
1930,11,16,310,310,0,1930-11-16,310
1930,11,17,291,291,0,1930-11-17,291
1930,11,18,316,251,65,1930-11-18,186
1930,11,19,909,431,478,1930-11-19,-47
1930,11,20,984,430,554,1930-11-20,-124
1930,11,21,1796,846,950,1930-11-21,-104
1930,11,22,1806,722,1084,1930-11-22,-362
1930,11,23,1844,713,1131,1930-11-23,-418
1930,11,24,1644,555,1089,1930-11-24,-534
1930,11,25,1440,437,1003,1930-11-25,-566
1930,11,26,1116,158,958,1930-11-26,-800
1930,11,27,797,172,625,1930-11-27,-453
1930,11,28,763,206,557,1930-11-28,-351
1930,11,29,660,141,519,1930-11-29,-378
1930,11,30,755,286,469,1930-11-30,-183
1930,12,1,750,281,469,1930-12-1,-188
1930,12,2,668,200,468,1930-12-2,-268
1930,12,3,289,198,91,1930-12-3,107
1930,12,4,197,197,0,1930-12-4,197
1930,12,5,53,53,0,1930-12-5,53
1930,12,6,18,18,0,1930-12-6,18
1930,12,7,0,0,0,1930-12-7,0
1930,12,8,0,0,0,1930-12-8,0
1930,12,9,199,199,0,1930-12-9,199
1930,12,10,189,189,0,1930-12-10,189
1930,12,11,135,135,0,1930-12-11,135
1930,12,12,108,108,0,1930-12-12,108
1930,12,13,150,150,0,1930-12-13,150
1930,12,14,150,105,45,1930-12-14,60
1930,12,15,112,69,43,1930-12-15,26
1930,12,16,53,12,41,1930-12-16,-29
1930,12,17,64,15,49,1930-12-17,-34
1930,12,18,530,98,432,1930-12-18,-334
1930,12,19,664,211,453,1930-12-19,-242
1930,12,20,642,427,215,1930-12-20,212
1930,12,21,423,227,196,1930-12-21,31
1930,12,22,219,53,166,1930-12-22,-113
1930,12,23,293,113,180,1930-12-23,-67
1930,12,24,235,103,132,1930-12-24,-29
1930,12,25,313,228,85,1930-12-25,143
1930,12,26,292,277,15,1930-12-26,262
1930,12,27,181,181,0,1930-12-27,181
1930,12,28,205,205,0,1930-12-28,205
1930,12,29,108,108,0,1930-12-29,108
1930,12,30,110,110,0,1930-12-30,110
1930,12,31,69,69,0,1930-12-31,69
1931,1,1,0,0,0,1931-1-1,0
1931,1,2,27,27,0,1931-1-2,27
1931,1,3,10,10,0,1931-1-3,10
1931,1,4,104,0,104,1931-1-4,-104
1931,1,5,125,0,125,1931-1-5,-125
1931,1,6,167,0,167,1931-1-6,-167
1931,1,7,106,0,106,1931-1-7,-106
1931,1,8,57,0,57,1931-1-8,-57
1931,1,9,101,0,101,1931-1-9,-101
1931,1,10,42,0,42,1931-1-10,-42
1931,1,11,50,0,50,1931-1-11,-50
1931,1,12,32,0,32,1931-1-12,-32
1931,1,13,91,69,22,1931-1-13,47
1931,1,14,143,119,24,1931-1-14,95
1931,1,15,308,295,13,1931-1-15,282
1931,1,16,743,743,0,1931-1-16,743
1931,1,17,907,907,0,1931-1-17,907
1931,1,18,1315,1315,0,1931-1-18,1315
1931,1,19,451,451,0,1931-1-19,451
1931,1,20,155,155,0,1931-1-20,155
1931,1,21,138,138,0,1931-1-21,138
1931,1,22,119,119,0,1931-1-22,119
1931,1,23,227,227,0,1931-1-23,227
1931,1,24,96,96,0,1931-1-24,96
1931,1,25,28,28,0,1931-1-25,28
1931,1,26,14,14,0,1931-1-26,14
1931,1,27,6,6,0,1931-1-27,6
1931,1,28,9,9,0,1931-1-28,9
1931,1,29,0,0,0,1931-1-29,0
1931,1,30,0,0,0,1931-1-30,0
1931,1,31,0,0,0,1931-1-31,0
1931,2,1,0,0,0,1931-2-1,0
1931,2,2,176,176,0,1931-2-2,176
1931,2,3,239,214,25,1931-2-3,189
1931,2,4,233,222,11,1931-2-4,211
1931,2,5,323,314,9,1931-2-5,305
1931,2,6,382,382,0,1931-2-6,382
1931,2,7,340,340,0,1931-2-7,340
1931,2,8,306,301,5,1931-2-8,296
1931,2,9,250,213,37,1931-2-9,176
1931,2,10,325,186,139,1931-2-10,47
1931,2,11,256,189,67,1931-2-11,122
1931,2,12,224,224,0,1931-2-12,224
1931,2,13,195,195,0,1931-2-13,195
1931,2,14,86,86,0,1931-2-14,86
1931,2,15,350,194,156,1931-2-15,38
1931,2,16,328,173,155,1931-2-16,18
1931,2,17,380,247,133,1931-2-17,114
1931,2,18,512,389,123,1931-2-18,266
1931,2,19,988,889,99,1931-2-19,790
1931,2,20,1781,1705,76,1931-2-20,1629
1931,2,21,1949,1867,82,1931-2-21,1785
1931,2,22,2355,2029,326,1931-2-22,1703
1931,2,23,2834,2172,662,1931-2-23,1510
1931,2,24,2417,1858,559,1931-2-24,1299
1931,2,25,2473,1956,517,1931-2-25,1439
1931,2,26,2160,1634,526,1931-2-26,1108
1931,2,27,577,414,163,1931-2-27,251
1931,2,28,299,79,220,1931-2-28,-141
1931,3,1,488,62,426,1931-3-1,-364
1931,3,2,416,0,416,1931-3-2,-416
1931,3,3,426,0,426,1931-3-3,-426
1931,3,4,650,0,650,1931-3-4,-650
1931,3,5,482,0,482,1931-3-5,-482
1931,3,6,449,0,449,1931-3-6,-449
1931,3,7,405,0,405,1931-3-7,-405
1931,3,8,333,0,333,1931-3-8,-333
1931,3,9,719,396,323,1931-3-9,73
1931,3,10,824,638,186,1931-3-10,452
1931,3,11,1170,1052,118,1931-3-11,934
1931,3,12,1234,1150,84,1931-3-12,1066
1931,3,13,1411,1308,103,1931-3-13,1205
1931,3,14,1123,1123,0,1931-3-14,1123
1931,3,15,797,797,0,1931-3-15,797
1931,3,16,832,832,0,1931-3-16,832
1931,3,17,879,742,137,1931-3-17,605
1931,3,18,1087,776,311,1931-3-18,465
1931,3,19,589,536,53,1931-3-19,483
1931,3,20,452,417,35,1931-3-20,382
1931,3,21,279,258,21,1931-3-21,237
1931,3,22,197,191,6,1931-3-22,185
1931,3,23,181,181,0,1931-3-23,181
1931,3,24,373,185,188,1931-3-24,-3
1931,3,25,174,0,174,1931-3-25,-174
1931,3,26,208,27,181,1931-3-26,-154
1931,3,27,176,0,176,1931-3-27,-176
1931,3,28,171,0,171,1931-3-28,-171
1931,3,29,172,0,172,1931-3-29,-172
1931,3,30,178,18,160,1931-3-30,-142
1931,3,31,256,27,229,1931-3-31,-202
1931,4,1,616,43,573,1931-4-1,-530
1931,4,2,348,16,332,1931-4-2,-316
1931,4,3,304,15,289,1931-4-3,-274
1931,4,4,205,13,192,1931-4-4,-179
1931,4,5,248,33,215,1931-4-5,-182
1931,4,6,197,51,146,1931-4-6,-95
1931,4,7,505,340,165,1931-4-7,175
1931,4,8,673,494,179,1931-4-8,315
1931,4,9,532,400,132,1931-4-9,268
1931,4,10,473,330,143,1931-4-10,187
1931,4,11,553,450,103,1931-4-11,347
1931,4,12,555,438,117,1931-4-12,321
1931,4,13,692,570,122,1931-4-13,448
1931,4,14,554,554,0,1931-4-14,554
1931,4,15,755,755,0,1931-4-15,755
1931,4,16,627,617,10,1931-4-16,607
1931,4,17,594,594,0,1931-4-17,594
1931,4,18,485,485,0,1931-4-18,485
1931,4,19,413,413,0,1931-4-19,413
1931,4,20,442,442,0,1931-4-20,442
1931,4,21,837,837,0,1931-4-21,837
1931,4,22,952,952,0,1931-4-22,952
1931,4,23,499,499,0,1931-4-23,499
1931,4,24,313,313,0,1931-4-24,313
1931,4,25,312,312,0,1931-4-25,312
1931,4,26,87,87,0,1931-4-26,87
1931,4,27,72,72,0,1931-4-27,72
1931,4,28,24,24,0,1931-4-28,24
1931,4,29,28,28,0,1931-4-29,28
1931,4,30,60,60,0,1931-4-30,60
1931,5,1,132,132,0,1931-5-1,132
1931,5,2,142,142,0,1931-5-2,142
1931,5,3,106,106,0,1931-5-3,106
1931,5,4,28,0,28,1931-5-4,-28
1931,5,5,12,4,8,1931-5-5,-4
1931,5,6,35,32,3,1931-5-6,29
1931,5,7,281,281,0,1931-5-7,281
1931,5,8,273,265,8,1931-5-8,257
1931,5,9,275,258,17,1931-5-9,241
1931,5,10,329,263,66,1931-5-10,197
1931,5,11,489,301,188,1931-5-11,113
1931,5,12,345,250,95,1931-5-12,155
1931,5,13,335,257,78,1931-5-13,179
1931,5,14,258,258,0,1931-5-14,258
1931,5,15,342,319,23,1931-5-15,296
1931,5,16,503,368,135,1931-5-16,233
1931,5,17,355,203,152,1931-5-17,51
1931,5,18,499,205,294,1931-5-18,-89
1931,5,19,329,9,320,1931-5-19,-311
1931,5,20,525,0,525,1931-5-20,-525
1931,5,21,571,12,559,1931-5-21,-547
1931,5,22,494,16,478,1931-5-22,-462
1931,5,23,529,65,464,1931-5-23,-399
1931,5,24,381,64,317,1931-5-24,-253
1931,5,25,264,64,200,1931-5-25,-136
1931,5,26,217,60,157,1931-5-26,-97
1931,5,27,174,174,0,1931-5-27,174
1931,5,28,78,78,0,1931-5-28,78
1931,5,29,149,149,0,1931-5-29,149
1931,5,30,263,263,0,1931-5-30,263
1931,5,31,328,328,0,1931-5-31,328
1931,6,1,352,352,0,1931-6-1,352
1931,6,2,328,314,14,1931-6-2,300
1931,6,3,373,365,8,1931-6-3,357
1931,6,4,559,559,0,1931-6-4,559
1931,6,5,388,388,0,1931-6-5,388
1931,6,6,474,474,0,1931-6-6,474
1931,6,7,442,442,0,1931-6-7,442
1931,6,8,466,466,0,1931-6-8,466
1931,6,9,366,366,0,1931-6-9,366
1931,6,10,315,315,0,1931-6-10,315
1931,6,11,130,130,0,1931-6-11,130
1931,6,12,12,12,0,1931-6-12,12
1931,6,13,0,0,0,1931-6-13,0
1931,6,14,99,0,99,1931-6-14,-99
1931,6,15,0,0,0,1931-6-15,0
1931,6,16,0,0,0,1931-6-16,0
1931,6,17,0,0,0,1931-6-17,0
1931,6,18,3,0,3,1931-6-18,-3
1931,6,19,0,0,0,1931-6-19,0
1931,6,20,0,0,0,1931-6-20,0
1931,6,21,0,0,0,1931-6-21,0
1931,6,22,5,5,0,1931-6-22,5
1931,6,23,0,0,0,1931-6-23,0
1931,6,24,0,0,0,1931-6-24,0
1931,6,25,0,0,0,1931-6-25,0
1931,6,26,0,0,0,1931-6-26,0
1931,6,27,4,0,4,1931-6-27,-4
1931,6,28,37,0,37,1931-6-28,-37
1931,6,29,511,380,131,1931-6-29,249
1931,6,30,491,373,118,1931-6-30,255
1931,7,1,415,307,108,1931-7-1,199
1931,7,2,314,235,79,1931-7-2,156
1931,7,3,197,117,80,1931-7-3,37
1931,7,4,153,88,65,1931-7-4,23
1931,7,5,91,25,66,1931-7-5,-41
1931,7,6,109,5,104,1931-7-6,-99
1931,7,7,171,14,157,1931-7-7,-143
1931,7,8,338,10,328,1931-7-8,-318
1931,7,9,221,0,221,1931-7-9,-221
1931,7,10,172,13,159,1931-7-10,-146
1931,7,11,147,0,147,1931-7-11,-147
1931,7,12,87,4,83,1931-7-12,-79
1931,7,13,48,4,44,1931-7-13,-40
1931,7,14,41,0,41,1931-7-14,-41
1931,7,15,41,0,41,1931-7-15,-41
1931,7,16,12,0,12,1931-7-16,-12
1931,7,17,9,9,0,1931-7-17,9
1931,7,18,11,7,4,1931-7-18,3
1931,7,19,0,0,0,1931-7-19,0
1931,7,20,0,0,0,1931-7-20,0
1931,7,21,2,2,0,1931-7-21,2
1931,7,22,61,61,0,1931-7-22,61
1931,7,23,25,25,0,1931-7-23,25
1931,7,24,13,13,0,1931-7-24,13
1931,7,25,10,10,0,1931-7-25,10
1931,7,26,79,79,0,1931-7-26,79
1931,7,27,75,75,0,1931-7-27,75
1931,7,28,70,70,0,1931-7-28,70
1931,7,29,82,82,0,1931-7-29,82
1931,7,30,136,103,33,1931-7-30,70
1931,7,31,236,111,125,1931-7-31,-14
1931,8,1,173,68,105,1931-8-1,-37
1931,8,2,126,64,62,1931-8-2,2
1931,8,3,74,37,37,1931-8-3,0
1931,8,4,177,29,148,1931-8-4,-119
1931,8,5,159,0,159,1931-8-5,-159
1931,8,6,185,9,176,1931-8-6,-167
1931,8,7,48,0,48,1931-8-7,-48
1931,8,8,0,0,0,1931-8-8,0
1931,8,9,7,7,0,1931-8-9,7
1931,8,10,0,0,0,1931-8-10,0
1931,8,11,13,13,0,1931-8-11,13
1931,8,12,5,5,0,1931-8-12,5
1931,8,13,4,4,0,1931-8-13,4
1931,8,14,7,7,0,1931-8-14,7
1931,8,15,0,0,0,1931-8-15,0
1931,8,16,0,0,0,1931-8-16,0
1931,8,17,63,0,63,1931-8-17,-63
1931,8,18,140,0,140,1931-8-18,-140
1931,8,19,124,0,124,1931-8-19,-124
1931,8,20,153,0,153,1931-8-20,-153
1931,8,21,97,0,97,1931-8-21,-97
1931,8,22,18,0,18,1931-8-22,-18
1931,8,23,0,0,0,1931-8-23,0
1931,8,24,0,0,0,1931-8-24,0
1931,8,25,0,0,0,1931-8-25,0
1931,8,26,132,118,14,1931-8-26,104
1931,8,27,145,135,10,1931-8-27,125
1931,8,28,168,135,33,1931-8-28,102
1931,8,29,170,140,30,1931-8-29,110
1931,8,30,120,109,11,1931-8-30,98
1931,8,31,261,261,0,1931-8-31,261
1931,9,1,182,182,0,1931-9-1,182
1931,9,2,128,117,11,1931-9-2,106
1931,9,3,122,111,11,1931-9-3,100
1931,9,4,71,67,4,1931-9-4,63
1931,9,5,42,42,0,1931-9-5,42
1931,9,6,39,39,0,1931-9-6,39
1931,9,7,62,41,21,1931-9-7,20
1931,9,8,13,0,13,1931-9-8,-13
1931,9,9,23,0,23,1931-9-9,-23
1931,9,10,125,0,125,1931-9-10,-125
1931,9,11,314,0,314,1931-9-11,-314
1931,9,12,359,18,341,1931-9-12,-323
1931,9,13,438,74,364,1931-9-13,-290
1931,9,14,213,213,0,1931-9-14,213
1931,9,15,118,118,0,1931-9-15,118
1931,9,16,276,276,0,1931-9-16,276
1931,9,17,279,279,0,1931-9-17,279
1931,9,18,260,260,0,1931-9-18,260
1931,9,19,177,177,0,1931-9-19,177
1931,9,20,138,138,0,1931-9-20,138
1931,9,21,102,102,0,1931-9-21,102
1931,9,22,99,99,0,1931-9-22,99
1931,9,23,108,108,0,1931-9-23,108
1931,9,24,36,36,0,1931-9-24,36
1931,9,25,13,13,0,1931-9-25,13
1931,9,26,3,3,0,1931-9-26,3
1931,9,27,34,34,0,1931-9-27,34
1931,9,28,252,252,0,1931-9-28,252
1931,9,29,219,217,2,1931-9-29,215
1931,9,30,229,229,0,1931-9-30,229
1931,10,1,174,174,0,1931-10-1,174
1931,10,2,138,138,0,1931-10-2,138
1931,10,3,103,103,0,1931-10-3,103
1931,10,4,98,66,32,1931-10-4,34
1931,10,5,44,40,4,1931-10-5,36
1931,10,6,46,46,0,1931-10-6,46
1931,10,7,13,13,0,1931-10-7,13
1931,10,8,24,0,24,1931-10-8,-24
1931,10,9,5,0,5,1931-10-9,-5
1931,10,10,0,0,0,1931-10-10,0
1931,10,11,0,0,0,1931-10-11,0
1931,10,12,5,0,5,1931-10-12,-5
1931,10,13,0,0,0,1931-10-13,0
1931,10,14,28,28,0,1931-10-14,28
1931,10,15,15,15,0,1931-10-15,15
1931,10,16,0,0,0,1931-10-16,0
1931,10,17,0,0,0,1931-10-17,0
1931,10,18,0,0,0,1931-10-18,0
1931,10,19,239,0,239,1931-10-19,-239
1931,10,20,220,0,220,1931-10-20,-220
1931,10,21,179,0,179,1931-10-21,-179
1931,10,22,186,0,186,1931-10-22,-186
1931,10,23,219,18,201,1931-10-23,-183
1931,10,24,195,22,173,1931-10-24,-151
1931,10,25,137,4,133,1931-10-25,-129
1931,10,26,164,12,152,1931-10-26,-140
1931,10,27,147,0,147,1931-10-27,-147
1931,10,28,189,0,189,1931-10-28,-189
1931,10,29,96,0,96,1931-10-29,-96
1931,10,30,141,3,138,1931-10-30,-135
1931,10,31,124,51,73,1931-10-31,-22
1931,11,1,98,98,0,1931-11-1,98
1931,11,2,0,0,0,1931-11-2,0
1931,11,3,44,7,37,1931-11-3,-30
1931,11,4,83,36,47,1931-11-4,-11
1931,11,5,144,89,55,1931-11-5,34
1931,11,6,490,303,187,1931-11-6,116
1931,11,7,155,0,155,1931-11-7,-155
1931,11,8,91,0,91,1931-11-8,-91
1931,11,9,55,0,55,1931-11-9,-55
1931,11,10,0,0,0,1931-11-10,0
1931,11,11,0,0,0,1931-11-11,0
1931,11,12,5,0,5,1931-11-12,-5
1931,11,13,0,0,0,1931-11-13,0
1931,11,14,0,0,0,1931-11-14,0
1931,11,15,0,0,0,1931-11-15,0
1931,11,16,0,0,0,1931-11-16,0
1931,11,17,0,0,0,1931-11-17,0
1931,11,18,30,30,0,1931-11-18,30
1931,11,19,71,71,0,1931-11-19,71
1931,11,20,369,369,0,1931-11-20,369
1931,11,21,720,720,0,1931-11-21,720
1931,11,22,847,847,0,1931-11-22,847
1931,11,23,839,839,0,1931-11-23,839
1931,11,24,675,640,35,1931-11-24,605
1931,11,25,627,590,37,1931-11-25,553
1931,11,26,615,601,14,1931-11-26,587
1931,11,27,593,593,0,1931-11-27,593
1931,11,28,499,499,0,1931-11-28,499
1931,11,29,461,461,0,1931-11-29,461
1931,11,30,384,384,0,1931-11-30,384
1931,12,1,304,302,2,1931-12-1,300
1931,12,2,224,224,0,1931-12-2,224
1931,12,3,0,0,0,1931-12-3,0
1931,12,4,0,0,0,1931-12-4,0
1931,12,5,0,0,0,1931-12-5,0
1931,12,6,48,48,0,1931-12-6,48
1931,12,7,271,271,0,1931-12-7,271
1931,12,8,292,292,0,1931-12-8,292
1931,12,9,402,402,0,1931-12-9,402
1931,12,10,497,497,0,1931-12-10,497
1931,12,11,688,688,0,1931-12-11,688
1931,12,12,534,534,0,1931-12-12,534
1931,12,13,508,508,0,1931-12-13,508
1931,12,14,398,398,0,1931-12-14,398
1931,12,15,232,232,0,1931-12-15,232
1931,12,16,185,185,0,1931-12-16,185
1931,12,17,65,65,0,1931-12-17,65
1931,12,18,105,105,0,1931-12-18,105
1931,12,19,83,83,0,1931-12-19,83
1931,12,20,75,75,0,1931-12-20,75
1931,12,21,58,58,0,1931-12-21,58
1931,12,22,31,26,5,1931-12-22,21
1931,12,23,8,8,0,1931-12-23,8
1931,12,24,51,51,0,1931-12-24,51
1931,12,25,204,40,164,1931-12-25,-124
1931,12,26,188,0,188,1931-12-26,-188
1931,12,27,188,32,156,1931-12-27,-124
1931,12,28,198,25,173,1931-12-28,-148
1931,12,29,171,0,171,1931-12-29,-171
1931,12,30,170,0,170,1931-12-30,-170
1931,12,31,152,0,152,1931-12-31,-152
1932,1,1,164,13,151,1932-1-1,-138
1932,1,2,188,23,165,1932-1-2,-142
1932,1,3,152,15,137,1932-1-3,-122
1932,1,4,174,26,148,1932-1-4,-122
1932,1,5,167,8,159,1932-1-5,-151
1932,1,6,29,29,0,1932-1-6,29
1932,1,7,8,8,0,1932-1-7,8
1932,1,8,3,3,0,1932-1-8,3
1932,1,9,5,3,2,1932-1-9,1
1932,1,10,8,8,0,1932-1-10,8
1932,1,11,0,0,0,1932-1-11,0
1932,1,12,0,0,0,1932-1-12,0
1932,1,13,7,0,7,1932-1-13,-7
1932,1,14,0,0,0,1932-1-14,0
1932,1,15,29,8,21,1932-1-15,-13
1932,1,16,103,0,103,1932-1-16,-103
1932,1,17,102,0,102,1932-1-17,-102
1932,1,18,70,7,63,1932-1-18,-56
1932,1,19,72,0,72,1932-1-19,-72
1932,1,20,0,0,0,1932-1-20,0
1932,1,21,157,0,157,1932-1-21,-157
1932,1,22,173,32,141,1932-1-22,-109
1932,1,23,167,47,120,1932-1-23,-73
1932,1,24,139,20,119,1932-1-24,-99
1932,1,25,200,33,167,1932-1-25,-134
1932,1,26,404,265,139,1932-1-26,126
1932,1,27,409,288,121,1932-1-27,167
1932,1,28,279,173,106,1932-1-28,67
1932,1,29,266,161,105,1932-1-29,56
1932,1,30,253,163,90,1932-1-30,73
1932,1,31,211,145,66,1932-1-31,79
1932,2,1,192,130,62,1932-2-1,68
1932,2,2,136,93,43,1932-2-2,50
1932,2,3,109,103,6,1932-2-3,97
1932,2,4,102,102,0,1932-2-4,102
1932,2,5,87,87,0,1932-2-5,87
1932,2,6,76,76,0,1932-2-6,76
1932,2,7,102,102,0,1932-2-7,102
1932,2,8,0,0,0,1932-2-8,0
1932,2,9,0,0,0,1932-2-9,0
1932,2,10,27,0,27,1932-2-10,-27
1932,2,11,37,0,37,1932-2-11,-37
1932,2,12,5,0,5,1932-2-12,-5
1932,2,13,0,0,0,1932-2-13,0
1932,2,14,0,0,0,1932-2-14,0
1932,2,15,0,0,0,1932-2-15,0
1932,2,16,0,0,0,1932-2-16,0
1932,2,17,0,0,0,1932-2-17,0
1932,2,18,0,0,0,1932-2-18,0
1932,2,19,0,0,0,1932-2-19,0
1932,2,20,8,0,8,1932-2-20,-8
1932,2,21,0,0,0,1932-2-21,0
1932,2,22,5,5,0,1932-2-22,5
1932,2,23,38,30,8,1932-2-23,22
1932,2,24,117,71,46,1932-2-24,25
1932,2,25,234,226,8,1932-2-25,218
1932,2,26,413,413,0,1932-2-26,413
1932,2,27,568,568,0,1932-2-27,568
1932,2,28,691,688,3,1932-2-28,685
1932,2,29,634,629,5,1932-2-29,624
1932,3,1,645,605,40,1932-3-1,565
1932,3,2,788,778,10,1932-3-2,768
1932,3,3,599,597,2,1932-3-3,595
1932,3,4,300,300,0,1932-3-4,300
1932,3,5,288,288,0,1932-3-5,288
1932,3,6,293,293,0,1932-3-6,293
1932,3,7,276,276,0,1932-3-7,276
1932,3,8,212,212,0,1932-3-8,212
1932,3,9,218,218,0,1932-3-9,218
1932,3,10,226,226,0,1932-3-10,226
1932,3,11,0,0,0,1932-3-11,0
1932,3,12,0,0,0,1932-3-12,0
1932,3,13,0,0,0,1932-3-13,0
1932,3,14,0,0,0,1932-3-14,0
1932,3,15,0,0,0,1932-3-15,0
1932,3,16,5,0,5,1932-3-16,-5
1932,3,17,67,0,67,1932-3-17,-67
1932,3,18,28,0,28,1932-3-18,-28
1932,3,19,44,0,44,1932-3-19,-44
1932,3,20,23,0,23,1932-3-20,-23
1932,3,21,9,0,9,1932-3-21,-9
1932,3,22,5,0,5,1932-3-22,-5
1932,3,23,0,0,0,1932-3-23,0
1932,3,24,0,0,0,1932-3-24,0
1932,3,25,111,111,0,1932-3-25,111
1932,3,26,81,81,0,1932-3-26,81
1932,3,27,95,85,10,1932-3-27,75
1932,3,28,103,90,13,1932-3-28,77
1932,3,29,98,93,5,1932-3-29,88
1932,3,30,83,76,7,1932-3-30,69
1932,3,31,66,66,0,1932-3-31,66
1932,4,1,57,57,0,1932-4-1,57
1932,4,2,40,40,0,1932-4-2,40
1932,4,3,71,17,54,1932-4-3,-37
1932,4,4,97,0,97,1932-4-4,-97
1932,4,5,2,0,2,1932-4-5,-2
1932,4,6,0,0,0,1932-4-6,0
1932,4,7,0,0,0,1932-4-7,0
1932,4,8,0,0,0,1932-4-8,0
1932,4,9,0,0,0,1932-4-9,0
1932,4,10,12,0,12,1932-4-10,-12
1932,4,11,11,0,11,1932-4-11,-11
1932,4,12,5,0,5,1932-4-12,-5
1932,4,13,1,0,1,1932-4-13,-1
1932,4,14,0,0,0,1932-4-14,0
1932,4,15,22,0,22,1932-4-15,-22
1932,4,16,11,0,11,1932-4-16,-11
1932,4,17,39,0,39,1932-4-17,-39
1932,4,18,8,0,8,1932-4-18,-8
1932,4,19,0,0,0,1932-4-19,0
1932,4,20,0,0,0,1932-4-20,0
1932,4,21,139,27,112,1932-4-21,-85
1932,4,22,556,317,239,1932-4-22,78
1932,4,23,965,474,491,1932-4-23,-17
1932,4,24,411,411,0,1932-4-24,411
1932,4,25,656,656,0,1932-4-25,656
1932,4,26,844,844,0,1932-4-26,844
1932,4,27,796,796,0,1932-4-27,796
1932,4,28,775,775,0,1932-4-28,775
1932,4,29,590,590,0,1932-4-29,590
1932,4,30,568,568,0,1932-4-30,568
1932,5,1,353,353,0,1932-5-1,353
1932,5,2,0,0,0,1932-5-2,0
1932,5,3,0,0,0,1932-5-3,0
1932,5,4,0,0,0,1932-5-4,0
1932,5,5,0,0,0,1932-5-5,0
1932,5,6,0,0,0,1932-5-6,0
1932,5,7,172,0,172,1932-5-7,-172
1932,5,8,111,0,111,1932-5-8,-111
1932,5,9,150,0,150,1932-5-9,-150
1932,5,10,112,0,112,1932-5-10,-112
1932,5,11,138,0,138,1932-5-11,-138
1932,5,12,162,0,162,1932-5-12,-162
1932,5,13,150,26,124,1932-5-13,-98
1932,5,14,172,32,140,1932-5-14,-108
1932,5,15,303,170,133,1932-5-15,37
1932,5,16,617,507,110,1932-5-16,397
1932,5,17,602,481,121,1932-5-17,360
1932,5,18,563,496,67,1932-5-18,429
1932,5,19,440,440,0,1932-5-19,440
1932,5,20,704,704,0,1932-5-20,704
1932,5,21,666,666,0,1932-5-21,666
1932,5,22,705,705,0,1932-5-22,705
1932,5,23,643,643,0,1932-5-23,643
1932,5,24,609,609,0,1932-5-24,609
1932,5,25,503,503,0,1932-5-25,503
1932,5,26,475,475,0,1932-5-26,475
1932,5,27,388,388,0,1932-5-27,388
1932,5,28,389,389,0,1932-5-28,389
1932,5,29,275,275,0,1932-5-29,275
1932,5,30,311,311,0,1932-5-30,311
1932,5,31,299,299,0,1932-5-31,299
1932,6,1,260,260,0,1932-6-1,260
1932,6,2,0,0,0,1932-6-2,0
1932,6,3,110,0,110,1932-6-3,-110
1932,6,4,126,0,126,1932-6-4,-126
1932,6,5,174,0,174,1932-6-5,-174
1932,6,6,231,29,202,1932-6-6,-173
1932,6,7,306,65,241,1932-6-7,-176
1932,6,8,332,29,303,1932-6-8,-274
1932,6,9,287,28,259,1932-6-9,-231
1932,6,10,277,35,242,1932-6-10,-207
1932,6,11,239,11,228,1932-6-11,-217
1932,6,12,199,0,199,1932-6-12,-199
1932,6,13,235,0,235,1932-6-13,-235
1932,6,14,306,0,306,1932-6-14,-306
1932,6,15,14,14,0,1932-6-15,14
1932,6,16,249,249,0,1932-6-16,249
1932,6,17,526,526,0,1932-6-17,526
1932,6,18,547,547,0,1932-6-18,547
1932,6,19,522,522,0,1932-6-19,522
1932,6,20,512,512,0,1932-6-20,512
1932,6,21,554,388,166,1932-6-21,222
1932,6,22,502,502,0,1932-6-22,502
1932,6,23,557,557,0,1932-6-23,557
1932,6,24,675,675,0,1932-6-24,675
1932,6,25,605,605,0,1932-6-25,605
1932,6,26,517,517,0,1932-6-26,517
1932,6,27,417,417,0,1932-6-27,417
1932,6,28,415,415,0,1932-6-28,415
1932,6,29,363,218,145,1932-6-29,73
1932,6,30,262,168,94,1932-6-30,74
1932,7,1,171,81,90,1932-7-1,-9
1932,7,2,175,88,87,1932-7-2,1
1932,7,3,154,0,154,1932-7-3,-154
1932,7,4,241,4,237,1932-7-4,-233
1932,7,5,204,0,204,1932-7-5,-204
1932,7,6,179,0,179,1932-7-6,-179
1932,7,7,127,0,127,1932-7-7,-127
1932,7,8,205,0,205,1932-7-8,-205
1932,7,9,192,0,192,1932-7-9,-192
1932,7,10,190,0,190,1932-7-10,-190
1932,7,11,216,0,216,1932-7-11,-216
1932,7,12,259,0,259,1932-7-12,-259
1932,7,13,16,0,16,1932-7-13,-16
1932,7,14,8,0,8,1932-7-14,-8
1932,7,15,0,0,0,1932-7-15,0
1932,7,16,0,0,0,1932-7-16,0
1932,7,17,0,0,0,1932-7-17,0
1932,7,18,27,0,27,1932-7-18,-27
1932,7,19,0,0,0,1932-7-19,0
1932,7,20,13,0,13,1932-7-20,-13
1932,7,21,7,0,7,1932-7-21,-7
1932,7,22,5,0,5,1932-7-22,-5
1932,7,23,0,0,0,1932-7-23,0
1932,7,24,0,0,0,1932-7-24,0
1932,7,25,0,0,0,1932-7-25,0
1932,7,26,0,0,0,1932-7-26,0
1932,7,27,259,0,259,1932-7-27,-259
1932,7,28,260,0,260,1932-7-28,-260
1932,7,29,247,8,239,1932-7-29,-231
1932,7,30,224,6,218,1932-7-30,-212
1932,7,31,220,0,220,1932-7-31,-220
1932,8,1,226,0,226,1932-8-1,-226
1932,8,2,202,0,202,1932-8-2,-202
1932,8,3,201,0,201,1932-8-3,-201
1932,8,4,194,0,194,1932-8-4,-194
1932,8,5,187,0,187,1932-8-5,-187
1932,8,6,202,0,202,1932-8-6,-202
1932,8,7,213,0,213,1932-8-7,-213
1932,8,8,194,0,194,1932-8-8,-194
1932,8,9,0,0,0,1932-8-9,0
1932,8,10,16,0,16,1932-8-10,-16
1932,8,11,45,0,45,1932-8-11,-45
1932,8,12,0,0,0,1932-8-12,0
1932,8,13,0,0,0,1932-8-13,0
1932,8,14,0,0,0,1932-8-14,0
1932,8,15,0,0,0,1932-8-15,0
1932,8,16,0,0,0,1932-8-16,0
1932,8,17,0,0,0,1932-8-17,0
1932,8,18,0,0,0,1932-8-18,0
1932,8,19,0,0,0,1932-8-19,0
1932,8,20,0,0,0,1932-8-20,0
1932,8,21,0,0,0,1932-8-21,0
1932,8,22,0,0,0,1932-8-22,0
1932,8,23,79,0,79,1932-8-23,-79
1932,8,24,96,3,93,1932-8-24,-90
1932,8,25,123,0,123,1932-8-25,-123
1932,8,26,135,0,135,1932-8-26,-135
1932,8,27,169,0,169,1932-8-27,-169
1932,8,28,84,0,84,1932-8-28,-84
1932,8,29,83,0,83,1932-8-29,-83
1932,8,30,19,0,19,1932-8-30,-19
1932,8,31,10,0,10,1932-8-31,-10
1932,9,1,9,0,9,1932-9-1,-9
1932,9,2,9,0,9,1932-9-2,-9
1932,9,3,11,0,11,1932-9-3,-11
1932,9,4,7,0,7,1932-9-4,-7
1932,9,5,0,0,0,1932-9-5,0
1932,9,6,0,0,0,1932-9-6,0
1932,9,7,0,0,0,1932-9-7,0
1932,9,8,0,0,0,1932-9-8,0
1932,9,9,0,0,0,1932-9-9,0
1932,9,10,0,0,0,1932-9-10,0
1932,9,11,0,0,0,1932-9-11,0
1932,9,12,17,17,0,1932-9-12,17
1932,9,13,0,0,0,1932-9-13,0
1932,9,14,0,0,0,1932-9-14,0
1932,9,15,0,0,0,1932-9-15,0
1932,9,16,0,0,0,1932-9-16,0
1932,9,17,0,0,0,1932-9-17,0
1932,9,18,0,0,0,1932-9-18,0
1932,9,19,11,0,11,1932-9-19,-11
1932,9,20,0,0,0,1932-9-20,0
1932,9,21,79,21,58,1932-9-21,-37
1932,9,22,5,5,0,1932-9-22,5
1932,9,23,0,0,0,1932-9-23,0
1932,9,24,11,11,0,1932-9-24,11
1932,9,25,2,2,0,1932-9-25,2
1932,9,26,0,0,0,1932-9-26,0
1932,9,27,11,11,0,1932-9-27,11
1932,9,28,15,15,0,1932-9-28,15
1932,9,29,46,0,46,1932-9-29,-46
1932,9,30,26,0,26,1932-9-30,-26
1932,10,1,23,11,12,1932-10-1,-1
1932,10,2,0,0,0,1932-10-2,0
1932,10,3,24,24,0,1932-10-3,24
1932,10,4,0,0,0,1932-10-4,0
1932,10,5,0,0,0,1932-10-5,0
1932,10,6,2,2,0,1932-10-6,2
1932,10,7,6,6,0,1932-10-7,6
1932,10,8,0,0,0,1932-10-8,0
1932,10,9,0,0,0,1932-10-9,0
1932,10,10,0,0,0,1932-10-10,0
1932,10,11,0,0,0,1932-10-11,0
1932,10,12,10,10,0,1932-10-12,10
1932,10,13,15,15,0,1932-10-13,15
1932,10,14,48,48,0,1932-10-14,48
1932,10,15,41,41,0,1932-10-15,41
1932,10,16,29,29,0,1932-10-16,29
1932,10,17,14,14,0,1932-10-17,14
1932,10,18,216,216,0,1932-10-18,216
1932,10,19,271,271,0,1932-10-19,271
1932,10,20,286,286,0,1932-10-20,286
1932,10,21,241,241,0,1932-10-21,241
1932,10,22,188,188,0,1932-10-22,188
1932,10,23,155,155,0,1932-10-23,155
1932,10,24,110,110,0,1932-10-24,110
1932,10,25,130,130,0,1932-10-25,130
1932,10,26,108,108,0,1932-10-26,108
1932,10,27,86,86,0,1932-10-27,86
1932,10,28,86,86,0,1932-10-28,86
1932,10,29,54,54,0,1932-10-29,54
1932,10,30,49,49,0,1932-10-30,49
1932,10,31,9,0,9,1932-10-31,-9
1932,11,1,5,0,5,1932-11-1,-5
1932,11,2,23,0,23,1932-11-2,-23
1932,11,3,32,0,32,1932-11-3,-32
1932,11,4,54,0,54,1932-11-4,-54
1932,11,5,12,0,12,1932-11-5,-12
1932,11,6,0,0,0,1932-11-6,0
1932,11,7,9,0,9,1932-11-7,-9
1932,11,8,0,0,0,1932-11-8,0
1932,11,9,0,0,0,1932-11-9,0
1932,11,10,0,0,0,1932-11-10,0
1932,11,11,23,13,10,1932-11-11,3
1932,11,12,7,7,0,1932-11-12,7
1932,11,13,19,19,0,1932-11-13,19
1932,11,14,30,30,0,1932-11-14,30
1932,11,15,21,21,0,1932-11-15,21
1932,11,16,4,4,0,1932-11-16,4
1932,11,17,66,66,0,1932-11-17,66
1932,11,18,316,316,0,1932-11-18,316
1932,11,19,383,383,0,1932-11-19,383
1932,11,20,771,771,0,1932-11-20,771
1932,11,21,1155,1155,0,1932-11-21,1155
1932,11,22,638,638,0,1932-11-22,638
1932,11,23,0,0,0,1932-11-23,0
1932,11,24,0,0,0,1932-11-24,0
1932,11,25,0,0,0,1932-11-25,0
1932,11,26,0,0,0,1932-11-26,0
1932,11,27,0,0,0,1932-11-27,0
1932,11,28,0,0,0,1932-11-28,0
1932,11,29,38,38,0,1932-11-29,38
1932,11,30,150,150,0,1932-11-30,150
1932,12,1,136,136,0,1932-12-1,136
1932,12,2,99,99,0,1932-12-2,99
1932,12,3,106,106,0,1932-12-3,106
1932,12,4,66,66,0,1932-12-4,66
1932,12,5,14,14,0,1932-12-5,14
1932,12,6,417,417,0,1932-12-6,417
1932,12,7,546,546,0,1932-12-7,546
1932,12,8,590,590,0,1932-12-8,590
1932,12,9,615,615,0,1932-12-9,615
1932,12,10,564,564,0,1932-12-10,564
1932,12,11,555,555,0,1932-12-11,555
1932,12,12,542,536,6,1932-12-12,530
1932,12,13,546,546,0,1932-12-13,546
1932,12,14,530,530,0,1932-12-14,530
1932,12,15,429,429,0,1932-12-15,429
1932,12,16,455,455,0,1932-12-16,455
1932,12,17,443,443,0,1932-12-17,443
1932,12,18,476,476,0,1932-12-18,476
1932,12,19,301,301,0,1932-12-19,301
1932,12,20,512,512,0,1932-12-20,512
1932,12,21,10,10,0,1932-12-21,10
1932,12,22,0,0,0,1932-12-22,0
1932,12,23,0,0,0,1932-12-23,0
1932,12,24,0,0,0,1932-12-24,0
1932,12,25,0,0,0,1932-12-25,0
1932,12,26,0,0,0,1932-12-26,0
1932,12,27,42,42,0,1932-12-27,42
1932,12,28,27,27,0,1932-12-28,27
1932,12,29,38,38,0,1932-12-29,38
1932,12,30,95,95,0,1932-12-30,95
1932,12,31,106,106,0,1932-12-31,106
1933,1,1,0,0,0,1933-1-1,0
1933,1,2,0,0,0,1933-1-2,0
1933,1,3,201,201,0,1933-1-3,201
1933,1,4,302,302,0,1933-1-4,302
1933,1,5,353,353,0,1933-1-5,353
1933,1,6,335,335,0,1933-1-6,335
1933,1,7,345,345,0,1933-1-7,345
1933,1,8,325,325,0,1933-1-8,325
1933,1,9,329,329,0,1933-1-9,329
1933,1,10,328,328,0,1933-1-10,328
1933,1,11,351,351,0,1933-1-11,351
1933,1,12,366,366,0,1933-1-12,366
1933,1,13,383,383,0,1933-1-13,383
1933,1,14,531,531,0,1933-1-14,531
1933,1,15,468,468,0,1933-1-15,468
1933,1,16,154,154,0,1933-1-16,154
1933,1,17,16,16,0,1933-1-17,16
1933,1,18,0,0,0,1933-1-18,0
1933,1,19,0,0,0,1933-1-19,0
1933,1,20,0,0,0,1933-1-20,0
1933,1,21,0,0,0,1933-1-21,0
1933,1,22,0,0,0,1933-1-22,0
1933,1,23,0,0,0,1933-1-23,0
1933,1,24,0,0,0,1933-1-24,0
1933,1,25,0,0,0,1933-1-25,0
1933,1,26,0,0,0,1933-1-26,0
1933,1,27,0,0,0,1933-1-27,0
1933,1,28,29,29,0,1933-1-28,29
1933,1,29,144,144,0,1933-1-29,144
1933,1,30,274,274,0,1933-1-30,274
1933,1,31,340,340,0,1933-1-31,340
1933,2,1,796,796,0,1933-2-1,796
1933,2,2,1929,1929,0,1933-2-2,1929
1933,2,3,1815,1815,0,1933-2-3,1815
1933,2,4,1785,1785,0,1933-2-4,1785
1933,2,5,1844,1844,0,1933-2-5,1844
1933,2,6,1709,1709,0,1933-2-6,1709
1933,2,7,1412,1377,35,1933-2-7,1342
1933,2,8,1300,1280,20,1933-2-8,1260
1933,2,9,1177,1177,0,1933-2-9,1177
1933,2,10,1020,1020,0,1933-2-10,1020
1933,2,11,911,911,0,1933-2-11,911
1933,2,12,655,655,0,1933-2-12,655
1933,2,13,339,339,0,1933-2-13,339
1933,2,14,0,0,0,1933-2-14,0
1933,2,15,2,0,2,1933-2-15,-2
1933,2,16,0,0,0,1933-2-16,0
1933,2,17,0,0,0,1933-2-17,0
1933,2,18,0,0,0,1933-2-18,0
1933,2,19,0,0,0,1933-2-19,0
1933,2,20,0,0,0,1933-2-20,0
1933,2,21,0,0,0,1933-2-21,0
1933,2,22,0,0,0,1933-2-22,0
1933,2,23,0,0,0,1933-2-23,0
1933,2,24,0,0,0,1933-2-24,0
1933,2,25,0,0,0,1933-2-25,0
1933,2,26,0,0,0,1933-2-26,0
1933,2,27,36,36,0,1933-2-27,36
1933,2,28,308,308,0,1933-2-28,308
1933,3,1,192,192,0,1933-3-1,192
1933,3,2,241,241,0,1933-3-2,241
1933,3,3,254,254,0,1933-3-3,254
1933,3,4,226,226,0,1933-3-4,226
1933,3,5,198,198,0,1933-3-5,198
1933,3,6,183,183,0,1933-3-6,183
1933,3,7,181,181,0,1933-3-7,181
1933,3,8,141,141,0,1933-3-8,141
1933,3,9,119,119,0,1933-3-9,119
1933,3,10,112,112,0,1933-3-10,112
1933,3,11,96,96,0,1933-3-11,96
1933,3,12,127,127,0,1933-3-12,127
1933,3,13,0,0,0,1933-3-13,0
1933,3,14,0,0,0,1933-3-14,0
1933,3,15,0,0,0,1933-3-15,0
1933,3,16,0,0,0,1933-3-16,0
1933,3,17,0,0,0,1933-3-17,0
1933,3,18,0,0,0,1933-3-18,0
1933,3,19,0,0,0,1933-3-19,0
1933,3,20,0,0,0,1933-3-20,0
1933,3,21,0,0,0,1933-3-21,0
1933,3,22,386,386,0,1933-3-22,386
1933,3,23,481,481,0,1933-3-23,481
1933,3,24,345,345,0,1933-3-24,345
1933,3,25,277,277,0,1933-3-25,277
1933,3,26,319,319,0,1933-3-26,319
1933,3,27,320,320,0,1933-3-27,320
1933,3,28,297,297,0,1933-3-28,297
1933,3,29,244,244,0,1933-3-29,244
1933,3,30,157,157,0,1933-3-30,157
1933,3,31,134,134,0,1933-3-31,134
1933,4,1,131,131,0,1933-4-1,131
1933,4,2,150,150,0,1933-4-2,150
1933,4,3,0,0,0,1933-4-3,0
1933,4,4,0,0,0,1933-4-4,0
1933,4,5,0,0,0,1933-4-5,0
1933,4,6,4,4,0,1933-4-6,4
1933,4,7,0,0,0,1933-4-7,0
1933,4,8,0,0,0,1933-4-8,0
1933,4,9,0,0,0,1933-4-9,0
1933,4,10,0,0,0,1933-4-10,0
1933,4,11,0,0,0,1933-4-11,0
1933,4,12,0,0,0,1933-4-12,0
1933,4,13,0,0,0,1933-4-13,0
1933,4,14,0,0,0,1933-4-14,0
1933,4,15,0,0,0,1933-4-15,0
1933,4,16,0,0,0,1933-4-16,0
1933,4,17,32,32,0,1933-4-17,32
1933,4,18,56,56,0,1933-4-18,56
1933,4,19,58,58,0,1933-4-19,58
1933,4,20,14,14,0,1933-4-20,14
1933,4,21,11,11,0,1933-4-21,11
1933,4,22,0,0,0,1933-4-22,0
1933,4,23,0,0,0,1933-4-23,0
1933,4,24,0,0,0,1933-4-24,0
1933,4,25,0,0,0,1933-4-25,0
1933,4,26,0,0,0,1933-4-26,0
1933,4,27,0,0,0,1933-4-27,0
1933,4,28,0,0,0,1933-4-28,0
1933,4,29,5,5,0,1933-4-29,5
1933,4,30,0,0,0,1933-4-30,0
1933,5,1,0,0,0,1933-5-1,0
1933,5,2,24,24,0,1933-5-2,24
1933,5,3,0,0,0,1933-5-3,0
1933,5,4,0,0,0,1933-5-4,0
1933,5,5,0,0,0,1933-5-5,0
1933,5,6,0,0,0,1933-5-6,0
1933,5,7,0,0,0,1933-5-7,0
1933,5,8,0,0,0,1933-5-8,0
1933,5,9,9,0,9,1933-5-9,-9
1933,5,10,3,0,3,1933-5-10,-3
1933,5,11,0,0,0,1933-5-11,0
1933,5,12,0,0,0,1933-5-12,0
1933,5,13,0,0,0,1933-5-13,0
1933,5,14,0,0,0,1933-5-14,0
1933,5,15,0,0,0,1933-5-15,0
1933,5,16,0,0,0,1933-5-16,0
1933,5,17,0,0,0,1933-5-17,0
1933,5,18,0,0,0,1933-5-18,0
1933,5,19,18,18,0,1933-5-19,18
1933,5,20,93,93,0,1933-5-20,93
1933,5,21,105,105,0,1933-5-21,105
1933,5,22,128,128,0,1933-5-22,128
1933,5,23,52,52,0,1933-5-23,52
1933,5,24,32,32,0,1933-5-24,32
1933,5,25,14,14,0,1933-5-25,14
1933,5,26,4,4,0,1933-5-26,4
1933,5,27,5,5,0,1933-5-27,5
1933,5,28,0,0,0,1933-5-28,0
1933,5,29,0,0,0,1933-5-29,0
1933,5,30,0,0,0,1933-5-30,0
1933,5,31,0,0,0,1933-5-31,0
1933,6,1,0,0,0,1933-6-1,0
1933,6,2,10,0,10,1933-6-2,-10
1933,6,3,10,0,10,1933-6-3,-10
1933,6,4,8,0,8,1933-6-4,-8
1933,6,5,5,0,5,1933-6-5,-5
1933,6,6,14,5,9,1933-6-6,-4
1933,6,7,7,0,7,1933-6-7,-7
1933,6,8,0,0,0,1933-6-8,0
1933,6,9,0,0,0,1933-6-9,0
1933,6,10,0,0,0,1933-6-10,0
1933,6,11,0,0,0,1933-6-11,0
1933,6,12,0,0,0,1933-6-12,0
1933,6,13,99,99,0,1933-6-13,99
1933,6,14,150,150,0,1933-6-14,150
1933,6,15,161,161,0,1933-6-15,161
1933,6,16,114,114,0,1933-6-16,114
1933,6,17,85,85,0,1933-6-17,85
1933,6,18,109,109,0,1933-6-18,109
1933,6,19,103,103,0,1933-6-19,103
1933,6,20,100,100,0,1933-6-20,100
1933,6,21,93,93,0,1933-6-21,93
1933,6,22,103,103,0,1933-6-22,103
1933,6,23,0,0,0,1933-6-23,0
1933,6,24,0,0,0,1933-6-24,0
1933,6,25,0,0,0,1933-6-25,0
1933,6,26,0,0,0,1933-6-26,0
1933,6,27,0,0,0,1933-6-27,0
1933,6,28,0,0,0,1933-6-28,0
1933,6,29,0,0,0,1933-6-29,0
1933,6,30,0,0,0,1933-6-30,0
1933,7,1,0,0,0,1933-7-1,0
1933,7,2,0,0,0,1933-7-2,0
1933,7,3,0,0,0,1933-7-3,0
1933,7,4,0,0,0,1933-7-4,0
1933,7,5,91,91,0,1933-7-5,91
1933,7,6,54,54,0,1933-7-6,54
1933,7,7,75,75,0,1933-7-7,75
1933,7,8,45,45,0,1933-7-8,45
1933,7,9,30,30,0,1933-7-9,30
1933,7,10,34,34,0,1933-7-10,34
1933,7,11,18,12,6,1933-7-11,6
1933,7,12,28,9,19,1933-7-12,-10
1933,7,13,4,0,4,1933-7-13,-4
1933,7,14,0,0,0,1933-7-14,0
1933,7,15,0,0,0,1933-7-15,0
1933,7,16,0,0,0,1933-7-16,0
1933,7,17,0,0,0,1933-7-17,0
1933,7,18,0,0,0,1933-7-18,0
1933,7,19,0,0,0,1933-7-19,0
1933,7,20,0,0,0,1933-7-20,0
1933,7,21,0,0,0,1933-7-21,0
1933,7,22,0,0,0,1933-7-22,0
1933,7,23,0,0,0,1933-7-23,0
1933,7,24,0,0,0,1933-7-24,0
1933,7,25,0,0,0,1933-7-25,0
1933,7,26,0,0,0,1933-7-26,0
1933,7,27,0,0,0,1933-7-27,0
1933,7,28,0,0,0,1933-7-28,0
1933,7,29,0,0,0,1933-7-29,0
1933,7,30,0,0,0,1933-7-30,0
1933,7,31,0,0,0,1933-7-31,0
1933,8,1,0,0,0,1933-8-1,0
1933,8,2,0,0,0,1933-8-2,0
1933,8,3,0,0,0,1933-8-3,0
1933,8,4,0,0,0,1933-8-4,0
1933,8,5,0,0,0,1933-8-5,0
1933,8,6,0,0,0,1933-8-6,0
1933,8,7,0,0,0,1933-8-7,0
1933,8,8,0,0,0,1933-8-8,0
1933,8,9,4,4,0,1933-8-9,4
1933,8,10,0,0,0,1933-8-10,0
1933,8,11,0,0,0,1933-8-11,0
1933,8,12,6,0,6,1933-8-12,-6
1933,8,13,0,0,0,1933-8-13,0
1933,8,14,0,0,0,1933-8-14,0
1933,8,15,0,0,0,1933-8-15,0
1933,8,16,0,0,0,1933-8-16,0
1933,8,17,0,0,0,1933-8-17,0
1933,8,18,0,0,0,1933-8-18,0
1933,8,19,0,0,0,1933-8-19,0
1933,8,20,0,0,0,1933-8-20,0
1933,8,21,0,0,0,1933-8-21,0
1933,8,22,0,0,0,1933-8-22,0
1933,8,23,0,0,0,1933-8-23,0
1933,8,24,0,0,0,1933-8-24,0
1933,8,25,0,0,0,1933-8-25,0
1933,8,26,0,0,0,1933-8-26,0
1933,8,27,0,0,0,1933-8-27,0
1933,8,28,0,0,0,1933-8-28,0
1933,8,29,0,0,0,1933-8-29,0
1933,8,30,0,0,0,1933-8-30,0
1933,8,31,0,0,0,1933-8-31,0
1933,9,1,0,0,0,1933-9-1,0
1933,9,2,13,13,0,1933-9-2,13
1933,9,3,5,5,0,1933-9-3,5
1933,9,4,3,3,0,1933-9-4,3
1933,9,5,0,0,0,1933-9-5,0
1933,9,6,33,0,33,1933-9-6,-33
1933,9,7,133,0,133,1933-9-7,-133
1933,9,8,92,0,92,1933-9-8,-92
1933,9,9,67,0,67,1933-9-9,-67
1933,9,10,24,0,24,1933-9-10,-24
1933,9,11,0,0,0,1933-9-11,0
1933,9,12,0,0,0,1933-9-12,0
1933,9,13,0,0,0,1933-9-13,0
1933,9,14,0,0,0,1933-9-14,0
1933,9,15,0,0,0,1933-9-15,0
1933,9,16,0,0,0,1933-9-16,0
1933,9,17,0,0,0,1933-9-17,0
1933,9,18,0,0,0,1933-9-18,0
1933,9,19,0,0,0,1933-9-19,0
1933,9,20,0,0,0,1933-9-20,0
1933,9,21,2,2,0,1933-9-21,2
1933,9,22,59,59,0,1933-9-22,59
1933,9,23,30,30,0,1933-9-23,30
1933,9,24,8,8,0,1933-9-24,8
1933,9,25,0,0,0,1933-9-25,0
1933,9,26,0,0,0,1933-9-26,0
1933,9,27,2,0,2,1933-9-27,-2
1933,9,28,36,0,36,1933-9-28,-36
1933,9,29,60,0,60,1933-9-29,-60
1933,9,30,19,0,19,1933-9-30,-19
1933,10,1,0,0,0,1933-10-1,0
1933,10,2,0,0,0,1933-10-2,0
1933,10,3,0,0,0,1933-10-3,0
1933,10,4,0,0,0,1933-10-4,0
1933,10,5,0,0,0,1933-10-5,0
1933,10,6,0,0,0,1933-10-6,0
1933,10,7,0,0,0,1933-10-7,0
1933,10,8,0,0,0,1933-10-8,0
1933,10,9,0,0,0,1933-10-9,0
1933,10,10,2,2,0,1933-10-10,2
1933,10,11,0,0,0,1933-10-11,0
1933,10,12,5,5,0,1933-10-12,5
1933,10,13,0,0,0,1933-10-13,0
1933,10,14,0,0,0,1933-10-14,0
1933,10,15,0,0,0,1933-10-15,0
1933,10,16,0,0,0,1933-10-16,0
1933,10,17,0,0,0,1933-10-17,0
1933,10,18,0,0,0,1933-10-18,0
1933,10,19,0,0,0,1933-10-19,0
1933,10,20,0,0,0,1933-10-20,0
1933,10,21,0,0,0,1933-10-21,0
1933,10,22,0,0,0,1933-10-22,0
1933,10,23,0,0,0,1933-10-23,0
1933,10,24,0,0,0,1933-10-24,0
1933,10,25,0,0,0,1933-10-25,0
1933,10,26,131,131,0,1933-10-26,131
1933,10,27,231,231,0,1933-10-27,231
1933,10,28,205,205,0,1933-10-28,205
1933,10,29,246,231,15,1933-10-29,216
1933,10,30,191,191,0,1933-10-30,191
1933,10,31,145,145,0,1933-10-31,145
1933,11,1,130,130,0,1933-11-1,130
1933,11,2,0,0,0,1933-11-2,0
1933,11,3,0,0,0,1933-11-3,0
1933,11,4,0,0,0,1933-11-4,0
1933,11,5,0,0,0,1933-11-5,0
1933,11,6,0,0,0,1933-11-6,0
1933,11,7,0,0,0,1933-11-7,0
1933,11,8,0,0,0,1933-11-8,0
1933,11,9,0,0,0,1933-11-9,0
1933,11,10,0,0,0,1933-11-10,0
1933,11,11,0,0,0,1933-11-11,0
1933,11,12,0,0,0,1933-11-12,0
1933,11,13,0,0,0,1933-11-13,0
1933,11,14,0,0,0,1933-11-14,0
1933,11,15,0,0,0,1933-11-15,0
1933,11,16,0,0,0,1933-11-16,0
1933,11,17,0,0,0,1933-11-17,0
1933,11,18,0,0,0,1933-11-18,0
1933,11,19,0,0,0,1933-11-19,0
1933,11,20,0,0,0,1933-11-20,0
1933,11,21,0,0,0,1933-11-21,0
1933,11,22,0,0,0,1933-11-22,0
1933,11,23,0,0,0,1933-11-23,0
1933,11,24,0,0,0,1933-11-24,0
1933,11,25,0,0,0,1933-11-25,0
1933,11,26,0,0,0,1933-11-26,0
1933,11,27,0,0,0,1933-11-27,0
1933,11,28,0,0,0,1933-11-28,0
1933,11,29,0,0,0,1933-11-29,0
1933,11,30,0,0,0,1933-11-30,0
1933,12,1,0,0,0,1933-12-1,0
1933,12,2,0,0,0,1933-12-2,0
1933,12,3,0,0,0,1933-12-3,0
1933,12,4,0,0,0,1933-12-4,0
1933,12,5,0,0,0,1933-12-5,0
1933,12,6,0,0,0,1933-12-6,0
1933,12,7,0,0,0,1933-12-7,0
1933,12,8,0,0,0,1933-12-8,0
1933,12,9,0,0,0,1933-12-9,0
1933,12,10,0,0,0,1933-12-10,0
1933,12,11,23,23,0,1933-12-11,23
1933,12,12,0,0,0,1933-12-12,0
1933,12,13,0,0,0,1933-12-13,0
1933,12,14,0,0,0,1933-12-14,0
1933,12,15,0,0,0,1933-12-15,0
1933,12,16,0,0,0,1933-12-16,0
1933,12,17,0,0,0,1933-12-17,0
1933,12,18,0,0,0,1933-12-18,0
1933,12,19,0,0,0,1933-12-19,0
1933,12,20,0,0,0,1933-12-20,0
1933,12,21,0,0,0,1933-12-21,0
1933,12,22,0,0,0,1933-12-22,0
1933,12,23,0,0,0,1933-12-23,0
1933,12,24,0,0,0,1933-12-24,0
1933,12,25,0,0,0,1933-12-25,0
1933,12,26,0,0,0,1933-12-26,0
1933,12,27,0,0,0,1933-12-27,0
1933,12,28,0,0,0,1933-12-28,0
1933,12,29,0,0,0,1933-12-29,0
1933,12,30,0,0,0,1933-12-30,0
1933,12,31,0,0,0,1933-12-31,0
1934,1,1,0,0,0,1934-1-1,0
1934,1,2,0,0,0,1934-1-2,0
1934,1,3,0,0,0,1934-1-3,0
1934,1,4,0,0,0,1934-1-4,0
1934,1,5,0,0,0,1934-1-5,0
1934,1,6,0,0,0,1934-1-6,0
1934,1,7,0,0,0,1934-1-7,0
1934,1,8,0,0,0,1934-1-8,0
1934,1,9,0,0,0,1934-1-9,0
1934,1,10,0,0,0,1934-1-10,0
1934,1,11,0,0,0,1934-1-11,0
1934,1,12,22,22,0,1934-1-12,22
1934,1,13,50,50,0,1934-1-13,50
1934,1,14,47,47,0,1934-1-14,47
1934,1,15,103,103,0,1934-1-15,103
1934,1,16,218,218,0,1934-1-16,218
1934,1,17,308,308,0,1934-1-17,308
1934,1,18,294,294,0,1934-1-18,294
1934,1,19,0,0,0,1934-1-19,0
1934,1,20,0,0,0,1934-1-20,0
1934,1,21,0,0,0,1934-1-21,0
1934,1,22,0,0,0,1934-1-22,0
1934,1,23,0,0,0,1934-1-23,0
1934,1,24,0,0,0,1934-1-24,0
1934,1,25,0,0,0,1934-1-25,0
1934,1,26,0,0,0,1934-1-26,0
1934,1,27,0,0,0,1934-1-27,0
1934,1,28,0,0,0,1934-1-28,0
1934,1,29,20,20,0,1934-1-29,20
1934,1,30,95,95,0,1934-1-30,95
1934,1,31,171,171,0,1934-1-31,171
1934,2,1,77,77,0,1934-2-1,77
1934,2,2,47,47,0,1934-2-2,47
1934,2,3,24,24,0,1934-2-3,24
1934,2,4,0,0,0,1934-2-4,0
1934,2,5,39,0,39,1934-2-5,-39
1934,2,6,38,0,38,1934-2-6,-38
1934,2,7,91,77,14,1934-2-7,63
1934,2,8,160,156,4,1934-2-8,152
1934,2,9,198,198,0,1934-2-9,198
1934,2,10,172,172,0,1934-2-10,172
1934,2,11,167,167,0,1934-2-11,167
1934,2,12,118,118,0,1934-2-12,118
1934,2,13,105,105,0,1934-2-13,105
1934,2,14,112,107,5,1934-2-14,102
1934,2,15,92,92,0,1934-2-15,92
1934,2,16,69,69,0,1934-2-16,69
1934,2,17,50,50,0,1934-2-17,50
1934,2,18,46,46,0,1934-2-18,46
1934,2,19,18,18,0,1934-2-19,18
1934,2,20,0,0,0,1934-2-20,0
1934,2,21,0,0,0,1934-2-21,0
1934,2,22,0,0,0,1934-2-22,0
1934,2,23,0,0,0,1934-2-23,0
1934,2,24,19,0,19,1934-2-24,-19
1934,2,25,7,0,7,1934-2-25,-7
1934,2,26,0,0,0,1934-2-26,0
1934,2,27,0,0,0,1934-2-27,0
1934,2,28,0,0,0,1934-2-28,0
1934,3,1,0,0,0,1934-3-1,0
1934,3,2,0,0,0,1934-3-2,0
1934,3,3,0,0,0,1934-3-3,0
1934,3,4,4,0,4,1934-3-4,-4
1934,3,5,0,0,0,1934-3-5,0
1934,3,6,23,0,23,1934-3-6,-23
1934,3,7,34,0,34,1934-3-7,-34
1934,3,8,40,0,40,1934-3-8,-40
1934,3,9,102,0,102,1934-3-9,-102
1934,3,10,84,0,84,1934-3-10,-84
1934,3,11,10,0,10,1934-3-11,-10
1934,3,12,0,0,0,1934-3-12,0
1934,3,13,3,3,0,1934-3-13,3
1934,3,14,0,0,0,1934-3-14,0
1934,3,15,0,0,0,1934-3-15,0
1934,3,16,0,0,0,1934-3-16,0
1934,3,17,4,4,0,1934-3-17,4
1934,3,18,0,0,0,1934-3-18,0
1934,3,19,0,0,0,1934-3-19,0
1934,3,20,0,0,0,1934-3-20,0
1934,3,21,0,0,0,1934-3-21,0
1934,3,22,0,0,0,1934-3-22,0
1934,3,23,0,0,0,1934-3-23,0
1934,3,24,0,0,0,1934-3-24,0
1934,3,25,4,0,4,1934-3-25,-4
1934,3,26,5,0,5,1934-3-26,-5
1934,3,27,21,21,0,1934-3-27,21
1934,3,28,9,9,0,1934-3-28,9
1934,3,29,5,0,5,1934-3-29,-5
1934,3,30,6,0,6,1934-3-30,-6
1934,3,31,0,0,0,1934-3-31,0
1934,4,1,10,10,0,1934-4-1,10
1934,4,2,73,73,0,1934-4-2,73
1934,4,3,97,97,0,1934-4-3,97
1934,4,4,23,23,0,1934-4-4,23
1934,4,5,12,12,0,1934-4-5,12
1934,4,6,0,0,0,1934-4-6,0
1934,4,7,0,0,0,1934-4-7,0
1934,4,8,5,0,5,1934-4-8,-5
1934,4,9,0,0,0,1934-4-9,0
1934,4,10,0,0,0,1934-4-10,0
1934,4,11,0,0,0,1934-4-11,0
1934,4,12,0,0,0,1934-4-12,0
1934,4,13,0,0,0,1934-4-13,0
1934,4,14,26,26,0,1934-4-14,26
1934,4,15,1069,25,1044,1934-4-15,-1019
1934,4,16,1190,21,1169,1934-4-16,-1148
1934,4,17,1043,9,1034,1934-4-17,-1025
1934,4,18,890,4,886,1934-4-18,-882
1934,4,19,741,0,741,1934-4-19,-741
1934,4,20,705,0,705,1934-4-20,-705
1934,4,21,717,0,717,1934-4-21,-717
1934,4,22,662,0,662,1934-4-22,-662
1934,4,23,587,0,587,1934-4-23,-587
1934,4,24,547,0,547,1934-4-24,-547
1934,4,25,576,0,576,1934-4-25,-576
1934,4,26,565,0,565,1934-4-26,-565
1934,4,27,565,35,530,1934-4-27,-495
1934,4,28,541,14,527,1934-4-28,-513
1934,4,29,7,7,0,1934-4-29,7
1934,4,30,0,0,0,1934-4-30,0
1934,5,1,21,21,0,1934-5-1,21
1934,5,2,0,0,0,1934-5-2,0
1934,5,3,0,0,0,1934-5-3,0
1934,5,4,24,0,24,1934-5-4,-24
1934,5,5,108,0,108,1934-5-5,-108
1934,5,6,198,0,198,1934-5-6,-198
1934,5,7,215,0,215,1934-5-7,-215
1934,5,8,235,30,205,1934-5-8,-175
1934,5,9,288,21,267,1934-5-9,-246
1934,5,10,159,0,159,1934-5-10,-159
1934,5,11,137,0,137,1934-5-11,-137
1934,5,12,42,0,42,1934-5-12,-42
1934,5,13,944,0,944,1934-5-13,-944
1934,5,14,811,0,811,1934-5-14,-811
1934,5,15,837,0,837,1934-5-15,-837
1934,5,16,864,85,779,1934-5-16,-694
1934,5,17,1296,457,839,1934-5-17,-382
1934,5,18,1032,344,688,1934-5-18,-344
1934,5,19,843,285,558,1934-5-19,-273
1934,5,20,716,277,439,1934-5-20,-162
1934,5,21,440,200,240,1934-5-21,-40
1934,5,22,406,219,187,1934-5-22,32
1934,5,23,406,213,193,1934-5-23,20
1934,5,24,389,234,155,1934-5-24,79
1934,5,25,352,221,131,1934-5-25,90
1934,5,26,367,244,123,1934-5-26,121
1934,5,27,200,200,0,1934-5-27,200
1934,5,28,155,150,5,1934-5-28,145
1934,5,29,90,90,0,1934-5-29,90
1934,5,30,0,0,0,1934-5-30,0
1934,5,31,0,0,0,1934-5-31,0
1934,6,1,0,0,0,1934-6-1,0
1934,6,2,0,0,0,1934-6-2,0
1934,6,3,0,0,0,1934-6-3,0
1934,6,4,0,0,0,1934-6-4,0
1934,6,5,0,0,0,1934-6-5,0
1934,6,6,0,0,0,1934-6-6,0
1934,6,7,0,0,0,1934-6-7,0
1934,6,8,0,0,0,1934-6-8,0
1934,6,9,0,0,0,1934-6-9,0
1934,6,10,0,0,0,1934-6-10,0
1934,6,11,0,0,0,1934-6-11,0
1934,6,12,3,0,3,1934-6-12,-3
1934,6,13,0,0,0,1934-6-13,0
1934,6,14,0,0,0,1934-6-14,0
1934,6,15,239,239,0,1934-6-15,239
1934,6,16,298,273,25,1934-6-16,248
1934,6,17,364,273,91,1934-6-17,182
1934,6,18,262,231,31,1934-6-18,200
1934,6,19,259,258,1,1934-6-19,257
1934,6,20,288,288,0,1934-6-20,288
1934,6,21,228,219,9,1934-6-21,210
1934,6,22,206,206,0,1934-6-22,206
1934,6,23,204,204,0,1934-6-23,204
1934,6,24,175,175,0,1934-6-24,175
1934,6,25,237,237,0,1934-6-25,237
1934,6,26,228,228,0,1934-6-26,228
1934,6,27,0,0,0,1934-6-27,0
1934,6,28,0,0,0,1934-6-28,0
1934,6,29,0,0,0,1934-6-29,0
1934,6,30,0,0,0,1934-6-30,0
1934,7,1,0,0,0,1934-7-1,0
1934,7,2,0,0,0,1934-7-2,0
1934,7,3,0,0,0,1934-7-3,0
1934,7,4,0,0,0,1934-7-4,0
1934,7,5,0,0,0,1934-7-5,0
1934,7,6,241,241,0,1934-7-6,241
1934,7,7,199,199,0,1934-7-7,199
1934,7,8,162,162,0,1934-7-8,162
1934,7,9,187,172,15,1934-7-9,157
1934,7,10,204,164,40,1934-7-10,124
1934,7,11,276,262,14,1934-7-11,248
1934,7,12,294,271,23,1934-7-12,248
1934,7,13,227,214,13,1934-7-13,201
1934,7,14,246,242,4,1934-7-14,238
1934,7,15,231,231,0,1934-7-15,231
1934,7,16,262,262,0,1934-7-16,262
1934,7,17,224,224,0,1934-7-17,224
1934,7,18,201,201,0,1934-7-18,201
1934,7,19,259,259,0,1934-7-19,259
1934,7,20,28,28,0,1934-7-20,28
1934,7,21,7,7,0,1934-7-21,7
1934,7,22,0,0,0,1934-7-22,0
1934,7,23,0,0,0,1934-7-23,0
1934,7,24,6,0,6,1934-7-24,-6
1934,7,25,8,0,8,1934-7-25,-8
1934,7,26,6,0,6,1934-7-26,-6
1934,7,27,0,0,0,1934-7-27,0
1934,7,28,12,7,5,1934-7-28,2
1934,7,29,3,0,3,1934-7-29,-3
1934,7,30,0,0,0,1934-7-30,0
1934,7,31,0,0,0,1934-7-31,0
1934,8,1,0,0,0,1934-8-1,0
1934,8,2,0,0,0,1934-8-2,0
1934,8,3,0,0,0,1934-8-3,0
1934,8,4,0,0,0,1934-8-4,0
1934,8,5,0,0,0,1934-8-5,0
1934,8,6,0,0,0,1934-8-6,0
1934,8,7,298,0,298,1934-8-7,-298
1934,8,8,287,0,287,1934-8-8,-287
1934,8,9,268,0,268,1934-8-9,-268
1934,8,10,244,0,244,1934-8-10,-244
1934,8,11,251,0,251,1934-8-11,-251
1934,8,12,272,19,253,1934-8-12,-234
1934,8,13,261,30,231,1934-8-13,-201
1934,8,14,267,41,226,1934-8-14,-185
1934,8,15,231,25,206,1934-8-15,-181
1934,8,16,237,77,160,1934-8-16,-83
1934,8,17,166,36,130,1934-8-17,-94
1934,8,18,138,10,128,1934-8-18,-118
1934,8,19,10,10,0,1934-8-19,10
1934,8,20,0,0,0,1934-8-20,0
1934,8,21,0,0,0,1934-8-21,0
1934,8,22,0,0,0,1934-8-22,0
1934,8,23,8,0,8,1934-8-23,-8
1934,8,24,41,0,41,1934-8-24,-41
1934,8,25,0,0,0,1934-8-25,0
1934,8,26,0,0,0,1934-8-26,0
1934,8,27,8,8,0,1934-8-27,8
1934,8,28,0,0,0,1934-8-28,0
1934,8,29,0,0,0,1934-8-29,0
1934,8,30,5,5,0,1934-8-30,5
1934,8,31,0,0,0,1934-8-31,0
1934,9,1,30,0,30,1934-9-1,-30
1934,9,2,4,4,0,1934-9-2,4
1934,9,3,11,11,0,1934-9-3,11
1934,9,4,0,0,0,1934-9-4,0
1934,9,5,0,0,0,1934-9-5,0
1934,9,6,0,0,0,1934-9-6,0
1934,9,7,0,0,0,1934-9-7,0
1934,9,8,0,0,0,1934-9-8,0
1934,9,9,0,0,0,1934-9-9,0
1934,9,10,0,0,0,1934-9-10,0
1934,9,11,0,0,0,1934-9-11,0
1934,9,12,10,0,10,1934-9-12,-10
1934,9,13,6,0,6,1934-9-13,-6
1934,9,14,0,0,0,1934-9-14,0
1934,9,15,98,84,14,1934-9-15,70
1934,9,16,223,218,5,1934-9-16,213
1934,9,17,136,136,0,1934-9-17,136
1934,9,18,0,0,0,1934-9-18,0
1934,9,19,0,0,0,1934-9-19,0
1934,9,20,0,0,0,1934-9-20,0
1934,9,21,0,0,0,1934-9-21,0
1934,9,22,0,0,0,1934-9-22,0
1934,9,23,0,0,0,1934-9-23,0
1934,9,24,2,2,0,1934-9-24,2
1934,9,25,0,0,0,1934-9-25,0
1934,9,26,2,2,0,1934-9-26,2
1934,9,27,0,0,0,1934-9-27,0
1934,9,28,9,9,0,1934-9-28,9
1934,9,29,23,14,9,1934-9-29,5
1934,9,30,78,68,10,1934-9-30,58
1934,10,1,53,3,50,1934-10-1,-47
1934,10,2,0,0,0,1934-10-2,0
1934,10,3,2,0,2,1934-10-3,-2
1934,10,4,8,0,8,1934-10-4,-8
1934,10,5,0,0,0,1934-10-5,0
1934,10,6,0,0,0,1934-10-6,0
1934,10,7,0,0,0,1934-10-7,0
1934,10,8,0,0,0,1934-10-8,0
1934,10,9,0,0,0,1934-10-9,0
1934,10,10,0,0,0,1934-10-10,0
1934,10,11,43,0,43,1934-10-11,-43
1934,10,12,50,0,50,1934-10-12,-50
1934,10,13,56,0,56,1934-10-13,-56
1934,10,14,33,0,33,1934-10-14,-33
1934,10,15,18,0,18,1934-10-15,-18
1934,10,16,16,0,16,1934-10-16,-16
1934,10,17,6,0,6,1934-10-17,-6
1934,10,18,9,0,9,1934-10-18,-9
1934,10,19,21,0,21,1934-10-19,-21
1934,10,20,8,0,8,1934-10-20,-8
1934,10,21,0,0,0,1934-10-21,0
1934,10,22,2,2,0,1934-10-22,2
1934,10,23,9,9,0,1934-10-23,9
1934,10,24,0,0,0,1934-10-24,0
1934,10,25,56,56,0,1934-10-25,56
1934,10,26,57,57,0,1934-10-26,57
1934,10,27,29,29,0,1934-10-27,29
1934,10,28,16,16,0,1934-10-28,16
1934,10,29,15,15,0,1934-10-29,15
1934,10,30,26,16,10,1934-10-30,6
1934,10,31,120,120,0,1934-10-31,120
1934,11,1,378,378,0,1934-11-1,378
1934,11,2,294,294,0,1934-11-2,294
1934,11,3,226,222,4,1934-11-3,218
1934,11,4,208,208,0,1934-11-4,208
1934,11,5,145,145,0,1934-11-5,145
1934,11,6,93,93,0,1934-11-6,93
1934,11,7,89,89,0,1934-11-7,89
1934,11,8,70,70,0,1934-11-8,70
1934,11,9,76,76,0,1934-11-9,76
1934,11,10,68,68,0,1934-11-10,68
1934,11,11,16,16,0,1934-11-11,16
1934,11,12,23,23,0,1934-11-12,23
1934,11,13,0,0,0,1934-11-13,0
1934,11,14,0,0,0,1934-11-14,0
1934,11,15,0,0,0,1934-11-15,0
1934,11,16,0,0,0,1934-11-16,0
1934,11,17,0,0,0,1934-11-17,0
1934,11,18,0,0,0,1934-11-18,0
1934,11,19,0,0,0,1934-11-19,0
1934,11,20,0,0,0,1934-11-20,0
1934,11,21,0,0,0,1934-11-21,0
1934,11,22,12,12,0,1934-11-22,12
1934,11,23,6,0,6,1934-11-23,-6
1934,11,24,0,0,0,1934-11-24,0
1934,11,25,11,0,11,1934-11-25,-11
1934,11,26,33,0,33,1934-11-26,-33
1934,11,27,4,0,4,1934-11-27,-4
1934,11,28,102,0,102,1934-11-28,-102
1934,11,29,261,0,261,1934-11-29,-261
1934,11,30,281,0,281,1934-11-30,-281
1934,12,1,172,0,172,1934-12-1,-172
1934,12,2,154,0,154,1934-12-2,-154
1934,12,3,247,0,247,1934-12-3,-247
1934,12,4,395,0,395,1934-12-4,-395
1934,12,5,72,0,72,1934-12-5,-72
1934,12,6,81,0,81,1934-12-6,-81
1934,12,7,324,0,324,1934-12-7,-324
1934,12,8,308,0,308,1934-12-8,-308
1934,12,9,0,0,0,1934-12-9,0
1934,12,10,0,0,0,1934-12-10,0
1934,12,11,0,0,0,1934-12-11,0
1934,12,12,0,0,0,1934-12-12,0
1934,12,13,0,0,0,1934-12-13,0
1934,12,14,0,0,0,1934-12-14,0
1934,12,15,0,0,0,1934-12-15,0
1934,12,16,0,0,0,1934-12-16,0
1934,12,17,0,0,0,1934-12-17,0
1934,12,18,0,0,0,1934-12-18,0
1934,12,19,0,0,0,1934-12-19,0
1934,12,20,78,78,0,1934-12-20,78
1934,12,21,245,190,55,1934-12-21,135
1934,12,22,209,155,54,1934-12-22,101
1934,12,23,175,104,71,1934-12-23,33
1934,12,24,292,102,190,1934-12-24,-88
1934,12,25,246,47,199,1934-12-25,-152
1934,12,26,336,41,295,1934-12-26,-254
1934,12,27,433,28,405,1934-12-27,-377
1934,12,28,371,47,324,1934-12-28,-277
1934,12,29,252,0,252,1934-12-29,-252
1934,12,30,217,0,217,1934-12-30,-217
1934,12,31,135,0,135,1934-12-31,-135
1935,1,1,120,0,120,1935-1-1,-120
1935,1,2,498,0,498,1935-1-2,-498
1935,1,3,461,0,461,1935-1-3,-461
1935,1,4,405,0,405,1935-1-4,-405
1935,1,5,297,11,286,1935-1-5,-275
1935,1,6,270,29,241,1935-1-6,-212
1935,1,7,252,17,235,1935-1-7,-218
1935,1,8,191,1,190,1935-1-8,-189
1935,1,9,178,0,178,1935-1-9,-178
1935,1,10,187,0,187,1935-1-10,-187
1935,1,11,232,0,232,1935-1-11,-232
1935,1,12,646,0,646,1935-1-12,-646
1935,1,13,700,0,700,1935-1-13,-700
1935,1,14,700,0,700,1935-1-14,-700
1935,1,15,357,0,357,1935-1-15,-357
1935,1,16,219,0,219,1935-1-16,-219
1935,1,17,194,0,194,1935-1-17,-194
1935,1,18,83,0,83,1935-1-18,-83
1935,1,19,27,0,27,1935-1-19,-27
1935,1,20,41,0,41,1935-1-20,-41
1935,1,21,9,0,9,1935-1-21,-9
1935,1,22,25,0,25,1935-1-22,-25
1935,1,23,109,50,59,1935-1-23,-9
1935,1,24,425,190,235,1935-1-24,-45
1935,1,25,681,198,483,1935-1-25,-285
1935,1,26,752,185,567,1935-1-26,-382
1935,1,27,657,193,464,1935-1-27,-271
1935,1,28,515,152,363,1935-1-28,-211
1935,1,29,152,152,0,1935-1-29,152
1935,1,30,139,139,0,1935-1-30,139
1935,1,31,157,152,5,1935-1-31,147
1935,2,1,161,161,0,1935-2-1,161
1935,2,2,150,150,0,1935-2-2,150
1935,2,3,137,137,0,1935-2-3,137
1935,2,4,118,118,0,1935-2-4,118
1935,2,5,114,114,0,1935-2-5,114
1935,2,6,417,102,315,1935-2-6,-213
1935,2,7,823,79,744,1935-2-7,-665
1935,2,8,1089,59,1030,1935-2-8,-971
1935,2,9,991,36,955,1935-2-9,-919
1935,2,10,669,42,627,1935-2-10,-585
1935,2,11,190,31,159,1935-2-11,-128
1935,2,12,30,11,19,1935-2-12,-8
1935,2,13,233,233,0,1935-2-13,233
1935,2,14,179,164,15,1935-2-14,149
1935,2,15,96,96,0,1935-2-15,96
1935,2,16,142,142,0,1935-2-16,142
1935,2,17,29,29,0,1935-2-17,29
1935,2,18,60,36,24,1935-2-18,12
1935,2,19,47,0,47,1935-2-19,-47
1935,2,20,134,82,52,1935-2-20,30
1935,2,21,93,48,45,1935-2-21,3
1935,2,22,49,21,28,1935-2-22,-7
1935,2,23,66,0,66,1935-2-23,-66
1935,2,24,91,0,91,1935-2-24,-91
1935,2,25,320,0,320,1935-2-25,-320
1935,2,26,286,0,286,1935-2-26,-286
1935,2,27,266,0,266,1935-2-27,-266
1935,2,28,190,0,190,1935-2-28,-190
1935,3,1,207,0,207,1935-3-1,-207
1935,3,2,195,0,195,1935-3-2,-195
1935,3,3,217,0,217,1935-3-3,-217
1935,3,4,133,0,133,1935-3-4,-133
1935,3,5,164,0,164,1935-3-5,-164
1935,3,6,160,0,160,1935-3-6,-160
1935,3,7,118,0,118,1935-3-7,-118
1935,3,8,177,0,177,1935-3-8,-177
1935,3,9,225,0,225,1935-3-9,-225
1935,3,10,210,20,190,1935-3-10,-170
1935,3,11,259,197,62,1935-3-11,135
1935,3,12,328,275,53,1935-3-12,222
1935,3,13,457,316,141,1935-3-13,175
1935,3,14,598,333,265,1935-3-14,68
1935,3,15,515,271,244,1935-3-15,27
1935,3,16,358,136,222,1935-3-16,-86
1935,3,17,286,159,127,1935-3-17,32
1935,3,18,267,188,79,1935-3-18,109
1935,3,19,369,344,25,1935-3-19,319
1935,3,20,307,213,94,1935-3-20,119
1935,3,21,390,297,93,1935-3-21,204
1935,3,22,107,12,95,1935-3-22,-83
1935,3,23,29,0,29,1935-3-23,-29
1935,3,24,6,0,6,1935-3-24,-6
1935,3,25,0,0,0,1935-3-25,0
1935,3,26,21,0,21,1935-3-26,-21
1935,3,27,2,0,2,1935-3-27,-2
1935,3,28,0,0,0,1935-3-28,0
1935,3,29,0,0,0,1935-3-29,0
1935,3,30,0,0,0,1935-3-30,0
1935,3,31,0,0,0,1935-3-31,0
1935,4,1,0,0,0,1935-4-1,0
1935,4,2,0,0,0,1935-4-2,0
1935,4,3,2,0,2,1935-4-3,-2
1935,4,4,5,0,5,1935-4-4,-5
1935,4,5,0,0,0,1935-4-5,0
1935,4,6,0,0,0,1935-4-6,0
1935,4,7,0,0,0,1935-4-7,0
1935,4,8,104,99,5,1935-4-8,94
1935,4,9,102,83,19,1935-4-9,64
1935,4,10,49,40,9,1935-4-10,31
1935,4,11,24,13,11,1935-4-11,2
1935,4,12,86,27,59,1935-4-12,-32
1935,4,13,222,26,196,1935-4-13,-170
1935,4,14,350,21,329,1935-4-14,-308
1935,4,15,460,53,407,1935-4-15,-354
1935,4,16,337,2,335,1935-4-16,-333
1935,4,17,320,9,311,1935-4-17,-302
1935,4,18,299,7,292,1935-4-18,-285
1935,4,19,248,0,248,1935-4-19,-248
1935,4,20,264,0,264,1935-4-20,-264
1935,4,21,224,0,224,1935-4-21,-224
1935,4,22,224,0,224,1935-4-22,-224
1935,4,23,22,0,22,1935-4-23,-22
1935,4,24,21,0,21,1935-4-24,-21
1935,4,25,7,0,7,1935-4-25,-7
1935,4,26,0,0,0,1935-4-26,0
1935,4,27,0,0,0,1935-4-27,0
1935,4,28,0,0,0,1935-4-28,0
1935,4,29,219,170,49,1935-4-29,121
1935,4,30,198,166,32,1935-4-30,134
1935,5,1,195,170,25,1935-5-1,145
1935,5,2,212,160,52,1935-5-2,108
1935,5,3,343,162,181,1935-5-3,-19
1935,5,4,489,147,342,1935-5-4,-195
1935,5,5,891,154,737,1935-5-5,-583
1935,5,6,935,137,798,1935-5-6,-661
1935,5,7,787,41,746,1935-5-7,-705
1935,5,8,962,36,926,1935-5-8,-890
1935,5,9,968,15,953,1935-5-9,-938
1935,5,10,963,0,963,1935-5-10,-963
1935,5,11,729,24,705,1935-5-11,-681
1935,5,12,514,33,481,1935-5-12,-448
1935,5,13,463,18,445,1935-5-13,-427
1935,5,14,368,20,348,1935-5-14,-328
1935,5,15,357,8,349,1935-5-15,-341
1935,5,16,305,8,297,1935-5-16,-289
1935,5,17,224,0,224,1935-5-17,-224
1935,5,18,0,0,0,1935-5-18,0
1935,5,19,0,0,0,1935-5-19,0
1935,5,20,0,0,0,1935-5-20,0
1935,5,21,0,0,0,1935-5-21,0
1935,5,22,0,0,0,1935-5-22,0
1935,5,23,0,0,0,1935-5-23,0
1935,5,24,41,17,24,1935-5-24,-7
1935,5,25,7,0,7,1935-5-25,-7
1935,5,26,0,0,0,1935-5-26,0
1935,5,27,181,7,174,1935-5-27,-167
1935,5,28,261,31,230,1935-5-28,-199
1935,5,29,304,79,225,1935-5-29,-146
1935,5,30,426,255,171,1935-5-30,84
1935,5,31,291,121,170,1935-5-31,-49
1935,6,1,483,130,353,1935-6-1,-223
1935,6,2,622,96,526,1935-6-2,-430
1935,6,3,732,41,691,1935-6-3,-650
1935,6,4,733,7,726,1935-6-4,-719
1935,6,5,656,114,542,1935-6-5,-428
1935,6,6,645,185,460,1935-6-6,-275
1935,6,7,669,151,518,1935-6-7,-367
1935,6,8,720,169,551,1935-6-8,-382
1935,6,9,646,137,509,1935-6-9,-372
1935,6,10,613,88,525,1935-6-10,-437
1935,6,11,517,122,395,1935-6-11,-273
1935,6,12,473,178,295,1935-6-12,-117
1935,6,13,432,289,143,1935-6-13,146
1935,6,14,230,164,66,1935-6-14,98
1935,6,15,483,223,260,1935-6-15,-37
1935,6,16,558,229,329,1935-6-16,-100
1935,6,17,459,196,263,1935-6-17,-67
1935,6,18,471,41,430,1935-6-18,-389
1935,6,19,539,35,504,1935-6-19,-469
1935,6,20,548,80,468,1935-6-20,-388
1935,6,21,383,26,357,1935-6-21,-331
1935,6,22,282,18,264,1935-6-22,-246
1935,6,23,617,173,444,1935-6-23,-271
1935,6,24,779,0,779,1935-6-24,-779
1935,6,25,956,0,956,1935-6-25,-956
1935,6,26,1073,0,1073,1935-6-26,-1073
1935,6,27,1388,0,1388,1935-6-27,-1388
1935,6,28,1349,0,1349,1935-6-28,-1349
1935,6,29,1324,0,1324,1935-6-29,-1324
1935,6,30,1327,0,1327,1935-6-30,-1327
1935,7,1,1135,0,1135,1935-7-1,-1135
1935,7,2,1084,0,1084,1935-7-2,-1084
1935,7,3,939,120,819,1935-7-3,-699
1935,7,4,795,112,683,1935-7-4,-571
1935,7,5,880,100,780,1935-7-5,-680
1935,7,6,709,98,611,1935-7-6,-513
1935,7,7,449,95,354,1935-7-7,-259
1935,7,8,688,136,552,1935-7-8,-416
1935,7,9,556,103,453,1935-7-9,-350
1935,7,10,544,133,411,1935-7-10,-278
1935,7,11,502,89,413,1935-7-11,-324
1935,7,12,604,81,523,1935-7-12,-442
1935,7,13,646,30,616,1935-7-13,-586
1935,7,14,805,28,777,1935-7-14,-749
1935,7,15,863,0,863,1935-7-15,-863
1935,7,16,681,0,681,1935-7-16,-681
1935,7,17,499,0,499,1935-7-17,-499
1935,7,18,479,0,479,1935-7-18,-479
1935,7,19,558,78,480,1935-7-19,-402
1935,7,20,759,322,437,1935-7-20,-115
1935,7,21,709,392,317,1935-7-21,75
1935,7,22,500,352,148,1935-7-22,204
1935,7,23,442,403,39,1935-7-23,364
1935,7,24,434,431,3,1935-7-24,428
1935,7,25,358,355,3,1935-7-25,352
1935,7,26,360,355,5,1935-7-26,350
1935,7,27,337,334,3,1935-7-27,331
1935,7,28,258,258,0,1935-7-28,258
1935,7,29,0,0,0,1935-7-29,0
1935,7,30,10,0,10,1935-7-30,-10
1935,7,31,142,0,142,1935-7-31,-142
1935,8,1,109,0,109,1935-8-1,-109
1935,8,2,82,0,82,1935-8-2,-82
1935,8,3,115,0,115,1935-8-3,-115
1935,8,4,211,0,211,1935-8-4,-211
1935,8,5,218,0,218,1935-8-5,-218
1935,8,6,232,65,167,1935-8-6,-102
1935,8,7,324,42,282,1935-8-7,-240
1935,8,8,323,35,288,1935-8-8,-253
1935,8,9,233,0,233,1935-8-9,-233
1935,8,10,204,0,204,1935-8-10,-204
1935,8,11,209,0,209,1935-8-11,-209
1935,8,12,207,13,194,1935-8-12,-181
1935,8,13,168,15,153,1935-8-13,-138
1935,8,14,332,175,157,1935-8-14,18
1935,8,15,236,134,102,1935-8-15,32
1935,8,16,295,191,104,1935-8-16,87
1935,8,17,263,218,45,1935-8-17,173
1935,8,18,325,164,161,1935-8-18,3
1935,8,19,430,159,271,1935-8-19,-112
1935,8,20,758,392,366,1935-8-20,26
1935,8,21,1028,749,279,1935-8-21,470
1935,8,22,909,909,0,1935-8-22,909
1935,8,23,932,932,0,1935-8-23,932
1935,8,24,1208,1205,3,1935-8-24,1202
1935,8,25,1072,1072,0,1935-8-25,1072
1935,8,26,694,685,9,1935-8-26,676
1935,8,27,326,326,0,1935-8-27,326
1935,8,28,402,348,54,1935-8-28,294
1935,8,29,756,594,162,1935-8-29,432
1935,8,30,617,617,0,1935-8-30,617
1935,8,31,563,556,7,1935-8-31,549
1935,9,1,477,477,0,1935-9-1,477
1935,9,2,492,472,20,1935-9-2,452
1935,9,3,528,505,23,1935-9-3,482
1935,9,4,542,526,16,1935-9-4,510
1935,9,5,515,515,0,1935-9-5,515
1935,9,6,612,612,0,1935-9-6,612
1935,9,7,622,622,0,1935-9-7,622
1935,9,8,705,512,193,1935-9-8,319
1935,9,9,946,548,398,1935-9-9,150
1935,9,10,860,431,429,1935-9-10,2
1935,9,11,599,83,516,1935-9-11,-433
1935,9,12,77,77,0,1935-9-12,77
1935,9,13,58,58,0,1935-9-13,58
1935,9,14,121,91,30,1935-9-14,61
1935,9,15,184,101,83,1935-9-15,18
1935,9,16,242,142,100,1935-9-16,42
1935,9,17,338,183,155,1935-9-17,28
1935,9,18,389,307,82,1935-9-18,225
1935,9,19,361,278,83,1935-9-19,195
1935,9,20,232,218,14,1935-9-20,204
1935,9,21,174,157,17,1935-9-21,140
1935,9,22,206,206,0,1935-9-22,206
1935,9,23,331,331,0,1935-9-23,331
1935,9,24,872,867,5,1935-9-24,862
1935,9,25,966,840,126,1935-9-25,714
1935,9,26,1292,775,517,1935-9-26,258
1935,9,27,1444,945,499,1935-9-27,446
1935,9,28,1207,845,362,1935-9-28,483
1935,9,29,564,268,296,1935-9-29,-28
1935,9,30,385,103,282,1935-9-30,-179
1935,10,1,611,104,507,1935-10-1,-403
1935,10,2,890,163,727,1935-10-2,-564
1935,10,3,676,92,584,1935-10-3,-492
1935,10,4,662,207,455,1935-10-4,-248
1935,10,5,565,170,395,1935-10-5,-225
1935,10,6,435,86,349,1935-10-6,-263
1935,10,7,322,51,271,1935-10-7,-220
1935,10,8,297,21,276,1935-10-8,-255
1935,10,9,14,0,14,1935-10-9,-14
1935,10,10,88,60,28,1935-10-10,32
1935,10,11,288,173,115,1935-10-11,58
1935,10,12,345,165,180,1935-10-12,-15
1935,10,13,401,326,75,1935-10-13,251
1935,10,14,511,423,88,1935-10-14,335
1935,10,15,608,526,82,1935-10-15,444
1935,10,16,663,631,32,1935-10-16,599
1935,10,17,827,752,75,1935-10-17,677
1935,10,18,1207,1017,190,1935-10-18,827
1935,10,19,1502,1269,233,1935-10-19,1036
1935,10,20,1442,1231,211,1935-10-20,1020
1935,10,21,1126,953,173,1935-10-21,780
1935,10,22,1309,1287,22,1935-10-22,1265
1935,10,23,1341,1341,0,1935-10-23,1341
1935,10,24,1457,1442,15,1935-10-24,1427
1935,10,25,1581,1570,11,1935-10-25,1559
1935,10,26,1110,1107,3,1935-10-26,1104
1935,10,27,785,785,0,1935-10-27,785
1935,10,28,671,671,0,1935-10-28,671
1935,10,29,500,500,0,1935-10-29,500
1935,10,30,423,423,0,1935-10-30,423
1935,10,31,327,327,0,1935-10-31,327
1935,11,1,403,376,27,1935-11-1,349
1935,11,2,187,0,187,1935-11-2,-187
1935,11,3,1037,38,999,1935-11-3,-961
1935,11,4,1810,133,1677,1935-11-4,-1544
1935,11,5,1640,158,1482,1935-11-5,-1324
1935,11,6,1588,230,1358,1935-11-6,-1128
1935,11,7,1702,484,1218,1935-11-7,-734
1935,11,8,2098,939,1159,1935-11-8,-220
1935,11,9,1889,855,1034,1935-11-9,-179
1935,11,10,1732,941,791,1935-11-10,150
1935,11,11,1762,1097,665,1935-11-11,432
1935,11,12,1562,927,635,1935-11-12,292
1935,11,13,1821,990,831,1935-11-13,159
1935,11,14,1688,897,791,1935-11-14,106
1935,11,15,1685,777,908,1935-11-15,-131
1935,11,16,1961,1032,929,1935-11-16,103
1935,11,17,2196,1181,1015,1935-11-17,166
1935,11,18,2184,1276,908,1935-11-18,368
1935,11,19,1421,940,481,1935-11-19,459
1935,11,20,1617,706,911,1935-11-20,-205
1935,11,21,1698,749,949,1935-11-21,-200
1935,11,22,1384,546,838,1935-11-22,-292
1935,11,23,1305,298,1007,1935-11-23,-709
1935,11,24,1189,46,1143,1935-11-24,-1097
1935,11,25,949,0,949,1935-11-25,-949
1935,11,26,1176,0,1176,1935-11-26,-1176
1935,11,27,1483,0,1483,1935-11-27,-1483
1935,11,28,1599,0,1599,1935-11-28,-1599
1935,11,29,1860,0,1860,1935-11-29,-1860
1935,11,30,2088,0,2088,1935-11-30,-2088
1935,12,1,2356,0,2356,1935-12-1,-2356
1935,12,2,2562,31,2531,1935-12-2,-2500
1935,12,3,2365,0,2365,1935-12-3,-2365
1935,12,4,2724,7,2717,1935-12-4,-2710
1935,12,5,2832,5,2827,1935-12-5,-2822
1935,12,6,3034,0,3034,1935-12-6,-3034
1935,12,7,3298,0,3298,1935-12-7,-3298
1935,12,8,3067,42,3025,1935-12-8,-2983
1935,12,9,1472,57,1415,1935-12-9,-1358
1935,12,10,1570,20,1550,1935-12-10,-1530
1935,12,11,1664,23,1641,1935-12-11,-1618
1935,12,12,1650,65,1585,1935-12-12,-1520
1935,12,13,2072,58,2014,1935-12-13,-1956
1935,12,14,1383,0,1383,1935-12-14,-1383
1935,12,15,1326,104,1222,1935-12-15,-1118
1935,12,16,1268,114,1154,1935-12-16,-1040
1935,12,17,1254,42,1212,1935-12-17,-1170
1935,12,18,1102,14,1088,1935-12-18,-1074
1935,12,19,684,0,684,1935-12-19,-684
1935,12,20,472,0,472,1935-12-20,-472
1935,12,21,797,340,457,1935-12-21,-117
1935,12,22,734,288,446,1935-12-22,-158
1935,12,23,1013,271,742,1935-12-23,-471
1935,12,24,1358,202,1156,1935-12-24,-954
1935,12,25,1734,243,1491,1935-12-25,-1248
1935,12,26,1658,273,1385,1935-12-26,-1112
1935,12,27,1533,170,1363,1935-12-27,-1193
1935,12,28,1120,275,845,1935-12-28,-570
1935,12,29,1145,267,878,1935-12-29,-611
1935,12,30,1088,254,834,1935-12-30,-580
1935,12,31,1186,266,920,1935-12-31,-654
1936,1,1,1527,482,1045,1936-1-1,-563
1936,1,2,2039,925,1114,1936-1-2,-189
1936,1,3,2022,969,1053,1936-1-3,-84
1936,1,4,2103,1083,1020,1936-1-4,63
1936,1,5,2195,1151,1044,1936-1-5,107
1936,1,6,2021,1119,902,1936-1-6,217
1936,1,7,1649,1110,539,1936-1-7,571
1936,1,8,1505,915,590,1936-1-8,325
1936,1,9,1567,779,788,1936-1-9,-9
1936,1,10,791,601,190,1936-1-10,411
1936,1,11,946,554,392,1936-1-11,162
1936,1,12,1078,405,673,1936-1-12,-268
1936,1,13,1022,320,702,1936-1-13,-382
1936,1,14,1217,359,858,1936-1-14,-499
1936,1,15,1281,0,1281,1936-1-15,-1281
1936,1,16,1638,0,1638,1936-1-16,-1638
1936,1,17,1880,0,1880,1936-1-17,-1880
1936,1,18,1836,0,1836,1936-1-18,-1836
1936,1,19,1945,0,1945,1936-1-19,-1945
1936,1,20,2103,8,2095,1936-1-20,-2087
1936,1,21,2696,415,2281,1936-1-21,-1866
1936,1,22,2973,705,2268,1936-1-22,-1563
1936,1,23,3097,984,2113,1936-1-23,-1129
1936,1,24,3263,919,2344,1936-1-24,-1425
1936,1,25,2156,686,1470,1936-1-25,-784
1936,1,26,1382,637,745,1936-1-26,-108
1936,1,27,766,542,224,1936-1-27,318
1936,1,28,604,429,175,1936-1-28,254
1936,1,29,538,353,185,1936-1-29,168
1936,1,30,433,297,136,1936-1-30,161
1936,1,31,795,654,141,1936-1-31,513
1936,2,1,690,553,137,1936-2-1,416
1936,2,2,566,432,134,1936-2-2,298
1936,2,3,480,338,142,1936-2-3,196
1936,2,4,656,452,204,1936-2-4,248
1936,2,5,767,498,269,1936-2-5,229
1936,2,6,813,536,277,1936-2-6,259
1936,2,7,1240,508,732,1936-2-7,-224
1936,2,8,2378,987,1391,1936-2-8,-404
1936,2,9,2234,1155,1079,1936-2-9,76
1936,2,10,1629,382,1247,1936-2-10,-865
1936,2,11,1436,194,1242,1936-2-11,-1048
1936,2,12,1283,6,1277,1936-2-12,-1271
1936,2,13,1100,6,1094,1936-2-13,-1088
1936,2,14,1080,65,1015,1936-2-14,-950
1936,2,15,1174,201,973,1936-2-15,-772
1936,2,16,1381,188,1193,1936-2-16,-1005
1936,2,17,1130,205,925,1936-2-17,-720
1936,2,18,1233,304,929,1936-2-18,-625
1936,2,19,1111,301,810,1936-2-19,-509
1936,2,20,909,264,645,1936-2-20,-381
1936,2,21,1187,329,858,1936-2-21,-529
1936,2,22,1618,242,1376,1936-2-22,-1134
1936,2,23,1526,201,1325,1936-2-23,-1124
1936,2,24,1385,546,839,1936-2-24,-293
1936,2,25,1569,764,805,1936-2-25,-41
1936,2,26,1519,658,861,1936-2-26,-203
1936,2,27,1432,589,843,1936-2-27,-254
1936,2,28,1237,645,592,1936-2-28,53
1936,2,29,810,344,466,1936-2-29,-122
1936,3,1,742,445,297,1936-3-1,148
1936,3,2,741,477,264,1936-3-2,213
1936,3,3,641,471,170,1936-3-3,301
1936,3,4,672,439,233,1936-3-4,206
1936,3,5,503,400,103,1936-3-5,297
1936,3,6,892,717,175,1936-3-6,542
1936,3,7,986,705,281,1936-3-7,424
1936,3,8,1462,882,580,1936-3-8,302
1936,3,9,1387,763,624,1936-3-9,139
1936,3,10,1998,917,1081,1936-3-10,-164
1936,3,11,1941,533,1408,1936-3-11,-875
1936,3,12,1402,310,1092,1936-3-12,-782
1936,3,13,931,109,822,1936-3-13,-713
1936,3,14,817,120,697,1936-3-14,-577
1936,3,15,782,135,647,1936-3-15,-512
1936,3,16,776,132,644,1936-3-16,-512
1936,3,17,684,72,612,1936-3-17,-540
1936,3,18,881,19,862,1936-3-18,-843
1936,3,19,1246,0,1246,1936-3-19,-1246
1936,3,20,1629,70,1559,1936-3-20,-1489
1936,3,21,1897,169,1728,1936-3-21,-1559
1936,3,22,1725,171,1554,1936-3-22,-1383
1936,3,23,977,103,874,1936-3-23,-771
1936,3,24,713,41,672,1936-3-24,-631
1936,3,25,364,52,312,1936-3-25,-260
1936,3,26,904,17,887,1936-3-26,-870
1936,3,27,1419,7,1412,1936-3-27,-1405
1936,3,28,1600,0,1600,1936-3-28,-1600
1936,3,29,1538,0,1538,1936-3-29,-1538
1936,3,30,1316,17,1299,1936-3-30,-1282
1936,3,31,1402,166,1236,1936-3-31,-1070
1936,4,1,1295,261,1034,1936-4-1,-773
1936,4,2,1222,347,875,1936-4-2,-528
1936,4,3,1035,393,642,1936-4-3,-249
1936,4,4,932,345,587,1936-4-4,-242
1936,4,5,848,386,462,1936-4-5,-76
1936,4,6,1361,861,500,1936-4-6,361
1936,4,7,1640,1307,333,1936-4-7,974
1936,4,8,1662,1188,474,1936-4-8,714
1936,4,9,1761,1245,516,1936-4-9,729
1936,4,10,1511,1133,378,1936-4-10,755
1936,4,11,1581,1212,369,1936-4-11,843
1936,4,12,1513,1156,357,1936-4-12,799
1936,4,13,1115,797,318,1936-4-13,479
1936,4,14,954,593,361,1936-4-14,232
1936,4,15,790,296,494,1936-4-15,-198
1936,4,16,1103,212,891,1936-4-16,-679
1936,4,17,1200,169,1031,1936-4-17,-862
1936,4,18,1067,49,1018,1936-4-18,-969
1936,4,19,1242,35,1207,1936-4-19,-1172
1936,4,20,865,27,838,1936-4-20,-811
1936,4,21,963,10,953,1936-4-21,-943
1936,4,22,849,0,849,1936-4-22,-849
1936,4,23,837,100,737,1936-4-23,-637
1936,4,24,812,165,647,1936-4-24,-482
1936,4,25,748,124,624,1936-4-25,-500
1936,4,26,726,61,665,1936-4-26,-604
1936,4,27,770,62,708,1936-4-27,-646
1936,4,28,619,45,574,1936-4-28,-529
1936,4,29,235,24,211,1936-4-29,-187
1936,4,30,81,31,50,1936-4-30,-19
1936,5,1,168,86,82,1936-5-1,4
1936,5,2,111,69,42,1936-5-2,27
1936,5,3,88,62,26,1936-5-3,36
1936,5,4,237,206,31,1936-5-4,175
1936,5,5,195,162,33,1936-5-5,129
1936,5,6,219,186,33,1936-5-6,153
1936,5,7,252,78,174,1936-5-7,-96
1936,5,8,373,141,232,1936-5-8,-91
1936,5,9,395,170,225,1936-5-9,-55
1936,5,10,665,54,611,1936-5-10,-557
1936,5,11,872,53,819,1936-5-11,-766
1936,5,12,904,37,867,1936-5-12,-830
1936,5,13,950,32,918,1936-5-13,-886
1936,5,14,959,14,945,1936-5-14,-931
1936,5,15,1042,102,940,1936-5-15,-838
1936,5,16,850,107,743,1936-5-16,-636
1936,5,17,698,88,610,1936-5-17,-522
1936,5,18,571,90,481,1936-5-18,-391
1936,5,19,423,28,395,1936-5-19,-367
1936,5,20,339,0,339,1936-5-20,-339
1936,5,21,296,0,296,1936-5-21,-296
1936,5,22,371,29,342,1936-5-22,-313
1936,5,23,359,9,350,1936-5-23,-341
1936,5,24,464,199,265,1936-5-24,-66
1936,5,25,797,467,330,1936-5-25,137
1936,5,26,728,346,382,1936-5-26,-36
1936,5,27,590,276,314,1936-5-27,-38
1936,5,28,880,368,512,1936-5-28,-144
1936,5,29,902,70,832,1936-5-29,-762
1936,5,30,861,64,797,1936-5-30,-733
1936,5,31,987,66,921,1936-5-31,-855
1936,6,1,927,94,833,1936-6-1,-739
1936,6,2,921,108,813,1936-6-2,-705
1936,6,3,795,40,755,1936-6-3,-715
1936,6,4,808,5,803,1936-6-4,-798
1936,6,5,763,117,646,1936-6-5,-529
1936,6,6,652,182,470,1936-6-6,-288
1936,6,7,578,155,423,1936-6-7,-268
1936,6,8,1157,134,1023,1936-6-8,-889
1936,6,9,1001,120,881,1936-6-9,-761
1936,6,10,289,41,248,1936-6-10,-207
1936,6,11,204,0,204,1936-6-11,-204
1936,6,12,202,16,186,1936-6-12,-170
1936,6,13,129,46,83,1936-6-13,-37
1936,6,14,146,75,71,1936-6-14,4
1936,6,15,250,226,24,1936-6-15,202
1936,6,16,1293,1229,64,1936-6-16,1165
1936,6,17,989,989,0,1936-6-17,989
1936,6,18,1007,1007,0,1936-6-18,1007
1936,6,19,981,981,0,1936-6-19,981
1936,6,20,826,826,0,1936-6-20,826
1936,6,21,831,690,141,1936-6-21,549
1936,6,22,815,489,326,1936-6-22,163
1936,6,23,802,386,416,1936-6-23,-30
1936,6,24,974,443,531,1936-6-24,-88
1936,6,25,1242,576,666,1936-6-25,-90
1936,6,26,966,712,254,1936-6-26,458
1936,6,27,1166,919,247,1936-6-27,672
1936,6,28,989,793,196,1936-6-28,597
1936,6,29,1191,832,359,1936-6-29,473
1936,6,30,1233,857,376,1936-6-30,481
1936,7,1,1349,1138,211,1936-7-1,927
1936,7,2,1255,1078,177,1936-7-2,901
1936,7,3,419,324,95,1936-7-3,229
1936,7,4,386,374,12,1936-7-4,362
1936,7,5,424,348,76,1936-7-5,272
1936,7,6,386,29,357,1936-7-6,-328
1936,7,7,422,30,392,1936-7-7,-362
1936,7,8,704,162,542,1936-7-8,-380
1936,7,9,851,355,496,1936-7-9,-141
1936,7,10,1052,457,595,1936-7-10,-138
1936,7,11,760,614,146,1936-7-11,468
1936,7,12,542,435,107,1936-7-12,328
1936,7,13,614,511,103,1936-7-13,408
1936,7,14,672,570,102,1936-7-14,468
1936,7,15,775,732,43,1936-7-15,689
1936,7,16,1023,774,249,1936-7-16,525
1936,7,17,943,716,227,1936-7-17,489
1936,7,18,688,476,212,1936-7-18,264
1936,7,19,497,271,226,1936-7-19,45
1936,7,20,562,340,222,1936-7-20,118
1936,7,21,280,91,189,1936-7-21,-98
1936,7,22,278,104,174,1936-7-22,-70
1936,7,23,301,134,167,1936-7-23,-33
1936,7,24,292,147,145,1936-7-24,2
1936,7,25,275,139,136,1936-7-25,3
1936,7,26,421,287,134,1936-7-26,153
1936,7,27,373,254,119,1936-7-27,135
1936,7,28,389,153,236,1936-7-28,-83
1936,7,29,741,187,554,1936-7-29,-367
1936,7,30,726,308,418,1936-7-30,-110
1936,7,31,1092,569,523,1936-7-31,46
1936,8,1,1028,466,562,1936-8-1,-96
1936,8,2,899,411,488,1936-8-2,-77
1936,8,3,957,318,639,1936-8-3,-321
1936,8,4,1079,466,613,1936-8-4,-147
1936,8,5,1368,567,801,1936-8-5,-234
1936,8,6,1370,570,800,1936-8-6,-230
1936,8,7,889,340,549,1936-8-7,-209
1936,8,8,799,252,547,1936-8-8,-295
1936,8,9,1022,392,630,1936-8-9,-238
1936,8,10,901,346,555,1936-8-10,-209
1936,8,11,855,303,552,1936-8-11,-249
1936,8,12,751,315,436,1936-8-12,-121
1936,8,13,682,379,303,1936-8-13,76
1936,8,14,648,381,267,1936-8-14,114
1936,8,15,967,757,210,1936-8-15,547
1936,8,16,1025,867,158,1936-8-16,709
1936,8,17,948,857,91,1936-8-17,766
1936,8,18,836,786,50,1936-8-18,736
1936,8,19,937,929,8,1936-8-19,921
1936,8,20,665,646,19,1936-8-20,627
1936,8,21,621,597,24,1936-8-21,573
1936,8,22,638,556,82,1936-8-22,474
1936,8,23,864,568,296,1936-8-23,272
1936,8,24,633,441,192,1936-8-24,249
1936,8,25,933,320,613,1936-8-25,-293
1936,8,26,905,334,571,1936-8-26,-237
1936,8,27,1003,193,810,1936-8-27,-617
1936,8,28,1250,65,1185,1936-8-28,-1120
1936,8,29,1343,56,1287,1936-8-29,-1231
1936,8,30,1302,99,1203,1936-8-30,-1104
1936,8,31,1395,73,1322,1936-8-31,-1249
1936,9,1,833,38,795,1936-9-1,-757
1936,9,2,692,41,651,1936-9-2,-610
1936,9,3,727,71,656,1936-9-3,-585
1936,9,4,603,25,578,1936-9-4,-553
1936,9,5,839,54,785,1936-9-5,-731
1936,9,6,505,175,330,1936-9-6,-155
1936,9,7,440,216,224,1936-9-7,-8
1936,9,8,407,201,206,1936-9-8,-5
1936,9,9,486,243,243,1936-9-9,0
1936,9,10,953,421,532,1936-9-10,-111
1936,9,11,1149,476,673,1936-9-11,-197
1936,9,12,1359,549,810,1936-9-12,-261
1936,9,13,915,103,812,1936-9-13,-709
1936,9,14,1180,126,1054,1936-9-14,-928
1936,9,15,975,225,750,1936-9-15,-525
1936,9,16,778,237,541,1936-9-16,-304
1936,9,17,607,141,466,1936-9-17,-325
1936,9,18,596,118,478,1936-9-18,-360
1936,9,19,627,82,545,1936-9-19,-463
1936,9,20,758,114,644,1936-9-20,-530
1936,9,21,1051,46,1005,1936-9-21,-959
1936,9,22,1250,86,1164,1936-9-22,-1078
1936,9,23,1216,98,1118,1936-9-23,-1020
1936,9,24,1070,60,1010,1936-9-24,-950
1936,9,25,899,17,882,1936-9-25,-865
1936,9,26,710,24,686,1936-9-26,-662
1936,9,27,1309,842,467,1936-9-27,375
1936,9,28,1725,1301,424,1936-9-28,877
1936,9,29,1425,982,443,1936-9-29,539
1936,9,30,1639,1306,333,1936-9-30,973
1936,10,1,1206,998,208,1936-10-1,790
1936,10,2,1256,991,265,1936-10-2,726
1936,10,3,1288,1049,239,1936-10-3,810
1936,10,4,1301,1159,142,1936-10-4,1017
1936,10,5,1840,1195,645,1936-10-5,550
1936,10,6,2027,1207,820,1936-10-6,387
1936,10,7,1872,1049,823,1936-10-7,226
1936,10,8,1608,807,801,1936-10-8,6
1936,10,9,1420,724,696,1936-10-9,28
1936,10,10,1247,671,576,1936-10-10,95
1936,10,11,1885,920,965,1936-10-11,-45
1936,10,12,1235,485,750,1936-10-12,-265
1936,10,13,836,67,769,1936-10-13,-702
1936,10,14,983,76,907,1936-10-14,-831
1936,10,15,1112,128,984,1936-10-15,-856
1936,10,16,1165,134,1031,1936-10-16,-897
1936,10,17,1204,250,954,1936-10-17,-704
1936,10,18,591,173,418,1936-10-18,-245
1936,10,19,573,137,436,1936-10-19,-299
1936,10,20,710,237,473,1936-10-20,-236
1936,10,21,848,471,377,1936-10-21,94
1936,10,22,716,450,266,1936-10-22,184
1936,10,23,595,412,183,1936-10-23,229
1936,10,24,519,392,127,1936-10-24,265
1936,10,25,401,377,24,1936-10-25,353
1936,10,26,411,244,167,1936-10-26,77
1936,10,27,815,604,211,1936-10-27,393
1936,10,28,912,648,264,1936-10-28,384
1936,10,29,940,673,267,1936-10-29,406
1936,10,30,1009,545,464,1936-10-30,81
1936,10,31,1103,698,405,1936-10-31,293
1936,11,1,1129,554,575,1936-11-1,-21
1936,11,2,987,329,658,1936-11-2,-329
1936,11,3,1053,348,705,1936-11-3,-357
1936,11,4,1220,476,744,1936-11-4,-268
1936,11,5,1478,824,654,1936-11-5,170
1936,11,6,1835,950,885,1936-11-6,65
1936,11,7,1761,829,932,1936-11-7,-103
1936,11,8,2138,774,1364,1936-11-8,-590
1936,11,9,2364,697,1667,1936-11-9,-970
1936,11,10,2214,645,1569,1936-11-10,-924
1936,11,11,2358,579,1779,1936-11-11,-1200
1936,11,12,2360,497,1863,1936-11-12,-1366
1936,11,13,2413,568,1845,1936-11-13,-1277
1936,11,14,1792,438,1354,1936-11-14,-916
1936,11,15,1638,482,1156,1936-11-15,-674
1936,11,16,1356,332,1024,1936-11-16,-692
1936,11,17,1184,108,1076,1936-11-17,-968
1936,11,18,1019,6,1013,1936-11-18,-1007
1936,11,19,873,0,873,1936-11-19,-873
1936,11,20,895,4,891,1936-11-20,-887
1936,11,21,649,0,649,1936-11-21,-649
1936,11,22,638,0,638,1936-11-22,-638
1936,11,23,1311,320,991,1936-11-23,-671
1936,11,24,1519,276,1243,1936-11-24,-967
1936,11,25,1559,390,1169,1936-11-25,-779
1936,11,26,3081,960,2121,1936-11-26,-1161
1936,11,27,4174,1543,2631,1936-11-27,-1088
1936,11,28,4773,1847,2926,1936-11-28,-1079
1936,11,29,4116,1897,2219,1936-11-29,-322
1936,11,30,4256,2045,2211,1936-11-30,-166
1936,12,1,4302,2109,2193,1936-12-1,-84
1936,12,2,4053,2139,1914,1936-12-2,225
1936,12,3,3697,2028,1669,1936-12-3,359
1936,12,4,3187,1781,1406,1936-12-4,375
1936,12,5,2336,1459,877,1936-12-5,582
1936,12,6,2346,1564,782,1936-12-6,782
1936,12,7,2293,1610,683,1936-12-7,927
1936,12,8,1974,1534,440,1936-12-8,1094
1936,12,9,1447,1240,207,1936-12-9,1033
1936,12,10,940,621,319,1936-12-10,302
1936,12,11,907,451,456,1936-12-11,-5
1936,12,12,990,373,617,1936-12-12,-244
1936,12,13,1148,352,796,1936-12-13,-444
1936,12,14,815,122,693,1936-12-14,-571
1936,12,15,806,13,793,1936-12-15,-780
1936,12,16,862,0,862,1936-12-16,-862
1936,12,17,579,0,579,1936-12-17,-579
1936,12,18,707,58,649,1936-12-18,-591
1936,12,19,1350,558,792,1936-12-19,-234
1936,12,20,1397,753,644,1936-12-20,109
1936,12,21,1336,786,550,1936-12-21,236
1936,12,22,1405,877,528,1936-12-22,349
1936,12,23,1467,992,475,1936-12-23,517
1936,12,24,1676,1254,422,1936-12-24,832
1936,12,25,1546,1085,461,1936-12-25,624
1936,12,26,1730,1278,452,1936-12-26,826
1936,12,27,1414,1208,206,1936-12-27,1002
1936,12,28,1658,1245,413,1936-12-28,832
1936,12,29,1705,1220,485,1936-12-29,735
1936,12,30,2238,1564,674,1936-12-30,890
1936,12,31,1795,1235,560,1936-12-31,675
1937,1,1,1742,1194,548,1937-1-1,646
1937,1,2,1878,1121,757,1937-1-2,364
1937,1,3,1402,690,712,1937-1-3,-22
1937,1,4,921,476,445,1937-1-4,31
1937,1,5,882,459,423,1937-1-5,36
1937,1,6,831,373,458,1937-1-6,-85
1937,1,7,1044,524,520,1937-1-7,4
1937,1,8,1341,541,800,1937-1-8,-259
1937,1,9,1306,227,1079,1937-1-9,-852
1937,1,10,1306,139,1167,1937-1-10,-1028
1937,1,11,1648,116,1532,1937-1-11,-1416
1937,1,12,1615,110,1505,1937-1-12,-1395
1937,1,13,1240,333,907,1937-1-13,-574
1937,1,14,1159,319,840,1937-1-14,-521
1937,1,15,1535,585,950,1937-1-15,-365
1937,1,16,1109,294,815,1937-1-16,-521
1937,1,17,1547,291,1256,1937-1-17,-965
1937,1,18,2185,197,1988,1937-1-18,-1791
1937,1,19,2226,214,2012,1937-1-19,-1798
1937,1,20,2253,220,2033,1937-1-20,-1813
1937,1,21,2393,338,2055,1937-1-21,-1717
1937,1,22,2595,698,1897,1937-1-22,-1199
1937,1,23,2488,1205,1283,1937-1-23,-78
1937,1,24,2237,1129,1108,1937-1-24,21
1937,1,25,2944,1297,1647,1937-1-25,-350
1937,1,26,3440,1542,1898,1937-1-26,-356
1937,1,27,4204,1702,2502,1937-1-27,-800
1937,1,28,4595,1786,2809,1937-1-28,-1023
1937,1,29,4738,1811,2927,1937-1-29,-1116
1937,1,30,5022,2064,2958,1937-1-30,-894
1937,1,31,6015,2650,3365,1937-1-31,-715
1937,2,1,5452,2014,3438,1937-2-1,-1424
1937,2,2,4370,1273,3097,1937-2-2,-1824
1937,2,3,4188,1016,3172,1937-2-3,-2156
1937,2,4,3760,818,2942,1937-2-4,-2124
1937,2,5,3763,617,3146,1937-2-5,-2529
1937,2,6,2308,259,2049,1937-2-6,-1790
1937,2,7,894,182,712,1937-2-7,-530
1937,2,8,486,136,350,1937-2-8,-214
1937,2,9,449,246,203,1937-2-9,43
1937,2,10,553,401,152,1937-2-10,249
1937,2,11,788,689,99,1937-2-11,590
1937,2,12,1129,1005,124,1937-2-12,881
1937,2,13,1383,1201,182,1937-2-13,1019
1937,2,14,1385,1290,95,1937-2-14,1195
1937,2,15,1395,1301,94,1937-2-15,1207
1937,2,16,1768,1718,50,1937-2-16,1668
1937,2,17,2058,1951,107,1937-2-17,1844
1937,2,18,2552,2539,13,1937-2-18,2526
1937,2,19,2515,2347,168,1937-2-19,2179
1937,2,20,3078,2692,386,1937-2-20,2306
1937,2,21,2855,2496,359,1937-2-21,2137
1937,2,22,2937,2314,623,1937-2-22,1691
1937,2,23,2745,2194,551,1937-2-23,1643
1937,2,24,3105,2562,543,1937-2-24,2019
1937,2,25,2939,2393,546,1937-2-25,1847
1937,2,26,2510,2003,507,1937-2-26,1496
1937,2,27,2241,1732,509,1937-2-27,1223
1937,2,28,2124,1590,534,1937-2-28,1056
1937,3,1,2185,1436,749,1937-3-1,687
1937,3,2,2002,1156,846,1937-3-2,310
1937,3,3,1386,966,420,1937-3-3,546
1937,3,4,1302,928,374,1937-3-4,554
1937,3,5,1386,1216,170,1937-3-5,1046
1937,3,6,1657,1507,150,1937-3-6,1357
1937,3,7,1918,1753,165,1937-3-7,1588
1937,3,8,1233,1067,166,1937-3-8,901
1937,3,9,1200,996,204,1937-3-9,792
1937,3,10,1314,979,335,1937-3-10,644
1937,3,11,1205,924,281,1937-3-11,643
1937,3,12,878,739,139,1937-3-12,600
1937,3,13,886,736,150,1937-3-13,586
1937,3,14,664,509,155,1937-3-14,354
1937,3,15,153,148,5,1937-3-15,143
1937,3,16,231,146,85,1937-3-16,61
1937,3,17,271,131,140,1937-3-17,-9
1937,3,18,228,109,119,1937-3-18,-10
1937,3,19,271,173,98,1937-3-19,75
1937,3,20,228,90,138,1937-3-20,-48
1937,3,21,487,351,136,1937-3-21,215
1937,3,22,523,257,266,1937-3-22,-9
1937,3,23,1219,930,289,1937-3-23,641
1937,3,24,1435,1183,252,1937-3-24,931
1937,3,25,1438,1241,197,1937-3-25,1044
1937,3,26,1628,1313,315,1937-3-26,998
1937,3,27,1535,1217,318,1937-3-27,899
1937,3,28,1635,1387,248,1937-3-28,1139
1937,3,29,1666,1437,229,1937-3-29,1208
1937,3,30,1644,1436,208,1937-3-30,1228
1937,3,31,1622,1413,209,1937-3-31,1204
1937,4,1,1596,1456,140,1937-4-1,1316
1937,4,2,1615,1517,98,1937-4-2,1419
1937,4,3,2216,1914,302,1937-4-3,1612
1937,4,4,2177,1739,438,1937-4-4,1301
1937,4,5,2282,1577,705,1937-4-5,872
1937,4,6,1360,706,654,1937-4-6,52
1937,4,7,948,207,741,1937-4-7,-534
1937,4,8,1045,257,788,1937-4-8,-531
1937,4,9,796,162,634,1937-4-9,-472
1937,4,10,721,193,528,1937-4-10,-335
1937,4,11,817,339,478,1937-4-11,-139
1937,4,12,584,275,309,1937-4-12,-34
1937,4,13,624,358,266,1937-4-13,92
1937,4,14,154,0,154,1937-4-14,-154
1937,4,15,204,41,163,1937-4-15,-122
1937,4,16,865,278,587,1937-4-16,-309
1937,4,17,787,312,475,1937-4-17,-163
1937,4,18,806,237,569,1937-4-18,-332
1937,4,19,1017,359,658,1937-4-19,-299
1937,4,20,1493,679,814,1937-4-20,-135
1937,4,21,2716,1779,937,1937-4-21,842
1937,4,22,3706,2961,745,1937-4-22,2216
1937,4,23,3806,3107,699,1937-4-23,2408
1937,4,24,3927,3282,645,1937-4-24,2637
1937,4,25,4717,4049,668,1937-4-25,3381
1937,4,26,5561,4539,1022,1937-4-26,3517
1937,4,27,6257,4681,1576,1937-4-27,3105
1937,4,28,6292,4425,1867,1937-4-28,2558
1937,4,29,5146,3850,1296,1937-4-29,2554
1937,4,30,3463,1974,1489,1937-4-30,485
1937,5,1,1975,784,1191,1937-5-1,-407
1937,5,2,1235,269,966,1937-5-2,-697
1937,5,3,1200,283,917,1937-5-3,-634
1937,5,4,1664,762,902,1937-5-4,-140
1937,5,5,1870,799,1071,1937-5-5,-272
1937,5,6,788,728,60,1937-5-6,668
1937,5,7,658,631,27,1937-5-7,604
1937,5,8,766,741,25,1937-5-8,716
1937,5,9,1252,1155,97,1937-5-9,1058
1937,5,10,1842,1461,381,1937-5-10,1080
1937,5,11,1606,1316,290,1937-5-11,1026
1937,5,12,1374,1170,204,1937-5-12,966
1937,5,13,1312,1147,165,1937-5-13,982
1937,5,14,1387,1089,298,1937-5-14,791
1937,5,15,2653,1538,1115,1937-5-15,423
1937,5,16,3433,2165,1268,1937-5-16,897
1937,5,17,3281,1569,1712,1937-5-17,-143
1937,5,18,3375,1565,1810,1937-5-18,-245
1937,5,19,3224,1378,1846,1937-5-19,-468
1937,5,20,3748,1394,2354,1937-5-20,-960
1937,5,21,4831,2599,2232,1937-5-21,367
1937,5,22,4426,2470,1956,1937-5-22,514
1937,5,23,4378,2497,1881,1937-5-23,616
1937,5,24,4530,2777,1753,1937-5-24,1024
1937,5,25,4124,2641,1483,1937-5-25,1158
1937,5,26,2596,1293,1303,1937-5-26,-10
1937,5,27,1542,981,561,1937-5-27,420
1937,5,28,1384,925,459,1937-5-28,466
1937,5,29,1523,1071,452,1937-5-29,619
1937,5,30,2266,1757,509,1937-5-30,1248
1937,5,31,2212,1818,394,1937-5-31,1424
1937,6,1,2565,2177,388,1937-6-1,1789
1937,6,2,1922,1906,16,1937-6-2,1890
1937,6,3,2158,2135,23,1937-6-3,2112
1937,6,4,2278,2112,166,1937-6-4,1946
1937,6,5,2118,1914,204,1937-6-5,1710
1937,6,6,1836,1473,363,1937-6-6,1110
1937,6,7,1968,1403,565,1937-6-7,838
1937,6,8,1448,1131,317,1937-6-8,814
1937,6,9,1728,1551,177,1937-6-9,1374
1937,6,10,3464,2168,1296,1937-6-10,872
1937,6,11,2842,1945,897,1937-6-11,1048
1937,6,12,2943,2043,900,1937-6-12,1143
1937,6,13,2881,1922,959,1937-6-13,963
1937,6,14,3355,1829,1526,1937-6-14,303
1937,6,15,3977,2397,1580,1937-6-15,817
1937,6,16,4073,2354,1719,1937-6-16,635
1937,6,17,4904,2390,2514,1937-6-17,-124
1937,6,18,4316,2087,2229,1937-6-18,-142
1937,6,19,4146,1847,2299,1937-6-19,-452
1937,6,20,4202,1884,2318,1937-6-20,-434
1937,6,21,4559,1930,2629,1937-6-21,-699
1937,6,22,4273,1372,2901,1937-6-22,-1529
1937,6,23,3281,1081,2200,1937-6-23,-1119
1937,6,24,2162,971,1191,1937-6-24,-220
1937,6,25,2003,683,1320,1937-6-25,-637
1937,6,26,1568,487,1081,1937-6-26,-594
1937,6,27,1540,448,1092,1937-6-27,-644
1937,6,28,1194,237,957,1937-6-28,-720
1937,6,29,847,87,760,1937-6-29,-673
1937,6,30,824,283,541,1937-6-30,-258
1937,7,1,798,370,428,1937-7-1,-58
1937,7,2,898,577,321,1937-7-2,256
1937,7,3,935,697,238,1937-7-3,459
1937,7,4,972,723,249,1937-7-4,474
1937,7,5,1376,798,578,1937-7-5,220
1937,7,6,1994,1191,803,1937-7-6,388
1937,7,7,2730,1704,1026,1937-7-7,678
1937,7,8,3980,2313,1667,1937-7-8,646
1937,7,9,4728,2628,2100,1937-7-9,528
1937,7,10,4620,2801,1819,1937-7-10,982
1937,7,11,4729,3028,1701,1937-7-11,1327
1937,7,12,4540,3183,1357,1937-7-12,1826
1937,7,13,4383,3169,1214,1937-7-13,1955
1937,7,14,5199,3575,1624,1937-7-14,1951
1937,7,15,4259,3128,1131,1937-7-15,1997
1937,7,16,3284,2027,1257,1937-7-16,770
1937,7,17,2754,1679,1075,1937-7-17,604
1937,7,18,2905,1775,1130,1937-7-18,645
1937,7,19,2733,1499,1234,1937-7-19,265
1937,7,20,2448,1096,1352,1937-7-20,-256
1937,7,21,2006,1007,999,1937-7-21,8
1937,7,22,2914,2085,829,1937-7-22,1256
1937,7,23,3109,2256,853,1937-7-23,1403
1937,7,24,3548,2772,776,1937-7-24,1996
1937,7,25,3560,2831,729,1937-7-25,2102
1937,7,26,4372,3661,711,1937-7-26,2950
1937,7,27,4957,3726,1231,1937-7-27,2495
1937,7,28,5110,3806,1304,1937-7-28,2502
1937,7,29,4829,3541,1288,1937-7-29,2253
1937,7,30,4548,3857,691,1937-7-30,3166
1937,7,31,5047,4437,610,1937-7-31,3827
1937,8,1,5117,4479,638,1937-8-1,3841
1937,8,2,5208,4337,871,1937-8-2,3466
1937,8,3,4645,3937,708,1937-8-3,3229
1937,8,4,3395,2431,964,1937-8-4,1467
1937,8,5,2919,1927,992,1937-8-5,935
1937,8,6,2054,1060,994,1937-8-6,66
1937,8,7,1950,786,1164,1937-8-7,-378
1937,8,8,1852,644,1208,1937-8-8,-564
1937,8,9,2125,592,1533,1937-8-9,-941
1937,8,10,2244,614,1630,1937-8-10,-1016
1937,8,11,2075,687,1388,1937-8-11,-701
1937,8,12,2005,732,1273,1937-8-12,-541
1937,8,13,2087,812,1275,1937-8-13,-463
1937,8,14,2334,1005,1329,1937-8-14,-324
1937,8,15,2572,1363,1209,1937-8-15,154
1937,8,16,2261,1340,921,1937-8-16,419
1937,8,17,1718,1223,495,1937-8-17,728
1937,8,18,1895,1505,390,1937-8-18,1115
1937,8,19,2695,2339,356,1937-8-19,1983
1937,8,20,2301,1609,692,1937-8-20,917
1937,8,21,1681,1213,468,1937-8-21,745
1937,8,22,1721,1269,452,1937-8-22,817
1937,8,23,2061,1413,648,1937-8-23,765
1937,8,24,2387,1479,908,1937-8-24,571
1937,8,25,2403,1326,1077,1937-8-25,249
1937,8,26,2343,1315,1028,1937-8-26,287
1937,8,27,2466,1766,700,1937-8-27,1066
1937,8,28,2475,1954,521,1937-8-28,1433
1937,8,29,2413,1927,486,1937-8-29,1441
1937,8,30,2196,1981,215,1937-8-30,1766
1937,8,31,2028,1973,55,1937-8-31,1918
1937,9,1,2072,1995,77,1937-9-1,1918
1937,9,2,1040,770,270,1937-9-2,500
1937,9,3,1276,988,288,1937-9-3,700
1937,9,4,1166,908,258,1937-9-4,650
1937,9,5,806,784,22,1937-9-5,762
1937,9,6,939,900,39,1937-9-6,861
1937,9,7,1056,1056,0,1937-9-7,1056
1937,9,8,1626,1622,4,1937-9-8,1618
1937,9,9,1548,1548,0,1937-9-9,1548
1937,9,10,1862,1820,42,1937-9-10,1778
1937,9,11,2003,1901,102,1937-9-11,1799
1937,9,12,2415,2339,76,1937-9-12,2263
1937,9,13,2570,2519,51,1937-9-13,2468
1937,9,14,2846,2789,57,1937-9-14,2732
1937,9,15,2699,2639,60,1937-9-15,2579
1937,9,16,2255,2184,71,1937-9-16,2113
1937,9,17,1369,1282,87,1937-9-17,1195
1937,9,18,701,572,129,1937-9-18,443
1937,9,19,891,756,135,1937-9-19,621
1937,9,20,936,790,146,1937-9-20,644
1937,9,21,812,669,143,1937-9-21,526
1937,9,22,781,640,141,1937-9-22,499
1937,9,23,1018,771,247,1937-9-23,524
1937,9,24,1370,905,465,1937-9-24,440
1937,9,25,1273,818,455,1937-9-25,363
1937,9,26,1089,799,290,1937-9-26,509
1937,9,27,695,597,98,1937-9-27,499
1937,9,28,1581,1237,344,1937-9-28,893
1937,9,29,1962,1744,218,1937-9-29,1526
1937,9,30,2477,2250,227,1937-9-30,2023
1937,10,1,3428,3180,248,1937-10-1,2932
1937,10,2,3786,3540,246,1937-10-2,3294
1937,10,3,4284,4071,213,1937-10-3,3858
1937,10,4,4678,4518,160,1937-10-4,4358
1937,10,5,4663,4571,92,1937-10-5,4479
1937,10,6,4546,4479,67,1937-10-6,4412
1937,10,7,4488,4433,55,1937-10-7,4378
1937,10,8,4477,4407,70,1937-10-8,4337
1937,10,9,3943,3869,74,1937-10-9,3795
1937,10,10,3127,3043,84,1937-10-10,2959
1937,10,11,1798,1512,286,1937-10-11,1226
1937,10,12,1684,1190,494,1937-10-12,696
1937,10,13,2661,1278,1383,1937-10-13,-105
1937,10,14,2360,867,1493,1937-10-14,-626
1937,10,15,2412,709,1703,1937-10-15,-994
1937,10,16,2102,525,1577,1937-10-16,-1052
1937,10,17,1675,375,1300,1937-10-17,-925
1937,10,18,1394,355,1039,1937-10-18,-684
1937,10,19,1016,104,912,1937-10-19,-808
1937,10,20,856,63,793,1937-10-20,-730
1937,10,21,911,214,697,1937-10-21,-483
1937,10,22,980,474,506,1937-10-22,-32
1937,10,23,1262,1023,239,1937-10-23,784
1937,10,24,1425,1124,301,1937-10-24,823
1937,10,25,1682,1172,510,1937-10-25,662
1937,10,26,1356,964,392,1937-10-26,572
1937,10,27,1208,805,403,1937-10-27,402
1937,10,28,1274,940,334,1937-10-28,606
1937,10,29,1091,802,289,1937-10-29,513
1937,10,30,1212,816,396,1937-10-30,420
1937,10,31,1330,900,430,1937-10-31,470
1937,11,1,1022,696,326,1937-11-1,370
1937,11,2,1428,718,710,1937-11-2,8
1937,11,3,1179,543,636,1937-11-3,-93
1937,11,4,829,343,486,1937-11-4,-143
1937,11,5,607,166,441,1937-11-5,-275
1937,11,6,554,153,401,1937-11-6,-248
1937,11,7,357,314,43,1937-11-7,271
1937,11,8,610,354,256,1937-11-8,98
1937,11,9,1096,401,695,1937-11-9,-294
1937,11,10,1262,348,914,1937-11-10,-566
1937,11,11,1609,295,1314,1937-11-11,-1019
1937,11,12,1642,392,1250,1937-11-12,-858
1937,11,13,1407,278,1129,1937-11-13,-851
1937,11,14,1335,261,1074,1937-11-14,-813
1937,11,15,1151,317,834,1937-11-15,-517
1937,11,16,927,360,567,1937-11-16,-207
1937,11,17,981,409,572,1937-11-17,-163
1937,11,18,1092,308,784,1937-11-18,-476
1937,11,19,1179,301,878,1937-11-19,-577
1937,11,20,568,106,462,1937-11-20,-356
1937,11,21,615,110,505,1937-11-21,-395
1937,11,22,524,159,365,1937-11-22,-206
1937,11,23,454,204,250,1937-11-23,-46
1937,11,24,372,131,241,1937-11-24,-110
1937,11,25,369,86,283,1937-11-25,-197
1937,11,26,385,137,248,1937-11-26,-111
1937,11,27,544,302,242,1937-11-27,60
1937,11,28,567,289,278,1937-11-28,11
1937,11,29,519,249,270,1937-11-29,-21
1937,11,30,401,145,256,1937-11-30,-111
1937,12,1,48,13,35,1937-12-1,-22
1937,12,2,124,7,117,1937-12-2,-110
1937,12,3,90,4,86,1937-12-3,-82
1937,12,4,130,0,130,1937-12-4,-130
1937,12,5,201,102,99,1937-12-5,3
1937,12,6,274,85,189,1937-12-6,-104
1937,12,7,604,89,515,1937-12-7,-426
1937,12,8,370,50,320,1937-12-8,-270
1937,12,9,217,42,175,1937-12-9,-133
1937,12,10,889,343,546,1937-12-10,-203
1937,12,11,961,104,857,1937-12-11,-753
1937,12,12,1425,190,1235,1937-12-12,-1045
1937,12,13,1557,452,1105,1937-12-13,-653
1937,12,14,2025,1068,957,1937-12-14,111
1937,12,15,2725,1832,893,1937-12-15,939
1937,12,16,2799,2034,765,1937-12-16,1269
1937,12,17,2343,1796,547,1937-12-17,1249
1937,12,18,1985,1477,508,1937-12-18,969
1937,12,19,1788,1271,517,1937-12-19,754
1937,12,20,1873,1367,506,1937-12-20,861
1937,12,21,1897,1477,420,1937-12-21,1057
1937,12,22,1198,972,226,1937-12-22,746
1937,12,23,1287,1017,270,1937-12-23,747
1937,12,24,1456,1095,361,1937-12-24,734
1937,12,25,1820,1313,507,1937-12-25,806
1937,12,26,1613,1037,576,1937-12-26,461
1937,12,27,1381,727,654,1937-12-27,73
1937,12,28,1597,673,924,1937-12-28,-251
1937,12,29,1382,517,865,1937-12-29,-348
1937,12,30,1060,282,778,1937-12-30,-496
1937,12,31,1334,447,887,1937-12-31,-440
1938,1,1,1426,619,807,1938-1-1,-188
1938,1,2,1795,776,1019,1938-1-2,-243
1938,1,3,1401,774,627,1938-1-3,147
1938,1,4,1158,1002,156,1938-1-4,846
1938,1,5,730,644,86,1938-1-5,558
1938,1,6,872,747,125,1938-1-6,622
1938,1,7,1222,1126,96,1938-1-7,1030
1938,1,8,1422,1411,11,1938-1-8,1400
1938,1,9,1295,1236,59,1938-1-9,1177
1938,1,10,1232,1134,98,1938-1-10,1036
1938,1,11,1377,1347,30,1938-1-11,1317
1938,1,12,2853,2792,61,1938-1-12,2731
1938,1,13,3412,3325,87,1938-1-13,3238
1938,1,14,3946,3896,50,1938-1-14,3846
1938,1,15,4863,4840,23,1938-1-15,4817
1938,1,16,4887,4882,5,1938-1-16,4877
1938,1,17,4983,4958,25,1938-1-17,4933
1938,1,18,3505,3441,64,1938-1-18,3377
1938,1,19,3504,3284,220,1938-1-19,3064
1938,1,20,3931,3600,331,1938-1-20,3269
1938,1,21,4092,3822,270,1938-1-21,3552
1938,1,22,3860,3424,436,1938-1-22,2988
1938,1,23,3682,3305,377,1938-1-23,2928
1938,1,24,3022,2683,339,1938-1-24,2344
1938,1,25,443,251,192,1938-1-25,59
1938,1,26,538,389,149,1938-1-26,240
1938,1,27,427,384,43,1938-1-27,341
1938,1,28,743,695,48,1938-1-28,647
1938,1,29,1167,1059,108,1938-1-29,951
1938,1,30,1126,1060,66,1938-1-30,994
1938,1,31,1296,1095,201,1938-1-31,894
1938,2,1,1181,899,282,1938-2-1,617
1938,2,2,1086,732,354,1938-2-2,378
1938,2,3,1293,682,611,1938-2-3,71
1938,2,4,1191,654,537,1938-2-4,117
1938,2,5,1242,681,561,1938-2-5,120
1938,2,6,1190,555,635,1938-2-6,-80
1938,2,7,1860,672,1188,1938-2-7,-516
1938,2,8,2250,550,1700,1938-2-8,-1150
1938,2,9,2275,732,1543,1938-2-9,-811
1938,2,10,2404,634,1770,1938-2-10,-1136
1938,2,11,2330,576,1754,1938-2-11,-1178
1938,2,12,2870,747,2123,1938-2-12,-1376
1938,2,13,3311,812,2499,1938-2-13,-1687
1938,2,14,3531,808,2723,1938-2-14,-1915
1938,2,15,3111,719,2392,1938-2-15,-1673
1938,2,16,3177,971,2206,1938-2-16,-1235
1938,2,17,2063,984,1079,1938-2-17,-95
1938,2,18,2031,742,1289,1938-2-18,-547
1938,2,19,1683,628,1055,1938-2-19,-427
1938,2,20,1218,240,978,1938-2-20,-738
1938,2,21,946,117,829,1938-2-21,-712
1938,2,22,942,187,755,1938-2-22,-568
1938,2,23,996,247,749,1938-2-23,-502
1938,2,24,1123,364,759,1938-2-24,-395
1938,2,25,936,299,637,1938-2-25,-338
1938,2,26,922,221,701,1938-2-26,-480
1938,2,27,894,187,707,1938-2-27,-520
1938,2,28,777,145,632,1938-2-28,-487
1938,3,1,837,166,671,1938-3-1,-505
1938,3,2,596,96,500,1938-3-2,-404
1938,3,3,856,34,822,1938-3-3,-788
1938,3,4,1278,410,868,1938-3-4,-458
1938,3,5,1162,466,696,1938-3-5,-230
1938,3,6,993,522,471,1938-3-6,51
1938,3,7,1195,865,330,1938-3-7,535
1938,3,8,1183,798,385,1938-3-8,413
1938,3,9,1573,1086,487,1938-3-9,599
1938,3,10,1552,1049,503,1938-3-10,546
1938,3,11,1822,1016,806,1938-3-11,210
1938,3,12,1985,924,1061,1938-3-12,-137
1938,3,13,1925,875,1050,1938-3-13,-175
1938,3,14,1842,730,1112,1938-3-14,-382
1938,3,15,1869,674,1195,1938-3-15,-521
1938,3,16,1655,297,1358,1938-3-16,-1061
1938,3,17,1543,235,1308,1938-3-17,-1073
1938,3,18,1289,232,1057,1938-3-18,-825
1938,3,19,703,282,421,1938-3-19,-139
1938,3,20,1163,219,944,1938-3-20,-725
1938,3,21,1972,176,1796,1938-3-21,-1620
1938,3,22,1683,28,1655,1938-3-22,-1627
1938,3,23,1736,34,1702,1938-3-23,-1668
1938,3,24,1594,17,1577,1938-3-24,-1560
1938,3,25,1640,0,1640,1938-3-25,-1640
1938,3,26,1486,0,1486,1938-3-26,-1486
1938,3,27,1605,0,1605,1938-3-27,-1605
1938,3,28,1624,0,1624,1938-3-28,-1624
1938,3,29,1639,0,1639,1938-3-29,-1639
1938,3,30,1586,0,1586,1938-3-30,-1586
1938,3,31,2091,9,2082,1938-3-31,-2073
1938,4,1,2112,39,2073,1938-4-1,-2034
1938,4,2,1509,69,1440,1938-4-2,-1371
1938,4,3,933,80,853,1938-4-3,-773
1938,4,4,929,72,857,1938-4-4,-785
1938,4,5,856,74,782,1938-4-5,-708
1938,4,6,1466,56,1410,1938-4-6,-1354
1938,4,7,1484,38,1446,1938-4-7,-1408
1938,4,8,3190,1559,1631,1938-4-8,-72
1938,4,9,3029,1578,1451,1938-4-9,127
1938,4,10,3368,1568,1800,1938-4-10,-232
1938,4,11,3478,1634,1844,1938-4-11,-210
1938,4,12,3097,1433,1664,1938-4-12,-231
1938,4,13,3104,1526,1578,1938-4-13,-52
1938,4,14,2863,1295,1568,1938-4-14,-273
1938,4,15,3037,1176,1861,1938-4-15,-685
1938,4,16,3694,991,2703,1938-4-16,-1712
1938,4,17,3665,744,2921,1938-4-17,-2177
1938,4,18,3082,501,2581,1938-4-18,-2080
1938,4,19,2880,338,2542,1938-4-19,-2204
1938,4,20,2503,101,2402,1938-4-20,-2301
1938,4,21,2025,21,2004,1938-4-21,-1983
1938,4,22,1724,37,1687,1938-4-22,-1650
1938,4,23,1374,165,1209,1938-4-23,-1044
1938,4,24,1746,382,1364,1938-4-24,-982
1938,4,25,1723,475,1248,1938-4-25,-773
1938,4,26,2147,599,1548,1938-4-26,-949
1938,4,27,2872,901,1971,1938-4-27,-1070
1938,4,28,2687,1134,1553,1938-4-28,-419
1938,4,29,2358,1161,1197,1938-4-29,-36
1938,4,30,2034,1086,948,1938-4-30,138
1938,5,1,2026,1125,901,1938-5-1,224
1938,5,2,2044,1026,1018,1938-5-2,8
1938,5,3,2108,933,1175,1938-5-3,-242
1938,5,4,2267,878,1389,1938-5-4,-511
1938,5,5,2009,450,1559,1938-5-5,-1109
1938,5,6,2223,433,1790,1938-5-6,-1357
1938,5,7,2650,591,2059,1938-5-7,-1468
1938,5,8,2911,701,2210,1938-5-8,-1509
1938,5,9,3013,854,2159,1938-5-9,-1305
1938,5,10,2670,760,1910,1938-5-10,-1150
1938,5,11,3088,810,2278,1938-5-11,-1468
1938,5,12,3027,721,2306,1938-5-12,-1585
1938,5,13,2641,640,2001,1938-5-13,-1361
1938,5,14,2540,472,2068,1938-5-14,-1596
1938,5,15,2476,370,2106,1938-5-15,-1736
1938,5,16,2201,221,1980,1938-5-16,-1759
1938,5,17,1722,199,1523,1938-5-17,-1324
1938,5,18,1959,123,1836,1938-5-18,-1713
1938,5,19,2324,115,2209,1938-5-19,-2094
1938,5,20,2441,130,2311,1938-5-20,-2181
1938,5,21,2075,122,1953,1938-5-21,-1831
1938,5,22,2180,52,2128,1938-5-22,-2076
1938,5,23,2326,374,1952,1938-5-23,-1578
1938,5,24,2592,1168,1424,1938-5-24,-256
1938,5,25,2455,1383,1072,1938-5-25,311
1938,5,26,2486,1532,954,1938-5-26,578
1938,5,27,1943,1565,378,1938-5-27,1187
1938,5,28,2389,2058,331,1938-5-28,1727
1938,5,29,2704,2457,247,1938-5-29,2210
1938,5,30,1337,942,395,1938-5-30,547
1938,5,31,1083,513,570,1938-5-31,-57
1938,6,1,996,512,484,1938-6-1,28
1938,6,2,1009,419,590,1938-6-2,-171
1938,6,3,984,472,512,1938-6-3,-40
1938,6,4,1248,631,617,1938-6-4,14
1938,6,5,1243,831,412,1938-6-5,419
1938,6,6,1243,878,365,1938-6-6,513
1938,6,7,1540,939,601,1938-6-7,338
1938,6,8,1630,1051,579,1938-6-8,472
1938,6,9,1527,935,592,1938-6-9,343
1938,6,10,1260,860,400,1938-6-10,460
1938,6,11,1226,921,305,1938-6-11,616
1938,6,12,1216,861,355,1938-6-12,506
1938,6,13,1288,1201,87,1938-6-13,1114
1938,6,14,1142,1111,31,1938-6-14,1080
1938,6,15,1057,1017,40,1938-6-15,977
1938,6,16,1025,988,37,1938-6-16,951
1938,6,17,1347,1281,66,1938-6-17,1215
1938,6,18,968,913,55,1938-6-18,858
1938,6,19,1225,1196,29,1938-6-19,1167
1938,6,20,1336,1291,45,1938-6-20,1246
1938,6,21,1497,1466,31,1938-6-21,1435
1938,6,22,1533,1503,30,1938-6-22,1473
1938,6,23,1685,1627,58,1938-6-23,1569
1938,6,24,1672,1606,66,1938-6-24,1540
1938,6,25,1430,1357,73,1938-6-25,1284
1938,6,26,1166,1056,110,1938-6-26,946
1938,6,27,1639,910,729,1938-6-27,181
1938,6,28,1827,922,905,1938-6-28,17
1938,6,29,1283,311,972,1938-6-29,-661
1938,6,30,1443,196,1247,1938-6-30,-1051
1938,7,1,1371,118,1253,1938-7-1,-1135
1938,7,2,1716,203,1513,1938-7-2,-1310
1938,7,3,1530,386,1144,1938-7-3,-758
1938,7,4,2922,1327,1595,1938-7-4,-268
1938,7,5,3356,1693,1663,1938-7-5,30
1938,7,6,4078,1975,2103,1938-7-6,-128
1938,7,7,4013,1694,2319,1938-7-7,-625
1938,7,8,3996,1262,2734,1938-7-8,-1472
1938,7,9,4534,1550,2984,1938-7-9,-1434
1938,7,10,4876,1528,3348,1938-7-10,-1820
1938,7,11,5257,1351,3906,1938-7-11,-2555
1938,7,12,4915,1100,3815,1938-7-12,-2715
1938,7,13,5438,1197,4241,1938-7-13,-3044
1938,7,14,4776,538,4238,1938-7-14,-3700
1938,7,15,4589,616,3973,1938-7-15,-3357
1938,7,16,3993,600,3393,1938-7-16,-2793
1938,7,17,2963,518,2445,1938-7-17,-1927
1938,7,18,3336,946,2390,1938-7-18,-1444
1938,7,19,3463,893,2570,1938-7-19,-1677
1938,7,20,4399,848,3551,1938-7-20,-2703
1938,7,21,3003,966,2037,1938-7-21,-1071
1938,7,22,892,617,275,1938-7-22,342
1938,7,23,1759,853,906,1938-7-23,-53
1938,7,24,2644,1087,1557,1938-7-24,-470
1938,7,25,2774,1162,1612,1938-7-25,-450
1938,7,26,2371,899,1472,1938-7-26,-573
1938,7,27,2570,830,1740,1938-7-27,-910
1938,7,28,2119,694,1425,1938-7-28,-731
1938,7,29,1832,457,1375,1938-7-29,-918
1938,7,30,1349,338,1011,1938-7-30,-673
1938,7,31,1227,411,816,1938-7-31,-405
1938,8,1,2192,529,1663,1938-8-1,-1134
1938,8,2,1898,395,1503,1938-8-2,-1108
1938,8,3,1856,433,1423,1938-8-3,-990
1938,8,4,1859,598,1261,1938-8-4,-663
1938,8,5,3420,1168,2252,1938-8-5,-1084
1938,8,6,3378,1200,2178,1938-8-6,-978
1938,8,7,2592,462,2130,1938-8-7,-1668
1938,8,8,3341,474,2867,1938-8-8,-2393
1938,8,9,3260,539,2721,1938-8-9,-2182
1938,8,10,3252,692,2560,1938-8-10,-1868
1938,8,11,3044,538,2506,1938-8-11,-1968
1938,8,12,2606,450,2156,1938-8-12,-1706
1938,8,13,2376,313,2063,1938-8-13,-1750
1938,8,14,1750,131,1619,1938-8-14,-1488
1938,8,15,1892,416,1476,1938-8-15,-1060
1938,8,16,1664,472,1192,1938-8-16,-720
1938,8,17,1422,545,877,1938-8-17,-332
1938,8,18,803,381,422,1938-8-18,-41
1938,8,19,626,349,277,1938-8-19,72
1938,8,20,499,259,240,1938-8-20,19
1938,8,21,461,278,183,1938-8-21,95
1938,8,22,428,258,170,1938-8-22,88
1938,8,23,489,275,214,1938-8-23,61
1938,8,24,512,217,295,1938-8-24,-78
1938,8,25,685,342,343,1938-8-25,-1
1938,8,26,676,283,393,1938-8-26,-110
1938,8,27,781,427,354,1938-8-27,73
1938,8,28,871,602,269,1938-8-28,333
1938,8,29,1335,845,490,1938-8-29,355
1938,8,30,1004,720,284,1938-8-30,436
1938,8,31,1069,638,431,1938-8-31,207
1938,9,1,1304,678,626,1938-9-1,52
1938,9,2,1971,1382,589,1938-9-2,793
1938,9,3,1797,1294,503,1938-9-3,791
1938,9,4,1966,1246,720,1938-9-4,526
1938,9,5,2056,1314,742,1938-9-5,572
1938,9,6,2339,1668,671,1938-9-6,997
1938,9,7,1895,1417,478,1938-9-7,939
1938,9,8,1950,1534,416,1938-9-8,1118
1938,9,9,1669,1271,398,1938-9-9,873
1938,9,10,1366,1116,250,1938-9-10,866
1938,9,11,741,550,191,1938-9-11,359
1938,9,12,418,245,173,1938-9-12,72
1938,9,13,613,297,316,1938-9-13,-19
1938,9,14,260,260,0,1938-9-14,260
1938,9,15,777,777,0,1938-9-15,777
1938,9,16,911,911,0,1938-9-16,911
1938,9,17,726,718,8,1938-9-17,710
1938,9,18,700,700,0,1938-9-18,700
1938,9,19,1153,626,527,1938-9-19,99
1938,9,20,1245,527,718,1938-9-20,-191
1938,9,21,1622,597,1025,1938-9-21,-428
1938,9,22,2714,362,2352,1938-9-22,-1990
1938,9,23,2573,104,2469,1938-9-23,-2365
1938,9,24,2437,237,2200,1938-9-24,-1963
1938,9,25,2294,286,2008,1938-9-25,-1722
1938,9,26,2404,687,1717,1938-9-26,-1030
1938,9,27,2379,683,1696,1938-9-27,-1013
1938,9,28,2098,540,1558,1938-9-28,-1018
1938,9,29,1923,443,1480,1938-9-29,-1037
1938,9,30,1802,524,1278,1938-9-30,-754
1938,10,1,1608,530,1078,1938-10-1,-548
1938,10,2,1121,470,651,1938-10-2,-181
1938,10,3,1027,493,534,1938-10-3,-41
1938,10,4,412,334,78,1938-10-4,256
1938,10,5,2657,2567,90,1938-10-5,2477
1938,10,6,3227,3181,46,1938-10-6,3135
1938,10,7,3702,3657,45,1938-10-7,3612
1938,10,8,3534,3481,53,1938-10-8,3428
1938,10,9,3762,3489,273,1938-10-9,3216
1938,10,10,3521,3247,274,1938-10-10,2973
1938,10,11,3271,3070,201,1938-10-11,2869
1938,10,12,3515,3287,228,1938-10-12,3059
1938,10,13,2913,2761,152,1938-10-13,2609
1938,10,14,2923,2825,98,1938-10-14,2727
1938,10,15,2606,2524,82,1938-10-15,2442
1938,10,16,2325,2275,50,1938-10-16,2225
1938,10,17,2002,1936,66,1938-10-17,1870
1938,10,18,565,397,168,1938-10-18,229
1938,10,19,279,0,279,1938-10-19,-279
1938,10,20,845,340,505,1938-10-20,-165
1938,10,21,991,640,351,1938-10-21,289
1938,10,22,764,620,144,1938-10-22,476
1938,10,23,715,570,145,1938-10-23,425
1938,10,24,683,526,157,1938-10-24,369
1938,10,25,836,597,239,1938-10-25,358
1938,10,26,1364,707,657,1938-10-26,50
1938,10,27,1541,681,860,1938-10-27,-179
1938,10,28,1576,750,826,1938-10-28,-76
1938,10,29,1904,837,1067,1938-10-29,-230
1938,10,30,1735,737,998,1938-10-30,-261
1938,10,31,1512,784,728,1938-10-31,56
1938,11,1,1414,738,676,1938-11-1,62
1938,11,2,947,702,245,1938-11-2,457
1938,11,3,899,745,154,1938-11-3,591
1938,11,4,1837,674,1163,1938-11-4,-489
1938,11,5,2844,562,2282,1938-11-5,-1720
1938,11,6,2953,591,2362,1938-11-6,-1771
1938,11,7,3749,556,3193,1938-11-7,-2637
1938,11,8,3726,503,3223,1938-11-8,-2720
1938,11,9,3582,591,2991,1938-11-9,-2400
1938,11,10,3190,364,2826,1938-11-10,-2462
1938,11,11,3118,289,2829,1938-11-11,-2540
1938,11,12,3189,146,3043,1938-11-12,-2897
1938,11,13,3096,241,2855,1938-11-13,-2614
1938,11,14,3041,430,2611,1938-11-14,-2181
1938,11,15,2998,377,2621,1938-11-15,-2244
1938,11,16,3329,405,2924,1938-11-16,-2519
1938,11,17,2349,347,2002,1938-11-17,-1655
1938,11,18,2096,290,1806,1938-11-18,-1516
1938,11,19,2482,284,2198,1938-11-19,-1914
1938,11,20,2465,382,2083,1938-11-20,-1701
1938,11,21,2231,359,1872,1938-11-21,-1513
1938,11,22,841,500,341,1938-11-22,159
1938,11,23,859,494,365,1938-11-23,129
1938,11,24,1189,800,389,1938-11-24,411
1938,11,25,1515,1481,34,1938-11-25,1447
1938,11,26,2067,1990,77,1938-11-26,1913
1938,11,27,2342,2222,120,1938-11-27,2102
1938,11,28,2557,2380,177,1938-11-28,2203
1938,11,29,2905,2400,505,1938-11-29,1895
1938,11,30,2578,2068,510,1938-11-30,1558
1938,12,1,2907,1922,985,1938-12-1,937
1938,12,2,2914,1595,1319,1938-12-2,276
1938,12,3,2820,1413,1407,1938-12-3,6
1938,12,4,2963,1259,1704,1938-12-4,-445
1938,12,5,1790,557,1233,1938-12-5,-676
1938,12,6,1588,135,1453,1938-12-6,-1318
1938,12,7,1982,72,1910,1938-12-7,-1838
1938,12,8,2001,16,1985,1938-12-8,-1969
1938,12,9,2141,84,2057,1938-12-9,-1973
1938,12,10,1915,145,1770,1938-12-10,-1625
1938,12,11,2108,419,1689,1938-12-11,-1270
1938,12,12,2204,335,1869,1938-12-12,-1534
1938,12,13,2171,509,1662,1938-12-13,-1153
1938,12,14,1797,538,1259,1938-12-14,-721
1938,12,15,1404,517,887,1938-12-15,-370
1938,12,16,1226,421,805,1938-12-16,-384
1938,12,17,962,396,566,1938-12-17,-170
1938,12,18,1309,377,932,1938-12-18,-555
1938,12,19,1435,655,780,1938-12-19,-125
1938,12,20,2629,1251,1378,1938-12-20,-127
1938,12,21,2295,1013,1282,1938-12-21,-269
1938,12,22,2337,945,1392,1938-12-22,-447
1938,12,23,2276,909,1367,1938-12-23,-458
1938,12,24,2402,1067,1335,1938-12-24,-268
1938,12,25,1761,789,972,1938-12-25,-183
1938,12,26,1400,609,791,1938-12-26,-182
1938,12,27,1302,785,517,1938-12-27,268
1938,12,28,1209,755,454,1938-12-28,301
1938,12,29,1344,550,794,1938-12-29,-244
1938,12,30,1418,390,1028,1938-12-30,-638
1938,12,31,1410,298,1112,1938-12-31,-814
1939,1,1,1227,49,1178,1939-1-1,-1129
1939,1,2,842,12,830,1939-1-2,-818
1939,1,3,956,61,895,1939-1-3,-834
1939,1,4,1116,120,996,1939-1-4,-876
1939,1,5,1308,196,1112,1939-1-5,-916
1939,1,6,1281,359,922,1939-1-6,-563
1939,1,7,1334,578,756,1939-1-7,-178
1939,1,8,1117,337,780,1939-1-8,-443
1939,1,9,1140,416,724,1939-1-9,-308
1939,1,10,1558,716,842,1939-1-10,-126
1939,1,11,1633,684,949,1939-1-11,-265
1939,1,12,1575,637,938,1939-1-12,-301
1939,1,13,1131,459,672,1939-1-13,-213
1939,1,14,1361,618,743,1939-1-14,-125
1939,1,15,1602,712,890,1939-1-15,-178
1939,1,16,1075,658,417,1939-1-16,241
1939,1,17,984,586,398,1939-1-17,188
1939,1,18,540,419,121,1939-1-18,298
1939,1,19,704,498,206,1939-1-19,292
1939,1,20,1046,403,643,1939-1-20,-240
1939,1,21,994,426,568,1939-1-21,-142
1939,1,22,846,175,671,1939-1-22,-496
1939,1,23,952,157,795,1939-1-23,-638
1939,1,24,1226,437,789,1939-1-24,-352
1939,1,25,1386,570,816,1939-1-25,-246
1939,1,26,1249,507,742,1939-1-26,-235
1939,1,27,1378,381,997,1939-1-27,-616
1939,1,28,1190,254,936,1939-1-28,-682
1939,1,29,877,160,717,1939-1-29,-557
1939,1,30,1158,192,966,1939-1-30,-774
1939,1,31,1147,193,954,1939-1-31,-761
1939,2,1,1020,185,835,1939-2-1,-650
1939,2,2,871,222,649,1939-2-2,-427
1939,2,3,1188,278,910,1939-2-3,-632
1939,2,4,1173,367,806,1939-2-4,-439
1939,2,5,883,149,734,1939-2-5,-585
1939,2,6,751,184,567,1939-2-6,-383
1939,2,7,647,246,401,1939-2-7,-155
1939,2,8,459,218,241,1939-2-8,-23
1939,2,9,418,259,159,1939-2-9,100
1939,2,10,303,299,4,1939-2-10,295
1939,2,11,829,366,463,1939-2-11,-97
1939,2,12,1114,481,633,1939-2-12,-152
1939,2,13,1354,568,786,1939-2-13,-218
1939,2,14,1166,472,694,1939-2-14,-222
1939,2,15,824,240,584,1939-2-15,-344
1939,2,16,803,215,588,1939-2-16,-373
1939,2,17,950,415,535,1939-2-17,-120
1939,2,18,1009,448,561,1939-2-18,-113
1939,2,19,1008,530,478,1939-2-19,52
1939,2,20,959,473,486,1939-2-20,-13
1939,2,21,1473,698,775,1939-2-21,-77
1939,2,22,1375,435,940,1939-2-22,-505
1939,2,23,1553,341,1212,1939-2-23,-871
1939,2,24,1447,357,1090,1939-2-24,-733
1939,2,25,1280,293,987,1939-2-25,-694
1939,2,26,1270,204,1066,1939-2-26,-862
1939,2,27,1349,206,1143,1939-2-27,-937
1939,2,28,1397,280,1117,1939-2-28,-837
1939,3,1,1410,364,1046,1939-3-1,-682
1939,3,2,1303,446,857,1939-3-2,-411
1939,3,3,1214,511,703,1939-3-3,-192
1939,3,4,951,437,514,1939-3-4,-77
1939,3,5,728,216,512,1939-3-5,-296
1939,3,6,491,175,316,1939-3-6,-141
1939,3,7,493,221,272,1939-3-7,-51
1939,3,8,550,461,89,1939-3-8,372
1939,3,9,513,420,93,1939-3-9,327
1939,3,10,578,345,233,1939-3-10,112
1939,3,11,766,348,418,1939-3-11,-70
1939,3,12,603,257,346,1939-3-12,-89
1939,3,13,820,420,400,1939-3-13,20
1939,3,14,623,191,432,1939-3-14,-241
1939,3,15,889,99,790,1939-3-15,-691
1939,3,16,833,168,665,1939-3-16,-497
1939,3,17,873,242,631,1939-3-17,-389
1939,3,18,939,294,645,1939-3-18,-351
1939,3,19,1264,541,723,1939-3-19,-182
1939,3,20,1683,716,967,1939-3-20,-251
1939,3,21,1134,579,555,1939-3-21,24
1939,3,22,1363,423,940,1939-3-22,-517
1939,3,23,859,370,489,1939-3-23,-119
1939,3,24,521,332,189,1939-3-24,143
1939,3,25,331,270,61,1939-3-25,209
1939,3,26,392,218,174,1939-3-26,44
1939,3,27,554,199,355,1939-3-27,-156
1939,3,28,436,152,284,1939-3-28,-132
1939,3,29,448,271,177,1939-3-29,94
1939,3,30,43,31,12,1939-3-30,19
1939,3,31,55,42,13,1939-3-31,29
1939,4,1,128,85,43,1939-4-1,42
1939,4,2,499,199,300,1939-4-2,-101
1939,4,3,958,439,519,1939-4-3,-80
1939,4,4,1046,372,674,1939-4-4,-302
1939,4,5,941,400,541,1939-4-5,-141
1939,4,6,1158,434,724,1939-4-6,-290
1939,4,7,1127,329,798,1939-4-7,-469
1939,4,8,989,190,799,1939-4-8,-609
1939,4,9,1197,396,801,1939-4-9,-405
1939,4,10,1153,503,650,1939-4-10,-147
1939,4,11,922,466,456,1939-4-11,10
1939,4,12,854,504,350,1939-4-12,154
1939,4,13,972,606,366,1939-4-13,240
1939,4,14,2049,1561,488,1939-4-14,1073
1939,4,15,2118,1435,683,1939-4-15,752
1939,4,16,2235,1482,753,1939-4-16,729
1939,4,17,1569,1282,287,1939-4-17,995
1939,4,18,1413,1226,187,1939-4-18,1039
1939,4,19,1631,1556,75,1939-4-19,1481
1939,4,20,3365,2255,1110,1939-4-20,1145
1939,4,21,3677,2109,1568,1939-4-21,541
1939,4,22,3569,1662,1907,1939-4-22,-245
1939,4,23,3799,1757,2042,1939-4-23,-285
1939,4,24,3919,1619,2300,1939-4-24,-681
1939,4,25,3501,1443,2058,1939-4-25,-615
1939,4,26,3511,1495,2016,1939-4-26,-521
1939,4,27,3235,1676,1559,1939-4-27,117
1939,4,28,2793,1434,1359,1939-4-28,75
1939,4,29,3045,1772,1273,1939-4-29,499
1939,4,30,2619,1804,815,1939-4-30,989
1939,5,1,2578,1764,814,1939-5-1,950
1939,5,2,3176,2212,964,1939-5-2,1248
1939,5,3,2378,1819,559,1939-5-3,1260
1939,5,4,2213,1896,317,1939-5-4,1579
1939,5,5,2344,2071,273,1939-5-5,1798
1939,5,6,2025,1911,114,1939-5-6,1797
1939,5,7,1974,1713,261,1939-5-7,1452
1939,5,8,1959,1778,181,1939-5-8,1597
1939,5,9,2233,1865,368,1939-5-9,1497
1939,5,10,2499,2080,419,1939-5-10,1661
1939,5,11,2208,1789,419,1939-5-11,1370
1939,5,12,1417,883,534,1939-5-12,349
1939,5,13,1411,697,714,1939-5-13,-17
1939,5,14,1446,892,554,1939-5-14,338
1939,5,15,1326,834,492,1939-5-15,342
1939,5,16,797,416,381,1939-5-16,35
1939,5,17,1048,394,654,1939-5-17,-260
1939,5,18,1432,597,835,1939-5-18,-238
1939,5,19,1055,386,669,1939-5-19,-283
1939,5,20,936,307,629,1939-5-20,-322
1939,5,21,803,295,508,1939-5-21,-213
1939,5,22,904,332,572,1939-5-22,-240
1939,5,23,1366,440,926,1939-5-23,-486
1939,5,24,1331,362,969,1939-5-24,-607
1939,5,25,1519,350,1169,1939-5-25,-819
1939,5,26,1405,309,1096,1939-5-26,-787
1939,5,27,1658,712,946,1939-5-27,-234
1939,5,28,2113,1016,1097,1939-5-28,-81
1939,5,29,2410,1157,1253,1939-5-29,-96
1939,5,30,2304,1028,1276,1939-5-30,-248
1939,5,31,2013,1182,831,1939-5-31,351
1939,6,1,1651,974,677,1939-6-1,297
1939,6,2,1572,1080,492,1939-6-2,588
1939,6,3,1125,818,307,1939-6-3,511
1939,6,4,1132,948,184,1939-6-4,764
1939,6,5,1649,1462,187,1939-6-5,1275
1939,6,6,1325,1220,105,1939-6-6,1115
1939,6,7,1347,1264,83,1939-6-7,1181
1939,6,8,1161,1130,31,1939-6-8,1099
1939,6,9,1546,1541,5,1939-6-9,1536
1939,6,10,1381,1287,94,1939-6-10,1193
1939,6,11,981,958,23,1939-6-11,935
1939,6,12,1101,992,109,1939-6-12,883
1939,6,13,1202,920,282,1939-6-13,638
1939,6,14,805,623,182,1939-6-14,441
1939,6,15,1086,772,314,1939-6-15,458
1939,6,16,926,586,340,1939-6-16,246
1939,6,17,1075,627,448,1939-6-17,179
1939,6,18,806,504,302,1939-6-18,202
1939,6,19,1053,526,527,1939-6-19,-1
1939,6,20,756,436,320,1939-6-20,116
1939,6,21,741,529,212,1939-6-21,317
1939,6,22,593,388,205,1939-6-22,183
1939,6,23,846,527,319,1939-6-23,208
1939,6,24,1061,508,553,1939-6-24,-45
1939,6,25,751,333,418,1939-6-25,-85
1939,6,26,963,382,581,1939-6-26,-199
1939,6,27,1014,276,738,1939-6-27,-462
1939,6,28,1191,259,932,1939-6-28,-673
1939,6,29,1585,265,1320,1939-6-29,-1055
1939,6,30,1494,137,1357,1939-6-30,-1220
1939,7,1,1236,143,1093,1939-7-1,-950
1939,7,2,1100,142,958,1939-7-2,-816
1939,7,3,2800,153,2647,1939-7-3,-2494
1939,7,4,2727,201,2526,1939-7-4,-2325
1939,7,5,2484,150,2334,1939-7-5,-2184
1939,7,6,2571,77,2494,1939-7-6,-2417
1939,7,7,3032,380,2652,1939-7-7,-2272
1939,7,8,3327,667,2660,1939-7-8,-1993
1939,7,9,2980,1080,1900,1939-7-9,-820
1939,7,10,3179,1275,1904,1939-7-10,-629
1939,7,11,3445,1789,1656,1939-7-11,133
1939,7,12,3523,2265,1258,1939-7-12,1007
1939,7,13,3157,2240,917,1939-7-13,1323
1939,7,14,2177,1688,489,1939-7-14,1199
1939,7,15,1731,1403,328,1939-7-15,1075
1939,7,16,1411,1392,19,1939-7-16,1373
1939,7,17,1456,1447,9,1939-7-17,1438
1939,7,18,1731,1727,4,1939-7-18,1723
1939,7,19,2125,2110,15,1939-7-19,2095
1939,7,20,2071,2029,42,1939-7-20,1987
1939,7,21,1561,1498,63,1939-7-21,1435
1939,7,22,1478,1261,217,1939-7-22,1044
1939,7,23,1340,854,486,1939-7-23,368
1939,7,24,992,376,616,1939-7-24,-240
1939,7,25,1015,217,798,1939-7-25,-581
1939,7,26,1065,197,868,1939-7-26,-671
1939,7,27,982,93,889,1939-7-27,-796
1939,7,28,1304,565,739,1939-7-28,-174
1939,7,29,1260,526,734,1939-7-29,-208
1939,7,30,853,619,234,1939-7-30,385
1939,7,31,721,550,171,1939-7-31,379
1939,8,1,1886,1447,439,1939-8-1,1008
1939,8,2,1826,1515,311,1939-8-2,1204
1939,8,3,1745,1477,268,1939-8-3,1209
1939,8,4,1966,1704,262,1939-8-4,1442
1939,8,5,2081,1698,383,1939-8-5,1315
1939,8,6,2133,1697,436,1939-8-6,1261
1939,8,7,1836,1411,425,1939-8-7,986
1939,8,8,2623,1649,974,1939-8-8,675
1939,8,9,3119,1817,1302,1939-8-9,515
1939,8,10,3213,1563,1650,1939-8-10,-87
1939,8,11,2947,1419,1528,1939-8-11,-109
1939,8,12,2912,1406,1506,1939-8-12,-100
1939,8,13,3583,1602,1981,1939-8-13,-379
1939,8,14,3020,1166,1854,1939-8-14,-688
1939,8,15,3008,1518,1490,1939-8-15,28
1939,8,16,2949,1617,1332,1939-8-16,285
1939,8,17,2810,1623,1187,1939-8-17,436
1939,8,18,2573,1662,911,1939-8-18,751
1939,8,19,2665,1791,874,1939-8-19,917
1939,8,20,2440,1637,803,1939-8-20,834
1939,8,21,2684,1925,759,1939-8-21,1166
1939,8,22,1942,1572,370,1939-8-22,1202
1939,8,23,1841,1267,574,1939-8-23,693
1939,8,24,1591,1018,573,1939-8-24,445
1939,8,25,1543,1057,486,1939-8-25,571
1939,8,26,1208,781,427,1939-8-26,354
1939,8,27,1923,813,1110,1939-8-27,-297
1939,8,28,1565,410,1155,1939-8-28,-745
1939,8,29,1707,162,1545,1939-8-29,-1383
1939,8,30,2226,245,1981,1939-8-30,-1736
1939,8,31,2569,312,2257,1939-8-31,-1945
1939,9,1,2791,198,2593,1939-9-1,-2395
1939,9,2,2993,180,2813,1939-9-2,-2633
1939,9,3,3151,172,2979,1939-9-3,-2807
1939,9,4,3957,156,3801,1939-9-4,-3645
1939,9,5,5394,243,5151,1939-9-5,-4908
1939,9,6,6541,321,6220,1939-9-6,-5899
1939,9,7,4218,333,3885,1939-9-7,-3552
1939,9,8,3111,289,2822,1939-9-8,-2533
1939,9,9,3479,197,3282,1939-9-9,-3085
1939,9,10,3567,136,3431,1939-9-10,-3295
1939,9,11,3803,64,3739,1939-9-11,-3675
1939,9,12,3578,121,3457,1939-9-12,-3336
1939,9,13,3781,98,3683,1939-9-13,-3585
1939,9,14,3277,67,3210,1939-9-14,-3143
1939,9,15,3369,29,3340,1939-9-15,-3311
1939,9,16,2438,36,2402,1939-9-16,-2366
1939,9,17,910,23,887,1939-9-17,-864
1939,9,18,1289,28,1261,1939-9-18,-1233
1939,9,19,1383,66,1317,1939-9-19,-1251
1939,9,20,1129,109,1020,1939-9-20,-911
1939,9,21,1061,183,878,1939-9-21,-695
1939,9,22,2121,122,1999,1939-9-22,-1877
1939,9,23,2777,70,2707,1939-9-23,-2637
1939,9,24,3318,302,3016,1939-9-24,-2714
1939,9,25,3665,720,2945,1939-9-25,-2225
1939,9,26,3468,847,2621,1939-9-26,-1774
1939,9,27,3472,914,2558,1939-9-27,-1644
1939,9,28,3482,1438,2044,1939-9-28,-606
1939,9,29,3795,1644,2151,1939-9-29,-507
1939,9,30,3635,1778,1857,1939-9-30,-79
1939,10,1,3854,1658,2196,1939-10-1,-538
1939,10,2,3387,1387,2000,1939-10-2,-613
1939,10,3,3052,1181,1871,1939-10-3,-690
1939,10,4,2274,1163,1111,1939-10-4,52
1939,10,5,1858,890,968,1939-10-5,-78
1939,10,6,1765,808,957,1939-10-6,-149
1939,10,7,1557,668,889,1939-10-7,-221
1939,10,8,1499,468,1031,1939-10-8,-563
1939,10,9,1619,397,1222,1939-10-9,-825
1939,10,10,1293,373,920,1939-10-10,-547
1939,10,11,879,0,879,1939-10-11,-879
1939,10,12,877,78,799,1939-10-12,-721
1939,10,13,1159,292,867,1939-10-13,-575
1939,10,14,1144,208,936,1939-10-14,-728
1939,10,15,1059,190,869,1939-10-15,-679
1939,10,16,1304,411,893,1939-10-16,-482
1939,10,17,1268,388,880,1939-10-17,-492
1939,10,18,990,491,499,1939-10-18,-8
1939,10,19,1114,557,557,1939-10-19,0
1939,10,20,2924,440,2484,1939-10-20,-2044
1939,10,21,2937,233,2704,1939-10-21,-2471
1939,10,22,2908,449,2459,1939-10-22,-2010
1939,10,23,2763,583,2180,1939-10-23,-1597
1939,10,24,2374,511,1863,1939-10-24,-1352
1939,10,25,2490,713,1777,1939-10-25,-1064
1939,10,26,1906,521,1385,1939-10-26,-864
1939,10,27,1916,413,1503,1939-10-27,-1090
1939,10,28,1795,342,1453,1939-10-28,-1111
1939,10,29,1744,402,1342,1939-10-29,-940
1939,10,30,1896,773,1123,1939-10-30,-350
1939,10,31,1923,873,1050,1939-10-31,-177
1939,11,1,1599,996,603,1939-11-1,393
1939,11,2,1364,884,480,1939-11-2,404
1939,11,3,1172,693,479,1939-11-3,214
1939,11,4,1304,673,631,1939-11-4,42
1939,11,5,1100,669,431,1939-11-5,238
1939,11,6,871,454,417,1939-11-6,37
1939,11,7,465,207,258,1939-11-7,-51
1939,11,8,248,0,248,1939-11-8,-248
1939,11,9,161,69,92,1939-11-9,-23
1939,11,10,323,211,112,1939-11-10,99
1939,11,11,463,266,197,1939-11-11,69
1939,11,12,1105,808,297,1939-11-12,511
1939,11,13,1294,919,375,1939-11-13,544
1939,11,14,1514,1010,504,1939-11-14,506
1939,11,15,1253,666,587,1939-11-15,79
1939,11,16,1737,679,1058,1939-11-16,-379
1939,11,17,1592,401,1191,1939-11-17,-790
1939,11,18,1672,356,1316,1939-11-18,-960
1939,11,19,1647,144,1503,1939-11-19,-1359
1939,11,20,1625,85,1540,1939-11-20,-1455
1939,11,21,2112,21,2091,1939-11-21,-2070
1939,11,22,1866,106,1760,1939-11-22,-1654
1939,11,23,1896,228,1668,1939-11-23,-1440
1939,11,24,1945,349,1596,1939-11-24,-1247
1939,11,25,1501,649,852,1939-11-25,-203
1939,11,26,1009,355,654,1939-11-26,-299
1939,11,27,659,15,644,1939-11-27,-629
1939,11,28,583,0,583,1939-11-28,-583
1939,11,29,419,0,419,1939-11-29,-419
1939,11,30,619,0,619,1939-11-30,-619
1939,12,1,1073,0,1073,1939-12-1,-1073
1939,12,2,859,0,859,1939-12-2,-859
1939,12,3,661,19,642,1939-12-3,-623
1939,12,4,413,4,409,1939-12-4,-405
1939,12,5,310,0,310,1939-12-5,-310
1939,12,6,95,0,95,1939-12-6,-95
1939,12,7,193,0,193,1939-12-7,-193
1939,12,8,350,24,326,1939-12-8,-302
1939,12,9,332,18,314,1939-12-9,-296
1939,12,10,458,7,451,1939-12-10,-444
1939,12,11,725,252,473,1939-12-11,-221
1939,12,12,696,416,280,1939-12-12,136
1939,12,13,621,376,245,1939-12-13,131
1939,12,14,611,340,271,1939-12-14,69
1939,12,15,618,372,246,1939-12-15,126
1939,12,16,631,443,188,1939-12-16,255
1939,12,17,665,520,145,1939-12-17,375
1939,12,18,802,614,188,1939-12-18,426
1939,12,19,765,697,68,1939-12-19,629
1939,12,20,860,526,334,1939-12-20,192
1939,12,21,972,424,548,1939-12-21,-124
1939,12,22,892,449,443,1939-12-22,6
1939,12,23,637,189,448,1939-12-23,-259
1939,12,24,492,0,492,1939-12-24,-492
1939,12,25,330,0,330,1939-12-25,-330
1939,12,26,282,0,282,1939-12-26,-282
1939,12,27,247,23,224,1939-12-27,-201
1939,12,28,258,30,228,1939-12-28,-198
1939,12,29,282,81,201,1939-12-29,-120
1939,12,30,398,227,171,1939-12-30,56
1939,12,31,270,166,104,1939-12-31,62
1940,1,1,216,154,62,1940-1-1,92
1940,1,2,298,298,0,1940-1-2,298
1940,1,3,611,601,10,1940-1-3,591
1940,1,4,1482,1471,11,1940-1-4,1460
1940,1,5,2493,2493,0,1940-1-5,2493
1940,1,6,3030,3030,0,1940-1-6,3030
1940,1,7,2835,2835,0,1940-1-7,2835
1940,1,8,2603,2600,3,1940-1-8,2597
1940,1,9,2450,2405,45,1940-1-9,2360
1940,1,10,2419,2367,52,1940-1-10,2315
1940,1,11,944,899,45,1940-1-11,854
1940,1,12,192,8,184,1940-1-12,-176
1940,1,13,261,20,241,1940-1-13,-221
1940,1,14,627,22,605,1940-1-14,-583
1940,1,15,450,6,444,1940-1-15,-438
1940,1,16,627,4,623,1940-1-16,-619
1940,1,17,629,0,629,1940-1-17,-629
1940,1,18,667,0,667,1940-1-18,-667
1940,1,19,459,26,433,1940-1-19,-407
1940,1,20,509,59,450,1940-1-20,-391
1940,1,21,474,75,399,1940-1-21,-324
1940,1,22,274,30,244,1940-1-22,-214
1940,1,23,419,26,393,1940-1-23,-367
1940,1,24,363,0,363,1940-1-24,-363
1940,1,25,346,0,346,1940-1-25,-346
1940,1,26,1492,1101,391,1940-1-26,710
1940,1,27,2227,1964,263,1940-1-27,1701
1940,1,28,1714,1613,101,1940-1-28,1512
1940,1,29,1511,1422,89,1940-1-29,1333
1940,1,30,1591,1237,354,1940-1-30,883
1940,1,31,1701,1156,545,1940-1-31,611
1940,2,1,1563,1219,344,1940-2-1,875
1940,2,2,1229,911,318,1940-2-2,593
1940,2,3,1574,1120,454,1940-2-3,666
1940,2,4,1444,1052,392,1940-2-4,660
1940,2,5,1439,1021,418,1940-2-5,603
1940,2,6,1368,920,448,1940-2-6,472
1940,2,7,1225,778,447,1940-2-7,331
1940,2,8,752,316,436,1940-2-8,-120
1940,2,9,772,256,516,1940-2-9,-260
1940,2,10,758,334,424,1940-2-10,-90
1940,2,11,814,489,325,1940-2-11,164
1940,2,12,799,490,309,1940-2-12,181
1940,2,13,870,520,350,1940-2-13,170
1940,2,14,1103,517,586,1940-2-14,-69
1940,2,15,1237,358,879,1940-2-15,-521
1940,2,16,1259,206,1053,1940-2-16,-847
1940,2,17,1266,133,1133,1940-2-17,-1000
1940,2,18,992,29,963,1940-2-18,-934
1940,2,19,778,106,672,1940-2-19,-566
1940,2,20,513,63,450,1940-2-20,-387
1940,2,21,440,33,407,1940-2-21,-374
1940,2,22,717,355,362,1940-2-22,-7
1940,2,23,767,325,442,1940-2-23,-117
1940,2,24,595,387,208,1940-2-24,179
1940,2,25,579,336,243,1940-2-25,93
1940,2,26,662,353,309,1940-2-26,44
1940,2,27,689,321,368,1940-2-27,-47
1940,2,28,826,335,491,1940-2-28,-156
1940,2,29,916,284,632,1940-2-29,-348
1940,3,1,1285,316,969,1940-3-1,-653
1940,3,2,1500,348,1152,1940-3-2,-804
1940,3,3,1662,384,1278,1940-3-3,-894
1940,3,4,1903,637,1266,1940-3-4,-629
1940,3,5,2349,798,1551,1940-3-5,-753
1940,3,6,1614,376,1238,1940-3-6,-862
1940,3,7,1677,349,1328,1940-3-7,-979
1940,3,8,1367,246,1121,1940-3-8,-875
1940,3,9,404,60,344,1940-3-9,-284
1940,3,10,450,94,356,1940-3-10,-262
1940,3,11,423,183,240,1940-3-11,-57
1940,3,12,664,280,384,1940-3-12,-104
1940,3,13,499,158,341,1940-3-13,-183
1940,3,14,453,300,153,1940-3-14,147
1940,3,15,620,379,241,1940-3-15,138
1940,3,16,554,370,184,1940-3-16,186
1940,3,17,529,389,140,1940-3-17,249
1940,3,18,525,431,94,1940-3-18,337
1940,3,19,721,523,198,1940-3-19,325
1940,3,20,1567,1244,323,1940-3-20,921
1940,3,21,1809,1491,318,1940-3-21,1173
1940,3,22,1691,1432,259,1940-3-22,1173
1940,3,23,1954,1561,393,1940-3-23,1168
1940,3,24,2336,1789,547,1940-3-24,1242
1940,3,25,2281,1892,389,1940-3-25,1503
1940,3,26,2055,1743,312,1940-3-26,1431
1940,3,27,2407,1707,700,1940-3-27,1007
1940,3,28,2417,1658,759,1940-3-28,899
1940,3,29,2707,2067,640,1940-3-29,1427
1940,3,30,2690,2145,545,1940-3-30,1600
1940,3,31,2378,1852,526,1940-3-31,1326
1940,4,1,1772,1282,490,1940-4-1,792
1940,4,2,861,363,498,1940-4-2,-135
1940,4,3,657,109,548,1940-4-3,-439
1940,4,4,595,104,491,1940-4-4,-387
1940,4,5,619,46,573,1940-4-5,-527
1940,4,6,658,0,658,1940-4-6,-658
1940,4,7,737,22,715,1940-4-7,-693
1940,4,8,476,31,445,1940-4-8,-414
1940,4,9,412,164,248,1940-4-9,-84
1940,4,10,480,286,194,1940-4-10,92
1940,4,11,655,309,346,1940-4-11,-37
1940,4,12,539,50,489,1940-4-12,-439
1940,4,13,256,6,250,1940-4-13,-244
1940,4,14,594,21,573,1940-4-14,-552
1940,4,15,613,13,600,1940-4-15,-587
1940,4,16,904,290,614,1940-4-16,-324
1940,4,17,754,347,407,1940-4-17,-60
1940,4,18,629,353,276,1940-4-18,77
1940,4,19,827,438,389,1940-4-19,49
1940,4,20,720,434,286,1940-4-20,148
1940,4,21,707,473,234,1940-4-21,239
1940,4,22,623,445,178,1940-4-22,267
1940,4,23,494,346,148,1940-4-23,198
1940,4,24,441,291,150,1940-4-24,141
1940,4,25,687,442,245,1940-4-25,197
1940,4,26,707,403,304,1940-4-26,99
1940,4,27,955,476,479,1940-4-27,-3
1940,4,28,431,201,230,1940-4-28,-29
1940,4,29,237,113,124,1940-4-29,-11
1940,4,30,222,112,110,1940-4-30,2
1940,5,1,87,87,0,1940-5-1,87
1940,5,2,85,85,0,1940-5-2,85
1940,5,3,67,60,7,1940-5-3,53
1940,5,4,78,70,8,1940-5-4,62
1940,5,5,114,103,11,1940-5-5,92
1940,5,6,199,199,0,1940-5-6,199
1940,5,7,179,179,0,1940-5-7,179
1940,5,8,167,146,21,1940-5-8,125
1940,5,9,168,136,32,1940-5-9,104
1940,5,10,326,190,136,1940-5-10,54
1940,5,11,456,113,343,1940-5-11,-230
1940,5,12,651,172,479,1940-5-12,-307
1940,5,13,1496,843,653,1940-5-13,190
1940,5,14,1517,870,647,1940-5-14,223
1940,5,15,1368,813,555,1940-5-15,258
1940,5,16,1275,835,440,1940-5-16,395
1940,5,17,1338,785,553,1940-5-17,232
1940,5,18,911,551,360,1940-5-18,191
1940,5,19,757,612,145,1940-5-19,467
1940,5,20,621,555,66,1940-5-20,489
1940,5,21,830,553,277,1940-5-21,276
1940,5,22,849,530,319,1940-5-22,211
1940,5,23,1139,451,688,1940-5-23,-237
1940,5,24,1092,307,785,1940-5-24,-478
1940,5,25,918,154,764,1940-5-25,-610
1940,5,26,778,10,768,1940-5-26,-758
1940,5,27,711,14,697,1940-5-27,-683
1940,5,28,680,38,642,1940-5-28,-604
1940,5,29,504,31,473,1940-5-29,-442
1940,5,30,706,48,658,1940-5-30,-610
1940,5,31,650,17,633,1940-5-31,-616
1940,6,1,543,0,543,1940-6-1,-543
1940,6,2,461,0,461,1940-6-2,-461
1940,6,3,705,44,661,1940-6-3,-617
1940,6,4,965,35,930,1940-6-4,-895
1940,6,5,709,0,709,1940-6-5,-709
1940,6,6,1188,234,954,1940-6-6,-720
1940,6,7,1842,507,1335,1940-6-7,-828
1940,6,8,1916,450,1466,1940-6-8,-1016
1940,6,9,1455,363,1092,1940-6-9,-729
1940,6,10,1528,372,1156,1940-6-10,-784
1940,6,11,1431,379,1052,1940-6-11,-673
1940,6,12,950,346,604,1940-6-12,-258
1940,6,13,1201,315,886,1940-6-13,-571
1940,6,14,1159,335,824,1940-6-14,-489
1940,6,15,1043,311,732,1940-6-15,-421
1940,6,16,1309,255,1054,1940-6-16,-799
1940,6,17,855,148,707,1940-6-17,-559
1940,6,18,981,152,829,1940-6-18,-677
1940,6,19,814,169,645,1940-6-19,-476
1940,6,20,1035,0,1035,1940-6-20,-1035
1940,6,21,1095,21,1074,1940-6-21,-1053
1940,6,22,1112,12,1100,1940-6-22,-1088
1940,6,23,1135,37,1098,1940-6-23,-1061
1940,6,24,1583,166,1417,1940-6-24,-1251
1940,6,25,2015,374,1641,1940-6-25,-1267
1940,6,26,1963,170,1793,1940-6-26,-1623
1940,6,27,2354,203,2151,1940-6-27,-1948
1940,6,28,2167,159,2008,1940-6-28,-1849
1940,6,29,1710,239,1471,1940-6-29,-1232
1940,6,30,1687,296,1391,1940-6-30,-1095
1940,7,1,1389,375,1014,1940-7-1,-639
1940,7,2,544,298,246,1940-7-2,52
1940,7,3,583,258,325,1940-7-3,-67
1940,7,4,419,168,251,1940-7-4,-83
1940,7,5,323,46,277,1940-7-5,-231
1940,7,6,272,121,151,1940-7-6,-30
1940,7,7,374,244,130,1940-7-7,114
1940,7,8,396,286,110,1940-7-8,176
1940,7,9,850,746,104,1940-7-9,642
1940,7,10,2162,1988,174,1940-7-10,1814
1940,7,11,2603,2446,157,1940-7-11,2289
1940,7,12,2848,2742,106,1940-7-12,2636
1940,7,13,2368,2269,99,1940-7-13,2170
1940,7,14,1062,1028,34,1940-7-14,994
1940,7,15,1023,962,61,1940-7-15,901
1940,7,16,804,741,63,1940-7-16,678
1940,7,17,668,563,105,1940-7-17,458
1940,7,18,563,478,85,1940-7-18,393
1940,7,19,620,541,79,1940-7-19,462
1940,7,20,628,453,175,1940-7-20,278
1940,7,21,308,284,24,1940-7-21,260
1940,7,22,413,384,29,1940-7-22,355
1940,7,23,127,13,114,1940-7-23,-101
1940,7,24,297,24,273,1940-7-24,-249
1940,7,25,412,16,396,1940-7-25,-380
1940,7,26,534,7,527,1940-7-26,-520
1940,7,27,789,23,766,1940-7-27,-743
1940,7,28,1098,274,824,1940-7-28,-550
1940,7,29,1289,654,635,1940-7-29,19
1940,7,30,1003,593,410,1940-7-30,183
1940,7,31,916,561,355,1940-7-31,206
1940,8,1,893,554,339,1940-8-1,215
1940,8,2,732,479,253,1940-8-2,226
1940,8,3,857,460,397,1940-8-3,63
1940,8,4,1277,534,743,1940-8-4,-209
1940,8,5,1776,759,1017,1940-8-5,-258
1940,8,6,1940,778,1162,1940-8-6,-384
1940,8,7,2156,1259,897,1940-8-7,362
1940,8,8,2239,1271,968,1940-8-8,303
1940,8,9,2404,1401,1003,1940-8-9,398
1940,8,10,2365,1277,1088,1940-8-10,189
1940,8,11,2733,1272,1461,1940-8-11,-189
1940,8,12,2848,1120,1728,1940-8-12,-608
1940,8,13,3190,1103,2087,1940-8-13,-984
1940,8,14,2736,1076,1660,1940-8-14,-584
1940,8,15,2844,1063,1781,1940-8-15,-718
1940,8,16,2479,836,1643,1940-8-16,-807
1940,8,17,2329,1255,1074,1940-8-17,181
1940,8,18,2619,1589,1030,1940-8-18,559
1940,8,19,2241,1318,923,1940-8-19,395
1940,8,20,2441,1326,1115,1940-8-20,211
1940,8,21,2294,1126,1168,1940-8-21,-42
1940,8,22,2150,1064,1086,1940-8-22,-22
1940,8,23,1057,605,452,1940-8-23,153
1940,8,24,862,450,412,1940-8-24,38
1940,8,25,680,339,341,1940-8-25,-2
1940,8,26,576,248,328,1940-8-26,-80
1940,8,27,949,53,896,1940-8-27,-843
1940,8,28,1630,176,1454,1940-8-28,-1278
1940,8,29,1891,681,1210,1940-8-29,-529
1940,8,30,1865,803,1062,1940-8-30,-259
1940,8,31,1842,659,1183,1940-8-31,-524
1940,9,1,1900,547,1353,1940-9-1,-806
1940,9,2,1293,374,919,1940-9-2,-545
1940,9,3,1502,359,1143,1940-9-3,-784
1940,9,4,1196,232,964,1940-9-4,-732
1940,9,5,1197,231,966,1940-9-5,-735
1940,9,6,1046,196,850,1940-9-6,-654
1940,9,7,553,208,345,1940-9-7,-137
1940,9,8,445,136,309,1940-9-8,-173
1940,9,9,463,111,352,1940-9-9,-241
1940,9,10,434,218,216,1940-9-10,2
1940,9,11,319,247,72,1940-9-11,175
1940,9,12,244,135,109,1940-9-12,26
1940,9,13,153,153,0,1940-9-13,153
1940,9,14,219,205,14,1940-9-14,191
1940,9,15,222,222,0,1940-9-15,222
1940,9,16,426,300,126,1940-9-16,174
1940,9,17,483,161,322,1940-9-17,-161
1940,9,18,909,347,562,1940-9-18,-215
1940,9,19,1733,615,1118,1940-9-19,-503
1940,9,20,2116,879,1237,1940-9-20,-358
1940,9,21,2091,767,1324,1940-9-21,-557
1940,9,22,2131,431,1700,1940-9-22,-1269
1940,9,23,1554,12,1542,1940-9-23,-1530
1940,9,24,1508,91,1417,1940-9-24,-1326
1940,9,25,1340,80,1260,1940-9-25,-1180
1940,9,26,596,0,596,1940-9-26,-596
1940,9,27,528,0,528,1940-9-27,-528
1940,9,28,557,0,557,1940-9-28,-557
1940,9,29,515,44,471,1940-9-29,-427
1940,9,30,702,44,658,1940-9-30,-614
1940,10,1,741,98,643,1940-10-1,-545
1940,10,2,419,77,342,1940-10-2,-265
1940,10,3,425,75,350,1940-10-3,-275
1940,10,4,271,262,9,1940-10-4,253
1940,10,5,282,282,0,1940-10-5,282
1940,10,6,267,267,0,1940-10-6,267
1940,10,7,1433,1249,184,1940-10-7,1065
1940,10,8,1526,1324,202,1940-10-8,1122
1940,10,9,1643,1344,299,1940-10-9,1045
1940,10,10,2027,1086,941,1940-10-10,145
1940,10,11,1966,1138,828,1940-10-11,310
1940,10,12,2208,1194,1014,1940-10-12,180
1940,10,13,1816,937,879,1940-10-13,58
1940,10,14,1478,612,866,1940-10-14,-254
1940,10,15,1494,429,1065,1940-10-15,-636
1940,10,16,1324,274,1050,1940-10-16,-776
1940,10,17,1453,144,1309,1940-10-17,-1165
1940,10,18,1321,85,1236,1940-10-18,-1151
1940,10,19,1438,0,1438,1940-10-19,-1438
1940,10,20,1298,0,1298,1940-10-20,-1298
1940,10,21,1318,0,1318,1940-10-21,-1318
1940,10,22,1398,4,1394,1940-10-22,-1390
1940,10,23,791,0,791,1940-10-23,-791
1940,10,24,679,0,679,1940-10-24,-679
1940,10,25,671,0,671,1940-10-25,-671
1940,10,26,708,0,708,1940-10-26,-708
1940,10,27,614,0,614,1940-10-27,-614
1940,10,28,587,66,521,1940-10-28,-455
1940,10,29,425,48,377,1940-10-29,-329
1940,10,30,509,212,297,1940-10-30,-85
1940,10,31,256,143,113,1940-10-31,30
1940,11,1,315,235,80,1940-11-1,155
1940,11,2,220,198,22,1940-11-2,176
1940,11,3,442,309,133,1940-11-3,176
1940,11,4,333,266,67,1940-11-4,199
1940,11,5,392,318,74,1940-11-5,244
1940,11,6,294,268,26,1940-11-6,242
1940,11,7,330,175,155,1940-11-7,20
1940,11,8,421,238,183,1940-11-8,55
1940,11,9,552,445,107,1940-11-9,338
1940,11,10,601,505,96,1940-11-10,409
1940,11,11,760,667,93,1940-11-11,574
1940,11,12,652,488,164,1940-11-12,324
1940,11,13,830,558,272,1940-11-13,286
1940,11,14,771,534,237,1940-11-14,297
1940,11,15,1340,685,655,1940-11-15,30
1940,11,16,1003,459,544,1940-11-16,-85
1940,11,17,1259,618,641,1940-11-17,-23
1940,11,18,1125,517,608,1940-11-18,-91
1940,11,19,790,358,432,1940-11-19,-74
1940,11,20,379,0,379,1940-11-20,-379
1940,11,21,353,0,353,1940-11-21,-353
1940,11,22,127,0,127,1940-11-22,-127
1940,11,23,151,26,125,1940-11-23,-99
1940,11,24,208,66,142,1940-11-24,-76
1940,11,25,777,541,236,1940-11-25,305
1940,11,26,777,460,317,1940-11-26,143
1940,11,27,592,388,204,1940-11-27,184
1940,11,28,703,435,268,1940-11-28,167
1940,11,29,697,556,141,1940-11-29,415
1940,11,30,635,635,0,1940-11-30,635
1940,12,1,666,666,0,1940-12-1,666
1940,12,2,525,525,0,1940-12-2,525
1940,12,3,400,400,0,1940-12-3,400
1940,12,4,480,400,80,1940-12-4,320
1940,12,5,855,730,125,1940-12-5,605
1940,12,6,1042,726,316,1940-12-6,410
1940,12,7,1009,640,369,1940-12-7,271
1940,12,8,1106,373,733,1940-12-8,-360
1940,12,9,1406,364,1042,1940-12-9,-678
1940,12,10,2039,720,1319,1940-12-10,-599
1940,12,11,1776,825,951,1940-12-11,-126
1940,12,12,1704,862,842,1940-12-12,20
1940,12,13,1654,1150,504,1940-12-13,646
1940,12,14,1703,1135,568,1940-12-14,567
1940,12,15,1565,1065,500,1940-12-15,565
1940,12,16,1027,603,424,1940-12-16,179
1940,12,17,810,372,438,1940-12-17,-66
1940,12,18,691,357,334,1940-12-18,23
1940,12,19,589,333,256,1940-12-19,77
1940,12,20,635,279,356,1940-12-20,-77
1940,12,21,656,343,313,1940-12-21,30
1940,12,22,431,75,356,1940-12-22,-281
1940,12,23,540,96,444,1940-12-23,-348
1940,12,24,612,296,316,1940-12-24,-20
1940,12,25,421,158,263,1940-12-25,-105
1940,12,26,440,216,224,1940-12-26,-8
1940,12,27,339,167,172,1940-12-27,-5
1940,12,28,319,39,280,1940-12-28,-241
1940,12,29,349,138,211,1940-12-29,-73
1940,12,30,468,197,271,1940-12-30,-74
1940,12,31,351,165,186,1940-12-31,-21
1941,1,1,428,258,170,1941-1-1,88
1941,1,2,273,210,63,1941-1-2,147
1941,1,3,260,243,17,1941-1-3,226
1941,1,4,313,304,9,1941-1-4,295
1941,1,5,445,390,55,1941-1-5,335
1941,1,6,345,113,232,1941-1-6,-119
1941,1,7,559,190,369,1941-1-7,-179
1941,1,8,778,250,528,1941-1-8,-278
1941,1,9,545,235,310,1941-1-9,-75
1941,1,10,390,266,124,1941-1-10,142
1941,1,11,348,259,89,1941-1-11,170
1941,1,12,251,196,55,1941-1-12,141
1941,1,13,103,84,19,1941-1-13,65
1941,1,14,96,84,12,1941-1-14,72
1941,1,15,55,55,0,1941-1-15,55
1941,1,16,238,218,20,1941-1-16,198
1941,1,17,240,240,0,1941-1-17,240
1941,1,18,185,185,0,1941-1-18,185
1941,1,19,204,192,12,1941-1-19,180
1941,1,20,214,163,51,1941-1-20,112
1941,1,21,419,173,246,1941-1-21,-73
1941,1,22,420,146,274,1941-1-22,-128
1941,1,23,398,131,267,1941-1-23,-136
1941,1,24,457,158,299,1941-1-24,-141
1941,1,25,835,659,176,1941-1-25,483
1941,1,26,957,813,144,1941-1-26,669
1941,1,27,813,736,77,1941-1-27,659
1941,1,28,818,668,150,1941-1-28,518
1941,1,29,1169,650,519,1941-1-29,131
1941,1,30,1306,739,567,1941-1-30,172
1941,1,31,1139,586,553,1941-1-31,33
1941,2,1,1204,650,554,1941-2-1,96
1941,2,2,888,389,499,1941-2-2,-110
1941,2,3,689,202,487,1941-2-3,-285
1941,2,4,581,153,428,1941-2-4,-275
1941,2,5,602,286,316,1941-2-5,-30
1941,2,6,463,209,254,1941-2-6,-45
1941,2,7,295,89,206,1941-2-7,-117
1941,2,8,190,60,130,1941-2-8,-70
1941,2,9,267,63,204,1941-2-9,-141
1941,2,10,257,111,146,1941-2-10,-35
1941,2,11,242,78,164,1941-2-11,-86
1941,2,12,219,110,109,1941-2-12,1
1941,2,13,248,117,131,1941-2-13,-14
1941,2,14,256,134,122,1941-2-14,12
1941,2,15,255,135,120,1941-2-15,15
1941,2,16,248,56,192,1941-2-16,-136
1941,2,17,240,0,240,1941-2-17,-240
1941,2,18,178,0,178,1941-2-18,-178
1941,2,19,83,0,83,1941-2-19,-83
1941,2,20,235,0,235,1941-2-20,-235
1941,2,21,267,50,217,1941-2-21,-167
1941,2,22,451,193,258,1941-2-22,-65
1941,2,23,472,462,10,1941-2-23,452
1941,2,24,717,717,0,1941-2-24,717
1941,2,25,965,940,25,1941-2-25,915
1941,2,26,830,830,0,1941-2-26,830
1941,2,27,1027,1005,22,1941-2-27,983
1941,2,28,1040,1026,14,1941-2-28,1012
1941,3,1,1017,1017,0,1941-3-1,1017
1941,3,2,735,735,0,1941-3-2,735
1941,3,3,571,571,0,1941-3-3,571
1941,3,4,652,652,0,1941-3-4,652
1941,3,5,576,564,12,1941-3-5,552
1941,3,6,398,398,0,1941-3-6,398
1941,3,7,306,270,36,1941-3-7,234
1941,3,8,316,316,0,1941-3-8,316
1941,3,9,411,348,63,1941-3-9,285
1941,3,10,557,406,151,1941-3-10,255
1941,3,11,969,763,206,1941-3-11,557
1941,3,12,835,673,162,1941-3-12,511
1941,3,13,354,291,63,1941-3-13,228
1941,3,14,483,315,168,1941-3-14,147
1941,3,15,316,209,107,1941-3-15,102
1941,3,16,492,159,333,1941-3-16,-174
1941,3,17,595,190,405,1941-3-17,-215
1941,3,18,710,397,313,1941-3-18,84
1941,3,19,771,494,277,1941-3-19,217
1941,3,20,958,666,292,1941-3-20,374
1941,3,21,735,491,244,1941-3-21,247
1941,3,22,640,405,235,1941-3-22,170
1941,3,23,637,400,237,1941-3-23,163
1941,3,24,574,448,126,1941-3-24,322
1941,3,25,365,269,96,1941-3-25,173
1941,3,26,173,117,56,1941-3-26,61
1941,3,27,315,294,21,1941-3-27,273
1941,3,28,282,273,9,1941-3-28,264
1941,3,29,147,147,0,1941-3-29,147
1941,3,30,107,107,0,1941-3-30,107
1941,3,31,107,107,0,1941-3-31,107
1941,4,1,147,69,78,1941-4-1,-9
1941,4,2,108,55,53,1941-4-2,2
1941,4,3,67,22,45,1941-4-3,-23
1941,4,4,70,12,58,1941-4-4,-46
1941,4,5,65,12,53,1941-4-5,-41
1941,4,6,52,0,52,1941-4-6,-52
1941,4,7,302,9,293,1941-4-7,-284
1941,4,8,296,12,284,1941-4-8,-272
1941,4,9,346,13,333,1941-4-9,-320
1941,4,10,273,0,273,1941-4-10,-273
1941,4,11,195,0,195,1941-4-11,-195
1941,4,12,188,0,188,1941-4-12,-188
1941,4,13,56,0,56,1941-4-13,-56
1941,4,14,42,35,7,1941-4-14,28
1941,4,15,21,0,21,1941-4-15,-21
1941,4,16,36,13,23,1941-4-16,-10
1941,4,17,152,0,152,1941-4-17,-152
1941,4,18,247,28,219,1941-4-18,-191
1941,4,19,569,0,569,1941-4-19,-569
1941,4,20,480,0,480,1941-4-20,-480
1941,4,21,624,0,624,1941-4-21,-624
1941,4,22,643,0,643,1941-4-22,-643
1941,4,23,704,11,693,1941-4-23,-682
1941,4,24,597,33,564,1941-4-24,-531
1941,4,25,527,115,412,1941-4-25,-297
1941,4,26,1021,155,866,1941-4-26,-711
1941,4,27,841,121,720,1941-4-27,-599
1941,4,28,671,63,608,1941-4-28,-545
1941,4,29,554,38,516,1941-4-29,-478
1941,4,30,524,23,501,1941-4-30,-478
1941,5,1,388,121,267,1941-5-1,-146
1941,5,2,269,136,133,1941-5-2,3
1941,5,3,377,193,184,1941-5-3,9
1941,5,4,373,228,145,1941-5-4,83
1941,5,5,304,185,119,1941-5-5,66
1941,5,6,123,101,22,1941-5-6,79
1941,5,7,85,74,11,1941-5-7,63
1941,5,8,65,65,0,1941-5-8,65
1941,5,9,178,178,0,1941-5-9,178
1941,5,10,296,296,0,1941-5-10,296
1941,5,11,362,362,0,1941-5-11,362
1941,5,12,269,246,23,1941-5-12,223
1941,5,13,224,204,20,1941-5-13,184
1941,5,14,125,109,16,1941-5-14,93
1941,5,15,208,67,141,1941-5-15,-74
1941,5,16,164,44,120,1941-5-16,-76
1941,5,17,155,76,79,1941-5-17,-3
1941,5,18,158,44,114,1941-5-18,-70
1941,5,19,92,7,85,1941-5-19,-78
1941,5,20,169,0,169,1941-5-20,-169
1941,5,21,219,31,188,1941-5-21,-157
1941,5,22,173,26,147,1941-5-22,-121
1941,5,23,176,64,112,1941-5-23,-48
1941,5,24,255,90,165,1941-5-24,-75
1941,5,25,188,77,111,1941-5-25,-34
1941,5,26,151,49,102,1941-5-26,-53
1941,5,27,100,24,76,1941-5-27,-52
1941,5,28,78,21,57,1941-5-28,-36
1941,5,29,5,5,0,1941-5-29,5
1941,5,30,362,0,362,1941-5-30,-362
1941,5,31,310,0,310,1941-5-31,-310
1941,6,1,411,18,393,1941-6-1,-375
1941,6,2,297,0,297,1941-6-2,-297
1941,6,3,632,247,385,1941-6-3,-138
1941,6,4,793,382,411,1941-6-4,-29
1941,6,5,987,379,608,1941-6-5,-229
1941,6,6,944,406,538,1941-6-6,-132
1941,6,7,692,320,372,1941-6-7,-52
1941,6,8,910,533,377,1941-6-8,156
1941,6,9,1005,725,280,1941-6-9,445
1941,6,10,1276,1107,169,1941-6-10,938
1941,6,11,1209,1056,153,1941-6-11,903
1941,6,12,927,728,199,1941-6-12,529
1941,6,13,881,688,193,1941-6-13,495
1941,6,14,766,647,119,1941-6-14,528
1941,6,15,442,358,84,1941-6-15,274
1941,6,16,362,322,40,1941-6-16,282
1941,6,17,377,358,19,1941-6-17,339
1941,6,18,359,280,79,1941-6-18,201
1941,6,19,356,283,73,1941-6-19,210
1941,6,20,466,297,169,1941-6-20,128
1941,6,21,300,118,182,1941-6-21,-64
1941,6,22,178,121,57,1941-6-22,64
1941,6,23,496,187,309,1941-6-23,-122
1941,6,24,714,444,270,1941-6-24,174
1941,6,25,929,731,198,1941-6-25,533
1941,6,26,947,785,162,1941-6-26,623
1941,6,27,1008,916,92,1941-6-27,824
1941,6,28,1360,1254,106,1941-6-28,1148
1941,6,29,1675,1532,143,1941-6-29,1389
1941,6,30,1576,1503,73,1941-6-30,1430
1941,7,1,1329,1251,78,1941-7-1,1173
1941,7,2,1256,1187,69,1941-7-2,1118
1941,7,3,796,766,30,1941-7-3,736
1941,7,4,718,648,70,1941-7-4,578
1941,7,5,670,609,61,1941-7-5,548
1941,7,6,667,613,54,1941-7-6,559
1941,7,7,699,658,41,1941-7-7,617
1941,7,8,853,816,37,1941-7-8,779
1941,7,9,1374,1232,142,1941-7-9,1090
1941,7,10,590,428,162,1941-7-10,266
1941,7,11,162,27,135,1941-7-11,-108
1941,7,12,127,38,89,1941-7-12,-51
1941,7,13,83,10,73,1941-7-13,-63
1941,7,14,22,0,22,1941-7-14,-22
1941,7,15,26,0,26,1941-7-15,-26
1941,7,16,79,76,3,1941-7-16,73
1941,7,17,353,275,78,1941-7-17,197
1941,7,18,774,291,483,1941-7-18,-192
1941,7,19,741,264,477,1941-7-19,-213
1941,7,20,851,313,538,1941-7-20,-225
1941,7,21,820,320,500,1941-7-21,-180
1941,7,22,770,322,448,1941-7-22,-126
1941,7,23,1072,308,764,1941-7-23,-456
1941,7,24,1288,399,889,1941-7-24,-490
1941,7,25,1826,818,1008,1941-7-25,-190
1941,7,26,1367,687,680,1941-7-26,7
1941,7,27,2387,1097,1290,1941-7-27,-193
1941,7,28,2380,976,1404,1941-7-28,-428
1941,7,29,2096,749,1347,1941-7-29,-598
1941,7,30,2344,889,1455,1941-7-30,-566
1941,7,31,2390,1059,1331,1941-7-31,-272
1941,8,1,2352,1251,1101,1941-8-1,150
1941,8,2,1847,1265,582,1941-8-2,683
1941,8,3,1524,1158,366,1941-8-3,792
1941,8,4,1171,884,287,1941-8-4,597
1941,8,5,1554,1186,368,1941-8-5,818
1941,8,6,1574,1120,454,1941-8-6,666
1941,8,7,1481,1134,347,1941-8-7,787
1941,8,8,1349,980,369,1941-8-8,611
1941,8,9,1192,847,345,1941-8-9,502
1941,8,10,1019,722,297,1941-8-10,425
1941,8,11,976,714,262,1941-8-11,452
1941,8,12,807,563,244,1941-8-12,319
1941,8,13,228,43,185,1941-8-13,-142
1941,8,14,237,54,183,1941-8-14,-129
1941,8,15,0,0,0,1941-8-15,0
1941,8,16,353,0,353,1941-8-16,-353
1941,8,17,339,0,339,1941-8-17,-339
1941,8,18,559,0,559,1941-8-18,-559
1941,8,19,491,11,480,1941-8-19,-469
1941,8,20,835,351,484,1941-8-20,-133
1941,8,21,986,615,371,1941-8-21,244
1941,8,22,1121,861,260,1941-8-22,601
1941,8,23,1001,775,226,1941-8-23,549
1941,8,24,889,685,204,1941-8-24,481
1941,8,25,645,468,177,1941-8-25,291
1941,8,26,772,556,216,1941-8-26,340
1941,8,27,840,702,138,1941-8-27,564
1941,8,28,561,494,67,1941-8-28,427
1941,8,29,562,485,77,1941-8-29,408
1941,8,30,467,338,129,1941-8-30,209
1941,8,31,410,215,195,1941-8-31,20
1941,9,1,620,358,262,1941-9-1,96
1941,9,2,485,258,227,1941-9-2,31
1941,9,3,442,209,233,1941-9-3,-24
1941,9,4,498,245,253,1941-9-4,-8
1941,9,5,344,88,256,1941-9-5,-168
1941,9,6,415,95,320,1941-9-6,-225
1941,9,7,353,27,326,1941-9-7,-299
1941,9,8,571,98,473,1941-9-8,-375
1941,9,9,463,76,387,1941-9-9,-311
1941,9,10,806,486,320,1941-9-10,166
1941,9,11,1138,879,259,1941-9-11,620
1941,9,12,1448,1275,173,1941-9-12,1102
1941,9,13,1540,1528,12,1941-9-13,1516
1941,9,14,1646,1646,0,1941-9-14,1646
1941,9,15,2121,2051,70,1941-9-15,1981
1941,9,16,2188,2057,131,1941-9-16,1926
1941,9,17,2709,2417,292,1941-9-17,2125
1941,9,18,3441,3059,382,1941-9-18,2677
1941,9,19,3415,3087,328,1941-9-19,2759
1941,9,20,3564,3263,301,1941-9-20,2962
1941,9,21,3440,3253,187,1941-9-21,3066
1941,9,22,2767,2573,194,1941-9-22,2379
1941,9,23,1160,956,204,1941-9-23,752
1941,9,24,475,269,206,1941-9-24,63
1941,9,25,509,256,253,1941-9-25,3
1941,9,26,646,497,149,1941-9-26,348
1941,9,27,1086,727,359,1941-9-27,368
1941,9,28,737,582,155,1941-9-28,427
1941,9,29,737,596,141,1941-9-29,455
1941,9,30,671,562,109,1941-9-30,453
1941,10,1,666,551,115,1941-10-1,436
1941,10,2,627,528,99,1941-10-2,429
1941,10,3,520,488,32,1941-10-3,456
1941,10,4,529,497,32,1941-10-4,465
1941,10,5,656,564,92,1941-10-5,472
1941,10,6,669,608,61,1941-10-6,547
1941,10,7,815,808,7,1941-10-7,801
1941,10,8,1010,1010,0,1941-10-8,1010
1941,10,9,718,718,0,1941-10-9,718
1941,10,10,656,656,0,1941-10-10,656
1941,10,11,644,644,0,1941-10-11,644
1941,10,12,590,590,0,1941-10-12,590
1941,10,13,412,391,21,1941-10-13,370
1941,10,14,443,399,44,1941-10-14,355
1941,10,15,484,358,126,1941-10-15,232
1941,10,16,476,276,200,1941-10-16,76
1941,10,17,555,236,319,1941-10-17,-83
1941,10,18,630,272,358,1941-10-18,-86
1941,10,19,566,332,234,1941-10-19,98
1941,10,20,527,332,195,1941-10-20,137
1941,10,21,513,307,206,1941-10-21,101
1941,10,22,401,234,167,1941-10-22,67
1941,10,23,1201,1082,119,1941-10-23,963
1941,10,24,1495,1470,25,1941-10-24,1445
1941,10,25,1620,1608,12,1941-10-25,1596
1941,10,26,1696,1686,10,1941-10-26,1676
1941,10,27,1418,1409,9,1941-10-27,1400
1941,10,28,1450,1450,0,1941-10-28,1450
1941,10,29,1445,1445,0,1941-10-29,1445
1941,10,30,1181,1181,0,1941-10-30,1181
1941,10,31,1077,1077,0,1941-10-31,1077
1941,11,1,1014,1014,0,1941-11-1,1014
1941,11,2,1212,1212,0,1941-11-2,1212
1941,11,3,1373,1367,6,1941-11-3,1361
1941,11,4,1518,1518,0,1941-11-4,1518
1941,11,5,933,933,0,1941-11-5,933
1941,11,6,317,317,0,1941-11-6,317
1941,11,7,0,0,0,1941-11-7,0
1941,11,8,0,0,0,1941-11-8,0
1941,11,9,0,0,0,1941-11-9,0
1941,11,10,0,0,0,1941-11-10,0
1941,11,11,0,0,0,1941-11-11,0
1941,11,12,31,12,19,1941-11-12,-7
1941,11,13,116,61,55,1941-11-13,6
1941,11,14,297,162,135,1941-11-14,27
1941,11,15,249,83,166,1941-11-15,-83
1941,11,16,197,64,133,1941-11-16,-69
1941,11,17,210,79,131,1941-11-17,-52
1941,11,18,206,65,141,1941-11-18,-76
1941,11,19,319,80,239,1941-11-19,-159
1941,11,20,288,82,206,1941-11-20,-124
1941,11,21,390,161,229,1941-11-21,-68
1941,11,22,1030,144,886,1941-11-22,-742
1941,11,23,1253,539,714,1941-11-23,-175
1941,11,24,1267,668,599,1941-11-24,69
1941,11,25,1488,802,686,1941-11-25,116
1941,11,26,1210,560,650,1941-11-26,-90
1941,11,27,1112,497,615,1941-11-27,-118
1941,11,28,1108,380,728,1941-11-28,-348
1941,11,29,1026,379,647,1941-11-29,-268
1941,11,30,1086,347,739,1941-11-30,-392
1941,12,1,891,285,606,1941-12-1,-321
1941,12,2,626,201,425,1941-12-2,-224
1941,12,3,573,201,372,1941-12-3,-171
1941,12,4,178,57,121,1941-12-4,-64
1941,12,5,363,146,217,1941-12-5,-71
1941,12,6,375,64,311,1941-12-6,-247
1941,12,7,363,39,324,1941-12-7,-285
1941,12,8,547,29,518,1941-12-8,-489
1941,12,9,270,11,259,1941-12-9,-248
1941,12,10,267,21,246,1941-12-10,-225
1941,12,11,457,187,270,1941-12-11,-83
1941,12,12,820,356,464,1941-12-12,-108
1941,12,13,719,301,418,1941-12-13,-117
1941,12,14,637,292,345,1941-12-14,-53
1941,12,15,459,190,269,1941-12-15,-79
1941,12,16,280,71,209,1941-12-16,-138
1941,12,17,268,6,262,1941-12-17,-256
1941,12,18,239,0,239,1941-12-18,-239
1941,12,19,112,0,112,1941-12-19,-112
1941,12,20,0,0,0,1941-12-20,0
1941,12,21,0,0,0,1941-12-21,0
1941,12,22,101,0,101,1941-12-22,-101
1941,12,23,136,3,133,1941-12-23,-130
1941,12,24,160,20,140,1941-12-24,-120
1941,12,25,154,0,154,1941-12-25,-154
1941,12,26,142,0,142,1941-12-26,-142
1941,12,27,182,45,137,1941-12-27,-92
1941,12,28,355,198,157,1941-12-28,41
1941,12,29,583,466,117,1941-12-29,349
1941,12,30,599,495,104,1941-12-30,391
1941,12,31,381,328,53,1941-12-31,275
1942,1,1,333,248,85,1942-1-1,163
1942,1,2,284,173,111,1942-1-2,62
1942,1,3,157,36,121,1942-1-3,-85
1942,1,4,359,63,296,1942-1-4,-233
1942,1,5,419,16,403,1942-1-5,-387
1942,1,6,424,13,411,1942-1-6,-398
1942,1,7,389,0,389,1942-1-7,-389
1942,1,8,769,0,769,1942-1-8,-769
1942,1,9,707,0,707,1942-1-9,-707
1942,1,10,660,0,660,1942-1-10,-660
1942,1,11,703,0,703,1942-1-11,-703
1942,1,12,648,0,648,1942-1-12,-648
1942,1,13,671,127,544,1942-1-13,-417
1942,1,14,698,267,431,1942-1-14,-164
1942,1,15,640,338,302,1942-1-15,36
1942,1,16,576,303,273,1942-1-16,30
1942,1,17,290,290,0,1942-1-17,290
1942,1,18,341,341,0,1942-1-18,341
1942,1,19,329,329,0,1942-1-19,329
1942,1,20,221,221,0,1942-1-20,221
1942,1,21,187,187,0,1942-1-21,187
1942,1,22,151,151,0,1942-1-22,151
1942,1,23,210,210,0,1942-1-23,210
1942,1,24,218,218,0,1942-1-24,218
1942,1,25,145,145,0,1942-1-25,145
1942,1,26,60,60,0,1942-1-26,60
1942,1,27,0,0,0,1942-1-27,0
1942,1,28,0,0,0,1942-1-28,0
1942,1,29,177,0,177,1942-1-29,-177
1942,1,30,255,0,255,1942-1-30,-255
1942,1,31,194,0,194,1942-1-31,-194
1942,2,1,237,0,237,1942-2-1,-237
1942,2,2,360,0,360,1942-2-2,-360
1942,2,3,365,91,274,1942-2-3,-183
1942,2,4,567,289,278,1942-2-4,11
1942,2,5,681,423,258,1942-2-5,165
1942,2,6,1093,788,305,1942-2-6,483
1942,2,7,1280,892,388,1942-2-7,504
1942,2,8,800,366,434,1942-2-8,-68
1942,2,9,408,112,296,1942-2-9,-184
1942,2,10,205,138,67,1942-2-10,71
1942,2,11,121,87,34,1942-2-11,53
1942,2,12,337,297,40,1942-2-12,257
1942,2,13,763,714,49,1942-2-13,665
1942,2,14,987,917,70,1942-2-14,847
1942,2,15,755,735,20,1942-2-15,715
1942,2,16,637,637,0,1942-2-16,637
1942,2,17,586,586,0,1942-2-17,586
1942,2,18,558,558,0,1942-2-18,558
1942,2,19,459,411,48,1942-2-19,363
1942,2,20,566,382,184,1942-2-20,198
1942,2,21,732,386,346,1942-2-21,40
1942,2,22,803,455,348,1942-2-22,107
1942,2,23,2490,2237,253,1942-2-23,1984
1942,2,24,2047,1992,55,1942-2-24,1937
1942,2,25,2472,2352,120,1942-2-25,2232
1942,2,26,2271,2132,139,1942-2-26,1993
1942,2,27,2653,2262,391,1942-2-27,1871
1942,2,28,2524,2149,375,1942-2-28,1774
1942,3,1,2179,1866,313,1942-3-1,1553
1942,3,2,1950,1686,264,1942-3-2,1422
1942,3,3,1302,1175,127,1942-3-3,1048
1942,3,4,1142,1067,75,1942-3-4,992
1942,3,5,1110,1040,70,1942-3-5,970
1942,3,6,980,950,30,1942-3-6,920
1942,3,7,403,403,0,1942-3-7,403
1942,3,8,5,5,0,1942-3-8,5
1942,3,9,0,0,0,1942-3-9,0
1942,3,10,0,0,0,1942-3-10,0
1942,3,11,19,0,19,1942-3-11,-19
1942,3,12,22,22,0,1942-3-12,22
1942,3,13,29,29,0,1942-3-13,29
1942,3,14,79,79,0,1942-3-14,79
1942,3,15,429,429,0,1942-3-15,429
1942,3,16,544,544,0,1942-3-16,544
1942,3,17,664,578,86,1942-3-17,492
1942,3,18,854,677,177,1942-3-18,500
1942,3,19,975,724,251,1942-3-19,473
1942,3,20,1046,635,411,1942-3-20,224
1942,3,21,1604,984,620,1942-3-21,364
1942,3,22,1958,1541,417,1942-3-22,1124
1942,3,23,2201,1826,375,1942-3-23,1451
1942,3,24,1999,1595,404,1942-3-24,1191
1942,3,25,1629,1384,245,1942-3-25,1139
1942,3,26,1416,1311,105,1942-3-26,1206
1942,3,27,1126,1099,27,1942-3-27,1072
1942,3,28,738,732,6,1942-3-28,726
1942,3,29,820,820,0,1942-3-29,820
1942,3,30,791,765,26,1942-3-30,739
1942,3,31,617,558,59,1942-3-31,499
1942,4,1,386,353,33,1942-4-1,320
1942,4,2,256,220,36,1942-4-2,184
1942,4,3,49,49,0,1942-4-3,49
1942,4,4,228,228,0,1942-4-4,228
1942,4,5,107,107,0,1942-4-5,107
1942,4,6,63,23,40,1942-4-6,-17
1942,4,7,182,40,142,1942-4-7,-102
1942,4,8,578,31,547,1942-4-8,-516
1942,4,9,460,0,460,1942-4-9,-460
1942,4,10,492,0,492,1942-4-10,-492
1942,4,11,815,194,621,1942-4-11,-427
1942,4,12,1230,306,924,1942-4-12,-618
1942,4,13,1477,409,1068,1942-4-13,-659
1942,4,14,1921,706,1215,1942-4-14,-509
1942,4,15,1193,596,597,1942-4-15,-1
1942,4,16,1042,946,96,1942-4-16,850
1942,4,17,1222,1173,49,1942-4-17,1124
1942,4,18,1574,1513,61,1942-4-18,1452
1942,4,19,1395,1340,55,1942-4-19,1285
1942,4,20,1860,1716,144,1942-4-20,1572
1942,4,21,1870,1499,371,1942-4-21,1128
1942,4,22,2234,1503,731,1942-4-22,772
1942,4,23,1691,1018,673,1942-4-23,345
1942,4,24,1282,732,550,1942-4-24,182
1942,4,25,1417,877,540,1942-4-25,337
1942,4,26,1211,846,365,1942-4-26,481
1942,4,27,1352,949,403,1942-4-27,546
1942,4,28,494,336,158,1942-4-28,178
1942,4,29,590,353,237,1942-4-29,116
1942,4,30,657,402,255,1942-4-30,147
1942,5,1,474,256,218,1942-5-1,38
1942,5,2,218,69,149,1942-5-2,-80
1942,5,3,321,160,161,1942-5-3,-1
1942,5,4,354,221,133,1942-5-4,88
1942,5,5,476,403,73,1942-5-5,330
1942,5,6,123,86,37,1942-5-6,49
1942,5,7,325,293,32,1942-5-7,261
1942,5,8,315,309,6,1942-5-8,303
1942,5,9,417,365,52,1942-5-9,313
1942,5,10,611,363,248,1942-5-10,115
1942,5,11,673,322,351,1942-5-11,-29
1942,5,12,545,229,316,1942-5-12,-87
1942,5,13,558,214,344,1942-5-13,-130
1942,5,14,499,199,300,1942-5-14,-101
1942,5,15,508,183,325,1942-5-15,-142
1942,5,16,487,200,287,1942-5-16,-87
1942,5,17,490,278,212,1942-5-17,66
1942,5,18,358,189,169,1942-5-18,20
1942,5,19,291,134,157,1942-5-19,-23
1942,5,20,101,54,47,1942-5-20,7
1942,5,21,87,72,15,1942-5-21,57
1942,5,22,71,71,0,1942-5-22,71
1942,5,23,56,56,0,1942-5-23,56
1942,5,24,57,57,0,1942-5-24,57
1942,5,25,32,32,0,1942-5-25,32
1942,5,26,16,16,0,1942-5-26,16
1942,5,27,33,13,20,1942-5-27,-7
1942,5,28,33,22,11,1942-5-28,11
1942,5,29,6,0,6,1942-5-29,-6
1942,5,30,6,0,6,1942-5-30,-6
1942,5,31,0,0,0,1942-5-31,0
1942,6,1,17,17,0,1942-6-1,17
1942,6,2,21,21,0,1942-6-2,21
1942,6,3,23,23,0,1942-6-3,23
1942,6,4,13,13,0,1942-6-4,13
1942,6,5,12,12,0,1942-6-5,12
1942,6,6,52,52,0,1942-6-6,52
1942,6,7,123,123,0,1942-6-7,123
1942,6,8,112,112,0,1942-6-8,112
1942,6,9,64,64,0,1942-6-9,64
1942,6,10,54,54,0,1942-6-10,54
1942,6,11,17,17,0,1942-6-11,17
1942,6,12,0,0,0,1942-6-12,0
1942,6,13,20,20,0,1942-6-13,20
1942,6,14,26,26,0,1942-6-14,26
1942,6,15,5,5,0,1942-6-15,5
1942,6,16,146,141,5,1942-6-16,136
1942,6,17,209,209,0,1942-6-17,209
1942,6,18,185,185,0,1942-6-18,185
1942,6,19,139,97,42,1942-6-19,55
1942,6,20,262,198,64,1942-6-20,134
1942,6,21,179,146,33,1942-6-21,113
1942,6,22,132,120,12,1942-6-22,108
1942,6,23,186,161,25,1942-6-23,136
1942,6,24,135,99,36,1942-6-24,63
1942,6,25,149,107,42,1942-6-25,65
1942,6,26,71,47,24,1942-6-26,23
1942,6,27,135,135,0,1942-6-27,135
1942,6,28,197,197,0,1942-6-28,197
1942,6,29,0,0,0,1942-6-29,0
1942,6,30,0,0,0,1942-6-30,0
1942,7,1,0,0,0,1942-7-1,0
1942,7,2,101,0,101,1942-7-2,-101
1942,7,3,96,0,96,1942-7-3,-96
1942,7,4,133,0,133,1942-7-4,-133
1942,7,5,430,0,430,1942-7-5,-430
1942,7,6,780,0,780,1942-7-6,-780
1942,7,7,678,0,678,1942-7-7,-678
1942,7,8,517,0,517,1942-7-8,-517
1942,7,9,436,0,436,1942-7-9,-436
1942,7,10,364,0,364,1942-7-10,-364
1942,7,11,322,0,322,1942-7-11,-322
1942,7,12,282,12,270,1942-7-12,-258
1942,7,13,286,10,276,1942-7-13,-266
1942,7,14,11,0,11,1942-7-14,-11
1942,7,15,93,0,93,1942-7-15,-93
1942,7,16,49,0,49,1942-7-16,-49
1942,7,17,36,0,36,1942-7-17,-36
1942,7,18,0,0,0,1942-7-18,0
1942,7,19,20,0,20,1942-7-19,-20
1942,7,20,56,0,56,1942-7-20,-56
1942,7,21,73,0,73,1942-7-21,-73
1942,7,22,71,0,71,1942-7-22,-71
1942,7,23,26,13,13,1942-7-23,0
1942,7,24,0,0,0,1942-7-24,0
1942,7,25,17,0,17,1942-7-25,-17
1942,7,26,20,0,20,1942-7-26,-20
1942,7,27,10,0,10,1942-7-27,-10
1942,7,28,263,0,263,1942-7-28,-263
1942,7,29,209,25,184,1942-7-29,-159
1942,7,30,256,63,193,1942-7-30,-130
1942,7,31,194,12,182,1942-7-31,-170
1942,8,1,206,6,200,1942-8-1,-194
1942,8,2,182,20,162,1942-8-2,-142
1942,8,3,208,22,186,1942-8-3,-164
1942,8,4,190,47,143,1942-8-4,-96
1942,8,5,182,14,168,1942-8-5,-154
1942,8,6,145,13,132,1942-8-6,-119
1942,8,7,154,27,127,1942-8-7,-100
1942,8,8,229,104,125,1942-8-8,-21
1942,8,9,235,96,139,1942-8-9,-43
1942,8,10,66,66,0,1942-8-10,66
1942,8,11,21,21,0,1942-8-11,21
1942,8,12,13,13,0,1942-8-12,13
1942,8,13,49,49,0,1942-8-13,49
1942,8,14,64,64,0,1942-8-14,64
1942,8,15,51,51,0,1942-8-15,51
1942,8,16,37,37,0,1942-8-16,37
1942,8,17,38,38,0,1942-8-17,38
1942,8,18,13,13,0,1942-8-18,13
1942,8,19,7,7,0,1942-8-19,7
1942,8,20,192,192,0,1942-8-20,192
1942,8,21,328,316,12,1942-8-21,304
1942,8,22,378,378,0,1942-8-22,378
1942,8,23,332,235,97,1942-8-23,138
1942,8,24,656,264,392,1942-8-24,-128
1942,8,25,551,246,305,1942-8-25,-59
1942,8,26,787,468,319,1942-8-26,149
1942,8,27,791,400,391,1942-8-27,9
1942,8,28,736,313,423,1942-8-28,-110
1942,8,29,407,259,148,1942-8-29,111
1942,8,30,146,146,0,1942-8-30,146
1942,8,31,120,120,0,1942-8-31,120
1942,9,1,12,12,0,1942-9-1,12
1942,9,2,12,12,0,1942-9-2,12
1942,9,3,37,12,25,1942-9-3,-13
1942,9,4,45,28,17,1942-9-4,11
1942,9,5,55,15,40,1942-9-5,-25
1942,9,6,195,0,195,1942-9-6,-195
1942,9,7,345,0,345,1942-9-7,-345
1942,9,8,220,0,220,1942-9-8,-220
1942,9,9,184,0,184,1942-9-9,-184
1942,9,10,61,0,61,1942-9-10,-61
1942,9,11,6,0,6,1942-9-11,-6
1942,9,12,28,0,28,1942-9-12,-28
1942,9,13,184,0,184,1942-9-13,-184
1942,9,14,191,0,191,1942-9-14,-191
1942,9,15,135,5,130,1942-9-15,-125
1942,9,16,126,0,126,1942-9-16,-126
1942,9,17,96,0,96,1942-9-17,-96
1942,9,18,101,0,101,1942-9-18,-101
1942,9,19,130,0,130,1942-9-19,-130
1942,9,20,104,0,104,1942-9-20,-104
1942,9,21,134,42,92,1942-9-21,-50
1942,9,22,167,103,64,1942-9-22,39
1942,9,23,127,102,25,1942-9-23,77
1942,9,24,81,81,0,1942-9-24,81
1942,9,25,49,35,14,1942-9-25,21
1942,9,26,56,27,29,1942-9-26,-2
1942,9,27,31,13,18,1942-9-27,-5
1942,9,28,87,0,87,1942-9-28,-87
1942,9,29,165,0,165,1942-9-29,-165
1942,9,30,97,0,97,1942-9-30,-97
1942,10,1,136,0,136,1942-10-1,-136
1942,10,2,63,10,53,1942-10-2,-43
1942,10,3,30,8,22,1942-10-3,-14
1942,10,4,0,0,0,1942-10-4,0
1942,10,5,0,0,0,1942-10-5,0
1942,10,6,0,0,0,1942-10-6,0
1942,10,7,15,0,15,1942-10-7,-15
1942,10,8,48,0,48,1942-10-8,-48
1942,10,9,55,0,55,1942-10-9,-55
1942,10,10,409,0,409,1942-10-10,-409
1942,10,11,355,0,355,1942-10-11,-355
1942,10,12,696,0,696,1942-10-12,-696
1942,10,13,206,0,206,1942-10-13,-206
1942,10,14,210,0,210,1942-10-14,-210
1942,10,15,206,0,206,1942-10-15,-206
1942,10,16,198,0,198,1942-10-16,-198
1942,10,17,216,0,216,1942-10-17,-216
1942,10,18,198,0,198,1942-10-18,-198
1942,10,19,192,0,192,1942-10-19,-192
1942,10,20,271,52,219,1942-10-20,-167
1942,10,21,264,126,138,1942-10-21,-12
1942,10,22,231,67,164,1942-10-22,-97
1942,10,23,70,64,6,1942-10-23,58
1942,10,24,12,12,0,1942-10-24,12
1942,10,25,0,0,0,1942-10-25,0
1942,10,26,74,0,74,1942-10-26,-74
1942,10,27,452,0,452,1942-10-27,-452
1942,10,28,550,15,535,1942-10-28,-520
1942,10,29,569,24,545,1942-10-29,-521
1942,10,30,568,7,561,1942-10-30,-554
1942,10,31,865,4,861,1942-10-31,-857
1942,11,1,906,0,906,1942-11-1,-906
1942,11,2,1001,0,1001,1942-11-2,-1001
1942,11,3,1006,0,1006,1942-11-3,-1006
1942,11,4,702,0,702,1942-11-4,-702
1942,11,5,598,0,598,1942-11-5,-598
1942,11,6,568,0,568,1942-11-6,-568
1942,11,7,661,0,661,1942-11-7,-661
1942,11,8,799,0,799,1942-11-8,-799
1942,11,9,98,17,81,1942-11-9,-64
1942,11,10,83,4,79,1942-11-10,-75
1942,11,11,97,0,97,1942-11-11,-97
1942,11,12,73,0,73,1942-11-12,-73
1942,11,13,164,0,164,1942-11-13,-164
1942,11,14,301,0,301,1942-11-14,-301
1942,11,15,326,0,326,1942-11-15,-326
1942,11,16,0,0,0,1942-11-16,0
1942,11,17,4,4,0,1942-11-17,4
1942,11,18,3,3,0,1942-11-18,3
1942,11,19,0,0,0,1942-11-19,0
1942,11,20,12,0,12,1942-11-20,-12
1942,11,21,226,112,114,1942-11-21,-2
1942,11,22,280,228,52,1942-11-22,176
1942,11,23,619,529,90,1942-11-23,439
1942,11,24,851,631,220,1942-11-24,411
1942,11,25,753,613,140,1942-11-25,473
1942,11,26,826,697,129,1942-11-26,568
1942,11,27,903,781,122,1942-11-27,659
1942,11,28,753,660,93,1942-11-28,567
1942,11,29,846,677,169,1942-11-29,508
1942,11,30,1103,587,516,1942-11-30,71
1942,12,1,960,422,538,1942-12-1,-116
1942,12,2,1041,423,618,1942-12-2,-195
1942,12,3,938,329,609,1942-12-3,-280
1942,12,4,501,40,461,1942-12-4,-421
1942,12,5,266,41,225,1942-12-5,-184
1942,12,6,57,40,17,1942-12-6,23
1942,12,7,176,168,8,1942-12-7,160
1942,12,8,214,214,0,1942-12-8,214
1942,12,9,235,235,0,1942-12-9,235
1942,12,10,290,290,0,1942-12-10,290
1942,12,11,310,310,0,1942-12-11,310
1942,12,12,210,196,14,1942-12-12,182
1942,12,13,246,225,21,1942-12-13,204
1942,12,14,253,236,17,1942-12-14,219
1942,12,15,198,170,28,1942-12-15,142
1942,12,16,163,163,0,1942-12-16,163
1942,12,17,105,105,0,1942-12-17,105
1942,12,18,92,92,0,1942-12-18,92
1942,12,19,104,104,0,1942-12-19,104
1942,12,20,12,12,0,1942-12-20,12
1942,12,21,12,0,12,1942-12-21,-12
1942,12,22,52,0,52,1942-12-22,-52
1942,12,23,88,14,74,1942-12-23,-60
1942,12,24,105,38,67,1942-12-24,-29
1942,12,25,206,162,44,1942-12-25,118
1942,12,26,239,217,22,1942-12-26,195
1942,12,27,192,192,0,1942-12-27,192
1942,12,28,169,169,0,1942-12-28,169
1942,12,29,142,142,0,1942-12-29,142
1942,12,30,129,129,0,1942-12-30,129
1942,12,31,146,146,0,1942-12-31,146
1943,1,1,108,108,0,1943-1-1,108
1943,1,2,117,117,0,1943-1-2,117
1943,1,3,86,86,0,1943-1-3,86
1943,1,4,89,89,0,1943-1-4,89
1943,1,5,0,0,0,1943-1-5,0
1943,1,6,54,0,54,1943-1-6,-54
1943,1,7,57,0,57,1943-1-7,-57
1943,1,8,214,0,214,1943-1-8,-214
1943,1,9,165,0,165,1943-1-9,-165
1943,1,10,188,0,188,1943-1-10,-188
1943,1,11,116,0,116,1943-1-11,-116
1943,1,12,78,0,78,1943-1-12,-78
1943,1,13,37,0,37,1943-1-13,-37
1943,1,14,16,0,16,1943-1-14,-16
1943,1,15,0,0,0,1943-1-15,0
1943,1,16,40,15,25,1943-1-16,-10
1943,1,17,8,0,8,1943-1-17,-8
1943,1,18,44,0,44,1943-1-18,-44
1943,1,19,114,22,92,1943-1-19,-70
1943,1,20,93,18,75,1943-1-20,-57
1943,1,21,90,65,25,1943-1-21,40
1943,1,22,113,83,30,1943-1-22,53
1943,1,23,53,49,4,1943-1-23,45
1943,1,24,47,47,0,1943-1-24,47
1943,1,25,55,55,0,1943-1-25,55
1943,1,26,73,73,0,1943-1-26,73
1943,1,27,73,73,0,1943-1-27,73
1943,1,28,53,53,0,1943-1-28,53
1943,1,29,38,29,9,1943-1-29,20
1943,1,30,9,0,9,1943-1-30,-9
1943,1,31,14,0,14,1943-1-31,-14
1943,2,1,15,0,15,1943-2-1,-15
1943,2,2,18,0,18,1943-2-2,-18
1943,2,3,84,27,57,1943-2-3,-30
1943,2,4,35,17,18,1943-2-4,-1
1943,2,5,30,30,0,1943-2-5,30
1943,2,6,0,0,0,1943-2-6,0
1943,2,7,10,10,0,1943-2-7,10
1943,2,8,32,0,32,1943-2-8,-32
1943,2,9,272,224,48,1943-2-9,176
1943,2,10,799,766,33,1943-2-10,733
1943,2,11,976,953,23,1943-2-11,930
1943,2,12,821,821,0,1943-2-12,821
1943,2,13,737,737,0,1943-2-13,737
1943,2,14,601,588,13,1943-2-14,575
1943,2,15,672,672,0,1943-2-15,672
1943,2,16,626,626,0,1943-2-16,626
1943,2,17,457,457,0,1943-2-17,457
1943,2,18,125,125,0,1943-2-18,125
1943,2,19,51,51,0,1943-2-19,51
1943,2,20,218,218,0,1943-2-20,218
1943,2,21,482,471,11,1943-2-21,460
1943,2,22,698,698,0,1943-2-22,698
1943,2,23,1021,1021,0,1943-2-23,1021
1943,2,24,1120,1120,0,1943-2-24,1120
1943,2,25,934,934,0,1943-2-25,934
1943,2,26,1228,1228,0,1943-2-26,1228
1943,2,27,1453,1453,0,1943-2-27,1453
1943,2,28,1930,1930,0,1943-2-28,1930
1943,3,1,1514,1514,0,1943-3-1,1514
1943,3,2,1441,1441,0,1943-3-2,1441
1943,3,3,719,719,0,1943-3-3,719
1943,3,4,192,192,0,1943-3-4,192
1943,3,5,453,453,0,1943-3-5,453
1943,3,6,559,559,0,1943-3-6,559
1943,3,7,832,832,0,1943-3-7,832
1943,3,8,1051,1051,0,1943-3-8,1051
1943,3,9,1224,1224,0,1943-3-9,1224
1943,3,10,1265,1265,0,1943-3-10,1265
1943,3,11,1270,1238,32,1943-3-11,1206
1943,3,12,1128,1121,7,1943-3-12,1114
1943,3,13,870,861,9,1943-3-13,852
1943,3,14,796,796,0,1943-3-14,796
1943,3,15,697,697,0,1943-3-15,697
1943,3,16,580,580,0,1943-3-16,580
1943,3,17,11,11,0,1943-3-17,11
1943,3,18,234,234,0,1943-3-18,234
1943,3,19,184,184,0,1943-3-19,184
1943,3,20,182,182,0,1943-3-20,182
1943,3,21,198,198,0,1943-3-21,198
1943,3,22,355,355,0,1943-3-22,355
1943,3,23,505,505,0,1943-3-23,505
1943,3,24,477,477,0,1943-3-24,477
1943,3,25,447,447,0,1943-3-25,447
1943,3,26,412,412,0,1943-3-26,412
1943,3,27,270,270,0,1943-3-27,270
1943,3,28,191,191,0,1943-3-28,191
1943,3,29,295,180,115,1943-3-29,65
1943,3,30,321,189,132,1943-3-30,57
1943,3,31,795,699,96,1943-3-31,603
1943,4,1,678,582,96,1943-4-1,486
1943,4,2,653,539,114,1943-4-2,425
1943,4,3,584,484,100,1943-4-3,384
1943,4,4,611,537,74,1943-4-4,463
1943,4,5,561,513,48,1943-4-5,465
1943,4,6,579,536,43,1943-4-6,493
1943,4,7,568,568,0,1943-4-7,568
1943,4,8,442,442,0,1943-4-8,442
1943,4,9,652,449,203,1943-4-9,246
1943,4,10,529,316,213,1943-4-10,103
1943,4,11,771,337,434,1943-4-11,-97
1943,4,12,796,296,500,1943-4-12,-204
1943,4,13,501,0,501,1943-4-13,-501
1943,4,14,428,0,428,1943-4-14,-428
1943,4,15,487,104,383,1943-4-15,-279
1943,4,16,436,95,341,1943-4-16,-246
1943,4,17,709,395,314,1943-4-17,81
1943,4,18,847,617,230,1943-4-18,387
1943,4,19,836,650,186,1943-4-19,464
1943,4,20,925,792,133,1943-4-20,659
1943,4,21,1018,1018,0,1943-4-21,1018
1943,4,22,1493,1493,0,1943-4-22,1493
1943,4,23,1818,1818,0,1943-4-23,1818
1943,4,24,1655,1655,0,1943-4-24,1655
1943,4,25,1785,1785,0,1943-4-25,1785
1943,4,26,1394,1394,0,1943-4-26,1394
1943,4,27,278,278,0,1943-4-27,278
1943,4,28,183,183,0,1943-4-28,183
1943,4,29,207,207,0,1943-4-29,207
1943,4,30,171,171,0,1943-4-30,171
1943,5,1,180,180,0,1943-5-1,180
1943,5,2,159,159,0,1943-5-2,159
1943,5,3,169,169,0,1943-5-3,169
1943,5,4,182,182,0,1943-5-4,182
1943,5,5,149,149,0,1943-5-5,149
1943,5,6,137,137,0,1943-5-6,137
1943,5,7,139,139,0,1943-5-7,139
1943,5,8,151,151,0,1943-5-8,151
1943,5,9,175,134,41,1943-5-9,93
1943,5,10,8,0,8,1943-5-10,-8
1943,5,11,94,94,0,1943-5-11,94
1943,5,12,520,520,0,1943-5-12,520
1943,5,13,406,406,0,1943-5-13,406
1943,5,14,421,421,0,1943-5-14,421
1943,5,15,402,402,0,1943-5-15,402
1943,5,16,428,372,56,1943-5-16,316
1943,5,17,562,317,245,1943-5-17,72
1943,5,18,795,334,461,1943-5-18,-127
1943,5,19,935,348,587,1943-5-19,-239
1943,5,20,380,346,34,1943-5-20,312
1943,5,21,290,290,0,1943-5-21,290
1943,5,22,249,249,0,1943-5-22,249
1943,5,23,210,210,0,1943-5-23,210
1943,5,24,156,156,0,1943-5-24,156
1943,5,25,102,102,0,1943-5-25,102
1943,5,26,99,99,0,1943-5-26,99
1943,5,27,79,79,0,1943-5-27,79
1943,5,28,49,49,0,1943-5-28,49
1943,5,29,35,35,0,1943-5-29,35
1943,5,30,28,28,0,1943-5-30,28
1943,5,31,19,19,0,1943-5-31,19
1943,6,1,17,17,0,1943-6-1,17
1943,6,2,5,5,0,1943-6-2,5
1943,6,3,8,8,0,1943-6-3,8
1943,6,4,0,0,0,1943-6-4,0
1943,6,5,0,0,0,1943-6-5,0
1943,6,6,0,0,0,1943-6-6,0
1943,6,7,6,6,0,1943-6-7,6
1943,6,8,98,98,0,1943-6-8,98
1943,6,9,136,136,0,1943-6-9,136
1943,6,10,101,101,0,1943-6-10,101
1943,6,11,97,97,0,1943-6-11,97
1943,6,12,92,92,0,1943-6-12,92
1943,6,13,95,95,0,1943-6-13,95
1943,6,14,107,107,0,1943-6-14,107
1943,6,15,44,44,0,1943-6-15,44
1943,6,16,46,46,0,1943-6-16,46
1943,6,17,31,31,0,1943-6-17,31
1943,6,18,10,10,0,1943-6-18,10
1943,6,19,9,9,0,1943-6-19,9
1943,6,20,0,0,0,1943-6-20,0
1943,6,21,29,0,29,1943-6-21,-29
1943,6,22,9,0,9,1943-6-22,-9
1943,6,23,48,0,48,1943-6-23,-48
1943,6,24,55,0,55,1943-6-24,-55
1943,6,25,22,0,22,1943-6-25,-22
1943,6,26,18,0,18,1943-6-26,-18
1943,6,27,8,0,8,1943-6-27,-8
1943,6,28,8,0,8,1943-6-28,-8
1943,6,29,0,0,0,1943-6-29,0
1943,6,30,3,3,0,1943-6-30,3
1943,7,1,8,0,8,1943-7-1,-8
1943,7,2,0,0,0,1943-7-2,0
1943,7,3,0,0,0,1943-7-3,0
1943,7,4,0,0,0,1943-7-4,0
1943,7,5,0,0,0,1943-7-5,0
1943,7,6,0,0,0,1943-7-6,0
1943,7,7,171,171,0,1943-7-7,171
1943,7,8,435,435,0,1943-7-8,435
1943,7,9,662,662,0,1943-7-9,662
1943,7,10,861,861,0,1943-7-10,861
1943,7,11,699,699,0,1943-7-11,699
1943,7,12,649,649,0,1943-7-12,649
1943,7,13,644,644,0,1943-7-13,644
1943,7,14,534,534,0,1943-7-14,534
1943,7,15,510,510,0,1943-7-15,510
1943,7,16,404,404,0,1943-7-16,404
1943,7,17,330,330,0,1943-7-17,330
1943,7,18,320,320,0,1943-7-18,320
1943,7,19,394,394,0,1943-7-19,394
1943,7,20,0,0,0,1943-7-20,0
1943,7,21,0,0,0,1943-7-21,0
1943,7,22,0,0,0,1943-7-22,0
1943,7,23,0,0,0,1943-7-23,0
1943,7,24,18,4,14,1943-7-24,-10
1943,7,25,40,0,40,1943-7-25,-40
1943,7,26,52,0,52,1943-7-26,-52
1943,7,27,248,151,97,1943-7-27,54
1943,7,28,199,67,132,1943-7-28,-65
1943,7,29,181,55,126,1943-7-29,-71
1943,7,30,57,50,7,1943-7-30,43
1943,7,31,23,23,0,1943-7-31,23
1943,8,1,18,18,0,1943-8-1,18
1943,8,2,0,0,0,1943-8-2,0
1943,8,3,124,124,0,1943-8-3,124
1943,8,4,183,183,0,1943-8-4,183
1943,8,5,205,205,0,1943-8-5,205
1943,8,6,185,185,0,1943-8-6,185
1943,8,7,162,162,0,1943-8-7,162
1943,8,8,217,183,34,1943-8-8,149
1943,8,9,335,198,137,1943-8-9,61
1943,8,10,261,145,116,1943-8-10,29
1943,8,11,283,137,146,1943-8-11,-9
1943,8,12,265,143,122,1943-8-12,21
1943,8,13,269,104,165,1943-8-13,-61
1943,8,14,281,168,113,1943-8-14,55
1943,8,15,244,115,129,1943-8-15,-14
1943,8,16,186,93,93,1943-8-16,0
1943,8,17,214,97,117,1943-8-17,-20
1943,8,18,181,84,97,1943-8-18,-13
1943,8,19,266,145,121,1943-8-19,24
1943,8,20,126,42,84,1943-8-20,-42
1943,8,21,65,22,43,1943-8-21,-21
1943,8,22,51,18,33,1943-8-22,-15
1943,8,23,30,7,23,1943-8-23,-16
1943,8,24,34,21,13,1943-8-24,8
1943,8,25,41,32,9,1943-8-25,23
1943,8,26,6,0,6,1943-8-26,-6
1943,8,27,28,0,28,1943-8-27,-28
1943,8,28,85,0,85,1943-8-28,-85
1943,8,29,40,0,40,1943-8-29,-40
1943,8,30,23,0,23,1943-8-30,-23
1943,8,31,16,0,16,1943-8-31,-16
1943,9,1,0,0,0,1943-9-1,0
1943,9,2,0,0,0,1943-9-2,0
1943,9,3,0,0,0,1943-9-3,0
1943,9,4,0,0,0,1943-9-4,0
1943,9,5,0,0,0,1943-9-5,0
1943,9,6,0,0,0,1943-9-6,0
1943,9,7,124,124,0,1943-9-7,124
1943,9,8,507,507,0,1943-9-8,507
1943,9,9,882,882,0,1943-9-9,882
1943,9,10,1007,1001,6,1943-9-10,995
1943,9,11,955,955,0,1943-9-11,955
1943,9,12,467,467,0,1943-9-12,467
1943,9,13,0,0,0,1943-9-13,0
1943,9,14,0,0,0,1943-9-14,0
1943,9,15,0,0,0,1943-9-15,0
1943,9,16,0,0,0,1943-9-16,0
1943,9,17,0,0,0,1943-9-17,0
1943,9,18,146,4,142,1943-9-18,-138
1943,9,19,164,0,164,1943-9-19,-164
1943,9,20,131,0,131,1943-9-20,-131
1943,9,21,96,0,96,1943-9-21,-96
1943,9,22,44,0,44,1943-9-22,-44
1943,9,23,16,0,16,1943-9-23,-16
1943,9,24,21,0,21,1943-9-24,-21
1943,9,25,0,0,0,1943-9-25,0
1943,9,26,319,319,0,1943-9-26,319
1943,9,27,513,513,0,1943-9-27,513
1943,9,28,631,631,0,1943-9-28,631
1943,9,29,603,603,0,1943-9-29,603
1943,9,30,634,634,0,1943-9-30,634
1943,10,1,586,586,0,1943-10-1,586
1943,10,2,586,586,0,1943-10-2,586
1943,10,3,576,576,0,1943-10-3,576
1943,10,4,552,552,0,1943-10-4,552
1943,10,5,581,581,0,1943-10-5,581
1943,10,6,588,588,0,1943-10-6,588
1943,10,7,534,534,0,1943-10-7,534
1943,10,8,515,515,0,1943-10-8,515
1943,10,9,497,479,18,1943-10-9,461
1943,10,10,22,0,22,1943-10-10,-22
1943,10,11,10,0,10,1943-10-11,-10
1943,10,12,5,0,5,1943-10-12,-5
1943,10,13,0,0,0,1943-10-13,0
1943,10,14,0,0,0,1943-10-14,0
1943,10,15,0,0,0,1943-10-15,0
1943,10,16,0,0,0,1943-10-16,0
1943,10,17,0,0,0,1943-10-17,0
1943,10,18,10,0,10,1943-10-18,-10
1943,10,19,13,0,13,1943-10-19,-13
1943,10,20,0,0,0,1943-10-20,0
1943,10,21,0,0,0,1943-10-21,0
1943,10,22,0,0,0,1943-10-22,0
1943,10,23,0,0,0,1943-10-23,0
1943,10,24,350,350,0,1943-10-24,350
1943,10,25,303,303,0,1943-10-25,303
1943,10,26,295,295,0,1943-10-26,295
1943,10,27,273,273,0,1943-10-27,273
1943,10,28,272,272,0,1943-10-28,272
1943,10,29,226,226,0,1943-10-29,226
1943,10,30,249,249,0,1943-10-30,249
1943,10,31,232,232,0,1943-10-31,232
1943,11,1,228,228,0,1943-11-1,228
1943,11,2,211,211,0,1943-11-2,211
1943,11,3,209,209,0,1943-11-3,209
1943,11,4,205,205,0,1943-11-4,205
1943,11,5,238,238,0,1943-11-5,238
1943,11,6,0,0,0,1943-11-6,0
1943,11,7,0,0,0,1943-11-7,0
1943,11,8,0,0,0,1943-11-8,0
1943,11,9,0,0,0,1943-11-9,0
1943,11,10,0,0,0,1943-11-10,0
1943,11,11,0,0,0,1943-11-11,0
1943,11,12,0,0,0,1943-11-12,0
1943,11,13,51,0,51,1943-11-13,-51
1943,11,14,55,0,55,1943-11-14,-55
1943,11,15,64,35,29,1943-11-15,6
1943,11,16,55,27,28,1943-11-16,-1
1943,11,17,19,0,19,1943-11-17,-19
1943,11,18,9,0,9,1943-11-18,-9
1943,11,19,0,0,0,1943-11-19,0
1943,11,20,24,24,0,1943-11-20,24
1943,11,21,261,261,0,1943-11-21,261
1943,11,22,356,356,0,1943-11-22,356
1943,11,23,226,226,0,1943-11-23,226
1943,11,24,238,238,0,1943-11-24,238
1943,11,25,225,225,0,1943-11-25,225
1943,11,26,197,197,0,1943-11-26,197
1943,11,27,221,221,0,1943-11-27,221
1943,11,28,180,180,0,1943-11-28,180
1943,11,29,279,279,0,1943-11-29,279
1943,11,30,253,253,0,1943-11-30,253
1943,12,1,195,195,0,1943-12-1,195
1943,12,2,229,229,0,1943-12-2,229
1943,12,3,144,144,0,1943-12-3,144
1943,12,4,212,212,0,1943-12-4,212
1943,12,5,107,107,0,1943-12-5,107
1943,12,6,275,275,0,1943-12-6,275
1943,12,7,265,265,0,1943-12-7,265
1943,12,8,217,217,0,1943-12-8,217
1943,12,9,209,196,13,1943-12-9,183
1943,12,10,175,141,34,1943-12-10,107
1943,12,11,160,142,18,1943-12-11,124
1943,12,12,124,124,0,1943-12-12,124
1943,12,13,143,134,9,1943-12-13,125
1943,12,14,369,137,232,1943-12-14,-95
1943,12,15,584,122,462,1943-12-15,-340
1943,12,16,818,122,696,1943-12-16,-574
1943,12,17,997,87,910,1943-12-17,-823
1943,12,18,844,128,716,1943-12-18,-588
1943,12,19,662,27,635,1943-12-19,-608
1943,12,20,645,12,633,1943-12-20,-621
1943,12,21,535,0,535,1943-12-21,-535
1943,12,22,371,0,371,1943-12-22,-371
1943,12,23,221,0,221,1943-12-23,-221
1943,12,24,146,0,146,1943-12-24,-146
1943,12,25,102,0,102,1943-12-25,-102
1943,12,26,52,0,52,1943-12-26,-52
1943,12,27,13,0,13,1943-12-27,-13
1943,12,28,8,0,8,1943-12-28,-8
1943,12,29,0,0,0,1943-12-29,0
1943,12,30,0,0,0,1943-12-30,0
1943,12,31,0,0,0,1943-12-31,0
1944,1,1,0,0,0,1944-1-1,0
1944,1,2,0,0,0,1944-1-2,0
1944,1,3,0,0,0,1944-1-3,0
1944,1,4,0,0,0,1944-1-4,0
1944,1,5,0,0,0,1944-1-5,0
1944,1,6,0,0,0,1944-1-6,0
1944,1,7,0,0,0,1944-1-7,0
1944,1,8,0,0,0,1944-1-8,0
1944,1,9,0,0,0,1944-1-9,0
1944,1,10,0,0,0,1944-1-10,0
1944,1,11,0,0,0,1944-1-11,0
1944,1,12,0,0,0,1944-1-12,0
1944,1,13,0,0,0,1944-1-13,0
1944,1,14,0,0,0,1944-1-14,0
1944,1,15,0,0,0,1944-1-15,0
1944,1,16,0,0,0,1944-1-16,0
1944,1,17,0,0,0,1944-1-17,0
1944,1,18,0,0,0,1944-1-18,0
1944,1,19,0,0,0,1944-1-19,0
1944,1,20,4,0,4,1944-1-20,-4
1944,1,21,15,0,15,1944-1-21,-15
1944,1,22,134,134,0,1944-1-22,134
1944,1,23,124,124,0,1944-1-23,124
1944,1,24,92,92,0,1944-1-24,92
1944,1,25,101,101,0,1944-1-25,101
1944,1,26,86,86,0,1944-1-26,86
1944,1,27,85,85,0,1944-1-27,85
1944,1,28,49,49,0,1944-1-28,49
1944,1,29,58,58,0,1944-1-29,58
1944,1,30,32,32,0,1944-1-30,32
1944,1,31,15,15,0,1944-1-31,15
1944,2,1,20,20,0,1944-2-1,20
1944,2,2,12,12,0,1944-2-2,12
1944,2,3,14,14,0,1944-2-3,14
1944,2,4,0,0,0,1944-2-4,0
1944,2,5,0,0,0,1944-2-5,0
1944,2,6,0,0,0,1944-2-6,0
1944,2,7,0,0,0,1944-2-7,0
1944,2,8,0,0,0,1944-2-8,0
1944,2,9,0,0,0,1944-2-9,0
1944,2,10,0,0,0,1944-2-10,0
1944,2,11,0,0,0,1944-2-11,0
1944,2,12,0,0,0,1944-2-12,0
1944,2,13,0,0,0,1944-2-13,0
1944,2,14,0,0,0,1944-2-14,0
1944,2,15,0,0,0,1944-2-15,0
1944,2,16,0,0,0,1944-2-16,0
1944,2,17,0,0,0,1944-2-17,0
1944,2,18,0,0,0,1944-2-18,0
1944,2,19,0,0,0,1944-2-19,0
1944,2,20,0,0,0,1944-2-20,0
1944,2,21,0,0,0,1944-2-21,0
1944,2,22,0,0,0,1944-2-22,0
1944,2,23,0,0,0,1944-2-23,0
1944,2,24,0,0,0,1944-2-24,0
1944,2,25,0,0,0,1944-2-25,0
1944,2,26,0,0,0,1944-2-26,0
1944,2,27,0,0,0,1944-2-27,0
1944,2,28,0,0,0,1944-2-28,0
1944,2,29,0,0,0,1944-2-29,0
1944,3,1,0,0,0,1944-3-1,0
1944,3,2,0,0,0,1944-3-2,0
1944,3,3,12,0,12,1944-3-3,-12
1944,3,4,0,0,0,1944-3-4,0
1944,3,5,0,0,0,1944-3-5,0
1944,3,6,0,0,0,1944-3-6,0
1944,3,7,0,0,0,1944-3-7,0
1944,3,8,0,0,0,1944-3-8,0
1944,3,9,0,0,0,1944-3-9,0
1944,3,10,0,0,0,1944-3-10,0
1944,3,11,0,0,0,1944-3-11,0
1944,3,12,0,0,0,1944-3-12,0
1944,3,13,0,0,0,1944-3-13,0
1944,3,14,31,0,31,1944-3-14,-31
1944,3,15,11,0,11,1944-3-15,-11
1944,3,16,3,0,3,1944-3-16,-3
1944,3,17,53,0,53,1944-3-17,-53
1944,3,18,351,0,351,1944-3-18,-351
1944,3,19,554,0,554,1944-3-19,-554
1944,3,20,562,0,562,1944-3-20,-562
1944,3,21,585,0,585,1944-3-21,-585
1944,3,22,538,17,521,1944-3-22,-504
1944,3,23,442,38,404,1944-3-23,-366
1944,3,24,333,7,326,1944-3-24,-319
1944,3,25,308,0,308,1944-3-25,-308
1944,3,26,343,0,343,1944-3-26,-343
1944,3,27,200,0,200,1944-3-27,-200
1944,3,28,108,0,108,1944-3-28,-108
1944,3,29,64,0,64,1944-3-29,-64
1944,3,30,6,0,6,1944-3-30,-6
1944,3,31,0,0,0,1944-3-31,0
1944,4,1,0,0,0,1944-4-1,0
1944,4,2,0,0,0,1944-4-2,0
1944,4,3,0,0,0,1944-4-3,0
1944,4,4,0,0,0,1944-4-4,0
1944,4,5,0,0,0,1944-4-5,0
1944,4,6,0,0,0,1944-4-6,0
1944,4,7,11,0,11,1944-4-7,-11
1944,4,8,11,0,11,1944-4-8,-11
1944,4,9,0,0,0,1944-4-9,0
1944,4,10,0,0,0,1944-4-10,0
1944,4,11,0,0,0,1944-4-11,0
1944,4,12,0,0,0,1944-4-12,0
1944,4,13,0,0,0,1944-4-13,0
1944,4,14,0,0,0,1944-4-14,0
1944,4,15,0,0,0,1944-4-15,0
1944,4,16,0,0,0,1944-4-16,0
1944,4,17,0,0,0,1944-4-17,0
1944,4,18,0,0,0,1944-4-18,0
1944,4,19,0,0,0,1944-4-19,0
1944,4,20,0,0,0,1944-4-20,0
1944,4,21,0,0,0,1944-4-21,0
1944,4,22,0,0,0,1944-4-22,0
1944,4,23,0,0,0,1944-4-23,0
1944,4,24,0,0,0,1944-4-24,0
1944,4,25,0,0,0,1944-4-25,0
1944,4,26,0,0,0,1944-4-26,0
1944,4,27,0,0,0,1944-4-27,0
1944,4,28,0,0,0,1944-4-28,0
1944,4,29,0,0,0,1944-4-29,0
1944,4,30,0,0,0,1944-4-30,0
1944,5,1,0,0,0,1944-5-1,0
1944,5,2,0,0,0,1944-5-2,0
1944,5,3,0,0,0,1944-5-3,0
1944,5,4,0,0,0,1944-5-4,0
1944,5,5,0,0,0,1944-5-5,0
1944,5,6,0,0,0,1944-5-6,0
1944,5,7,0,0,0,1944-5-7,0
1944,5,8,0,0,0,1944-5-8,0
1944,5,9,0,0,0,1944-5-9,0
1944,5,10,0,0,0,1944-5-10,0
1944,5,11,0,0,0,1944-5-11,0
1944,5,12,0,0,0,1944-5-12,0
1944,5,13,0,0,0,1944-5-13,0
1944,5,14,0,0,0,1944-5-14,0
1944,5,15,0,0,0,1944-5-15,0
1944,5,16,0,0,0,1944-5-16,0
1944,5,17,0,0,0,1944-5-17,0
1944,5,18,0,0,0,1944-5-18,0
1944,5,19,0,0,0,1944-5-19,0
1944,5,20,0,0,0,1944-5-20,0
1944,5,21,0,0,0,1944-5-21,0
1944,5,22,0,0,0,1944-5-22,0
1944,5,23,0,0,0,1944-5-23,0
1944,5,24,0,0,0,1944-5-24,0
1944,5,25,0,0,0,1944-5-25,0
1944,5,26,0,0,0,1944-5-26,0
1944,5,27,0,0,0,1944-5-27,0
1944,5,28,29,0,29,1944-5-28,-29
1944,5,29,40,5,35,1944-5-29,-30
1944,5,30,19,6,13,1944-5-30,-7
1944,5,31,185,185,0,1944-5-31,185
1944,6,1,332,332,0,1944-6-1,332
1944,6,2,237,237,0,1944-6-2,237
1944,6,3,0,0,0,1944-6-3,0
1944,6,4,0,0,0,1944-6-4,0
1944,6,5,19,0,19,1944-6-5,-19
1944,6,6,8,0,8,1944-6-6,-8
1944,6,7,13,0,13,1944-6-7,-13
1944,6,8,13,0,13,1944-6-8,-13
1944,6,9,0,0,0,1944-6-9,0
1944,6,10,10,0,10,1944-6-10,-10
1944,6,11,0,0,0,1944-6-11,0
1944,6,12,0,0,0,1944-6-12,0
1944,6,13,0,0,0,1944-6-13,0
1944,6,14,0,0,0,1944-6-14,0
1944,6,15,8,0,8,1944-6-15,-8
1944,6,16,83,72,11,1944-6-16,61
1944,6,17,99,83,16,1944-6-17,67
1944,6,18,75,75,0,1944-6-18,75
1944,6,19,67,67,0,1944-6-19,67
1944,6,20,76,76,0,1944-6-20,76
1944,6,21,72,72,0,1944-6-21,72
1944,6,22,78,78,0,1944-6-22,78
1944,6,23,74,74,0,1944-6-23,74
1944,6,24,76,76,0,1944-6-24,76
1944,6,25,61,61,0,1944-6-25,61
1944,6,26,75,75,0,1944-6-26,75
1944,6,27,48,48,0,1944-6-27,48
1944,6,28,46,46,0,1944-6-28,46
1944,6,29,0,0,0,1944-6-29,0
1944,6,30,5,0,5,1944-6-30,-5
1944,7,1,36,0,36,1944-7-1,-36
1944,7,2,41,41,0,1944-7-2,41
1944,7,3,35,35,0,1944-7-3,35
1944,7,4,24,19,5,1944-7-4,14
1944,7,5,32,19,13,1944-7-5,6
1944,7,6,25,20,5,1944-7-6,15
1944,7,7,0,0,0,1944-7-7,0
1944,7,8,0,0,0,1944-7-8,0
1944,7,9,0,0,0,1944-7-9,0
1944,7,10,0,0,0,1944-7-10,0
1944,7,11,0,0,0,1944-7-11,0
1944,7,12,0,0,0,1944-7-12,0
1944,7,13,0,0,0,1944-7-13,0
1944,7,14,0,0,0,1944-7-14,0
1944,7,15,0,0,0,1944-7-15,0
1944,7,16,0,0,0,1944-7-16,0
1944,7,17,0,0,0,1944-7-17,0
1944,7,18,0,0,0,1944-7-18,0
1944,7,19,29,0,29,1944-7-19,-29
1944,7,20,12,0,12,1944-7-20,-12
1944,7,21,0,0,0,1944-7-21,0
1944,7,22,0,0,0,1944-7-22,0
1944,7,23,0,0,0,1944-7-23,0
1944,7,24,13,0,13,1944-7-24,-13
1944,7,25,0,0,0,1944-7-25,0
1944,7,26,6,6,0,1944-7-26,6
1944,7,27,6,0,6,1944-7-27,-6
1944,7,28,160,0,160,1944-7-28,-160
1944,7,29,164,0,164,1944-7-29,-164
1944,7,30,168,0,168,1944-7-30,-168
1944,7,31,0,0,0,1944-7-31,0
1944,8,1,0,0,0,1944-8-1,0
1944,8,2,0,0,0,1944-8-2,0
1944,8,3,0,0,0,1944-8-3,0
1944,8,4,0,0,0,1944-8-4,0
1944,8,5,65,0,65,1944-8-5,-65
1944,8,6,180,0,180,1944-8-6,-180
1944,8,7,86,0,86,1944-8-7,-86
1944,8,8,148,0,148,1944-8-8,-148
1944,8,9,170,0,170,1944-8-9,-170
1944,8,10,156,0,156,1944-8-10,-156
1944,8,11,169,16,153,1944-8-11,-137
1944,8,12,107,0,107,1944-8-12,-107
1944,8,13,83,0,83,1944-8-13,-83
1944,8,14,70,30,40,1944-8-14,-10
1944,8,15,30,18,12,1944-8-15,6
1944,8,16,45,23,22,1944-8-16,1
1944,8,17,155,36,119,1944-8-17,-83
1944,8,18,202,34,168,1944-8-18,-134
1944,8,19,49,0,49,1944-8-19,-49
1944,8,20,76,0,76,1944-8-20,-76
1944,8,21,18,0,18,1944-8-21,-18
1944,8,22,10,0,10,1944-8-22,-10
1944,8,23,25,16,9,1944-8-23,7
1944,8,24,28,10,18,1944-8-24,-8
1944,8,25,116,16,100,1944-8-25,-84
1944,8,26,124,0,124,1944-8-26,-124
1944,8,27,84,0,84,1944-8-27,-84
1944,8,28,93,0,93,1944-8-28,-93
1944,8,29,112,0,112,1944-8-29,-112
1944,8,30,30,0,30,1944-8-30,-30
1944,8,31,0,0,0,1944-8-31,0
1944,9,1,0,0,0,1944-9-1,0
1944,9,2,229,0,229,1944-9-2,-229
1944,9,3,63,0,63,1944-9-3,-63
1944,9,4,0,0,0,1944-9-4,0
1944,9,5,0,0,0,1944-9-5,0
1944,9,6,0,0,0,1944-9-6,0
1944,9,7,0,0,0,1944-9-7,0
1944,9,8,10,0,10,1944-9-8,-10
1944,9,9,169,0,169,1944-9-9,-169
1944,9,10,267,0,267,1944-9-10,-267
1944,9,11,316,0,316,1944-9-11,-316
1944,9,12,374,0,374,1944-9-12,-374
1944,9,13,485,0,485,1944-9-13,-485
1944,9,14,464,0,464,1944-9-14,-464
1944,9,15,422,0,422,1944-9-15,-422
1944,9,16,264,0,264,1944-9-16,-264
1944,9,17,282,0,282,1944-9-17,-282
1944,9,18,283,0,283,1944-9-18,-283
1944,9,19,292,0,292,1944-9-19,-292
1944,9,20,311,0,311,1944-9-20,-311
1944,9,21,332,0,332,1944-9-21,-332
1944,9,22,257,0,257,1944-9-22,-257
1944,9,23,340,0,340,1944-9-23,-340
1944,9,24,401,0,401,1944-9-24,-401
1944,9,25,350,23,327,1944-9-25,-304
1944,9,26,387,0,387,1944-9-26,-387
1944,9,27,382,0,382,1944-9-27,-382
1944,9,28,340,0,340,1944-9-28,-340
1944,9,29,269,0,269,1944-9-29,-269
1944,9,30,213,207,6,1944-9-30,201
1944,10,1,336,206,130,1944-10-1,76
1944,10,2,457,326,131,1944-10-2,195
1944,10,3,470,278,192,1944-10-3,86
1944,10,4,446,263,183,1944-10-4,80
1944,10,5,269,133,136,1944-10-5,-3
1944,10,6,170,28,142,1944-10-6,-114
1944,10,7,97,0,97,1944-10-7,-97
1944,10,8,104,13,91,1944-10-8,-78
1944,10,9,151,9,142,1944-10-9,-133
1944,10,10,200,0,200,1944-10-10,-200
1944,10,11,89,0,89,1944-10-11,-89
1944,10,12,52,0,52,1944-10-12,-52
1944,10,13,0,0,0,1944-10-13,0
1944,10,14,0,0,0,1944-10-14,0
1944,10,15,284,6,278,1944-10-15,-272
1944,10,16,320,89,231,1944-10-16,-142
1944,10,17,288,81,207,1944-10-17,-126
1944,10,18,197,22,175,1944-10-18,-153
1944,10,19,161,0,161,1944-10-19,-161
1944,10,20,255,20,235,1944-10-20,-215
1944,10,21,278,8,270,1944-10-21,-262
1944,10,22,217,0,217,1944-10-22,-217
1944,10,23,199,0,199,1944-10-23,-199
1944,10,24,170,0,170,1944-10-24,-170
1944,10,25,202,0,202,1944-10-25,-202
1944,10,26,156,0,156,1944-10-26,-156
1944,10,27,122,0,122,1944-10-27,-122
1944,10,28,20,0,20,1944-10-28,-20
1944,10,29,65,0,65,1944-10-29,-65
1944,10,30,114,0,114,1944-10-30,-114
1944,10,31,87,0,87,1944-10-31,-87
1944,11,1,48,0,48,1944-11-1,-48
1944,11,2,100,0,100,1944-11-2,-100
1944,11,3,72,0,72,1944-11-3,-72
1944,11,4,61,22,39,1944-11-4,-17
1944,11,5,8,8,0,1944-11-5,8
1944,11,6,18,4,14,1944-11-6,-10
1944,11,7,0,0,0,1944-11-7,0
1944,11,8,0,0,0,1944-11-8,0
1944,11,9,0,0,0,1944-11-9,0
1944,11,10,0,0,0,1944-11-10,0
1944,11,11,0,0,0,1944-11-11,0
1944,11,12,12,0,12,1944-11-12,-12
1944,11,13,15,0,15,1944-11-13,-15
1944,11,14,10,0,10,1944-11-14,-10
1944,11,15,14,0,14,1944-11-15,-14
1944,11,16,348,348,0,1944-11-16,348
1944,11,17,353,353,0,1944-11-17,353
1944,11,18,330,330,0,1944-11-18,330
1944,11,19,364,364,0,1944-11-19,364
1944,11,20,394,394,0,1944-11-20,394
1944,11,21,377,377,0,1944-11-21,377
1944,11,22,363,343,20,1944-11-22,323
1944,11,23,474,420,54,1944-11-23,366
1944,11,24,427,382,45,1944-11-24,337
1944,11,25,398,384,14,1944-11-25,370
1944,11,26,363,352,11,1944-11-26,341
1944,11,27,386,386,0,1944-11-27,386
1944,11,28,372,372,0,1944-11-28,372
1944,11,29,11,11,0,1944-11-29,11
1944,11,30,7,0,7,1944-11-30,-7
1944,12,1,0,0,0,1944-12-1,0
1944,12,2,0,0,0,1944-12-2,0
1944,12,3,0,0,0,1944-12-3,0
1944,12,4,0,0,0,1944-12-4,0
1944,12,5,21,0,21,1944-12-5,-21
1944,12,6,61,50,11,1944-12-6,39
1944,12,7,41,41,0,1944-12-7,41
1944,12,8,589,39,550,1944-12-8,-511
1944,12,9,934,48,886,1944-12-9,-838
1944,12,10,907,65,842,1944-12-10,-777
1944,12,11,1182,97,1085,1944-12-11,-988
1944,12,12,1157,102,1055,1944-12-12,-953
1944,12,13,1219,256,963,1944-12-13,-707
1944,12,14,1196,303,893,1944-12-14,-590
1944,12,15,950,241,709,1944-12-15,-468
1944,12,16,819,243,576,1944-12-16,-333
1944,12,17,676,228,448,1944-12-17,-220
1944,12,18,721,355,366,1944-12-18,-11
1944,12,19,758,417,341,1944-12-19,76
1944,12,20,698,400,298,1944-12-20,102
1944,12,21,619,481,138,1944-12-21,343
1944,12,22,540,451,89,1944-12-22,362
1944,12,23,491,361,130,1944-12-23,231
1944,12,24,618,384,234,1944-12-24,150
1944,12,25,952,522,430,1944-12-25,92
1944,12,26,721,417,304,1944-12-26,113
1944,12,27,417,192,225,1944-12-27,-33
1944,12,28,217,139,78,1944-12-28,61
1944,12,29,81,81,0,1944-12-29,81
1944,12,30,67,67,0,1944-12-30,67
1944,12,31,35,35,0,1944-12-31,35
1945,1,1,40,21,19,1945-1-1,2
1945,1,2,23,17,6,1945-1-2,11
1945,1,3,0,0,0,1945-1-3,0
1945,1,4,0,0,0,1945-1-4,0
1945,1,5,65,57,8,1945-1-5,49
1945,1,6,224,68,156,1945-1-6,-88
1945,1,7,223,20,203,1945-1-7,-183
1945,1,8,175,11,164,1945-1-8,-153
1945,1,9,180,0,180,1945-1-9,-180
1945,1,10,216,80,136,1945-1-10,-56
1945,1,11,272,147,125,1945-1-11,22
1945,1,12,317,181,136,1945-1-12,45
1945,1,13,268,126,142,1945-1-13,-16
1945,1,14,119,96,23,1945-1-14,73
1945,1,15,135,111,24,1945-1-15,87
1945,1,16,122,91,31,1945-1-16,60
1945,1,17,109,104,5,1945-1-17,99
1945,1,18,179,179,0,1945-1-18,179
1945,1,19,287,287,0,1945-1-19,287
1945,1,20,250,250,0,1945-1-20,250
1945,1,21,251,251,0,1945-1-21,251
1945,1,22,257,257,0,1945-1-22,257
1945,1,23,126,126,0,1945-1-23,126
1945,1,24,97,97,0,1945-1-24,97
1945,1,25,54,54,0,1945-1-25,54
1945,1,26,58,58,0,1945-1-26,58
1945,1,27,114,40,74,1945-1-27,-34
1945,1,28,199,35,164,1945-1-28,-129
1945,1,29,413,6,407,1945-1-29,-401
1945,1,30,475,0,475,1945-1-30,-475
1945,1,31,402,0,402,1945-1-31,-402
1945,2,1,83,0,83,1945-2-1,-83
1945,2,2,65,0,65,1945-2-2,-65
1945,2,3,117,0,117,1945-2-3,-117
1945,2,4,111,0,111,1945-2-4,-111
1945,2,5,62,0,62,1945-2-5,-62
1945,2,6,34,0,34,1945-2-6,-34
1945,2,7,11,0,11,1945-2-7,-11
1945,2,8,9,0,9,1945-2-8,-9
1945,2,9,16,0,16,1945-2-9,-16
1945,2,10,0,0,0,1945-2-10,0
1945,2,11,0,0,0,1945-2-11,0
1945,2,12,0,0,0,1945-2-12,0
1945,2,13,141,141,0,1945-2-13,141
1945,2,14,307,307,0,1945-2-14,307
1945,2,15,280,280,0,1945-2-15,280
1945,2,16,156,156,0,1945-2-16,156
1945,2,17,157,157,0,1945-2-17,157
1945,2,18,110,110,0,1945-2-18,110
1945,2,19,75,60,15,1945-2-19,45
1945,2,20,21,21,0,1945-2-20,21
1945,2,21,5,5,0,1945-2-21,5
1945,2,22,0,0,0,1945-2-22,0
1945,2,23,256,0,256,1945-2-23,-256
1945,2,24,174,0,174,1945-2-24,-174
1945,2,25,113,0,113,1945-2-25,-113
1945,2,26,105,0,105,1945-2-26,-105
1945,2,27,86,0,86,1945-2-27,-86
1945,2,28,89,0,89,1945-2-28,-89
1945,3,1,53,0,53,1945-3-1,-53
1945,3,2,297,0,297,1945-3-2,-297
1945,3,3,631,0,631,1945-3-3,-631
1945,3,4,583,0,583,1945-3-4,-583
1945,3,5,587,0,587,1945-3-5,-587
1945,3,6,497,0,497,1945-3-6,-497
1945,3,7,471,0,471,1945-3-7,-471
1945,3,8,415,0,415,1945-3-8,-415
1945,3,9,464,0,464,1945-3-9,-464
1945,3,10,429,0,429,1945-3-10,-429
1945,3,11,497,0,497,1945-3-11,-497
1945,3,12,402,0,402,1945-3-12,-402
1945,3,13,416,0,416,1945-3-13,-416
1945,3,14,362,0,362,1945-3-14,-362
1945,3,15,213,0,213,1945-3-15,-213
1945,3,16,7,7,0,1945-3-16,7
1945,3,17,18,18,0,1945-3-17,18
1945,3,18,34,21,13,1945-3-18,8
1945,3,19,19,19,0,1945-3-19,19
1945,3,20,24,24,0,1945-3-20,24
1945,3,21,383,20,363,1945-3-21,-343
1945,3,22,798,0,798,1945-3-22,-798
1945,3,23,534,0,534,1945-3-23,-534
1945,3,24,582,0,582,1945-3-24,-582
1945,3,25,604,0,604,1945-3-25,-604
1945,3,26,656,0,656,1945-3-26,-656
1945,3,27,794,62,732,1945-3-27,-670
1945,3,28,1131,59,1072,1945-3-28,-1013
1945,3,29,1289,34,1255,1945-3-29,-1221
1945,3,30,1418,44,1374,1945-3-30,-1330
1945,3,31,1346,32,1314,1945-3-31,-1282
1945,4,1,1408,35,1373,1945-4-1,-1338
1945,4,2,1392,61,1331,1945-4-2,-1270
1945,4,3,1362,32,1330,1945-4-3,-1298
1945,4,4,962,21,941,1945-4-4,-920
1945,4,5,846,17,829,1945-4-5,-812
1945,4,6,709,16,693,1945-4-6,-677
1945,4,7,716,24,692,1945-4-7,-668
1945,4,8,50,22,28,1945-4-8,-6
1945,4,9,34,0,34,1945-4-9,-34
1945,4,10,18,0,18,1945-4-10,-18
1945,4,11,0,0,0,1945-4-11,0
1945,4,12,0,0,0,1945-4-12,0
1945,4,13,0,0,0,1945-4-13,0
1945,4,14,28,0,28,1945-4-14,-28
1945,4,15,22,0,22,1945-4-15,-22
1945,4,16,50,0,50,1945-4-16,-50
1945,4,17,82,0,82,1945-4-17,-82
1945,4,18,192,0,192,1945-4-18,-192
1945,4,19,362,0,362,1945-4-19,-362
1945,4,20,537,0,537,1945-4-20,-537
1945,4,21,516,0,516,1945-4-21,-516
1945,4,22,422,0,422,1945-4-22,-422
1945,4,23,390,0,390,1945-4-23,-390
1945,4,24,387,0,387,1945-4-24,-387
1945,4,25,810,0,810,1945-4-25,-810
1945,4,26,1401,0,1401,1945-4-26,-1401
1945,4,27,1381,0,1381,1945-4-27,-1381
1945,4,28,1266,0,1266,1945-4-28,-1266
1945,4,29,1188,0,1188,1945-4-29,-1188
1945,4,30,1006,0,1006,1945-4-30,-1006
1945,5,1,819,10,809,1945-5-1,-799
1945,5,2,1009,23,986,1945-5-2,-963
1945,5,3,788,16,772,1945-5-3,-756
1945,5,4,614,18,596,1945-5-4,-578
1945,5,5,467,11,456,1945-5-5,-445
1945,5,6,500,0,500,1945-5-6,-500
1945,5,7,604,0,604,1945-5-7,-604
1945,5,8,186,0,186,1945-5-8,-186
1945,5,9,128,0,128,1945-5-9,-128
1945,5,10,74,0,74,1945-5-10,-74
1945,5,11,11,0,11,1945-5-11,-11
1945,5,12,18,0,18,1945-5-12,-18
1945,5,13,10,0,10,1945-5-13,-10
1945,5,14,30,0,30,1945-5-14,-30
1945,5,15,150,0,150,1945-5-15,-150
1945,5,16,397,0,397,1945-5-16,-397
1945,5,17,378,0,378,1945-5-17,-378
1945,5,18,411,6,405,1945-5-18,-399
1945,5,19,630,33,597,1945-5-19,-564
1945,5,20,92,9,83,1945-5-20,-74
1945,5,21,69,33,36,1945-5-21,-3
1945,5,22,50,23,27,1945-5-22,-4
1945,5,23,186,52,134,1945-5-23,-82
1945,5,24,168,67,101,1945-5-24,-34
1945,5,25,167,26,141,1945-5-25,-115
1945,5,26,198,21,177,1945-5-26,-156
1945,5,27,169,32,137,1945-5-27,-105
1945,5,28,151,0,151,1945-5-28,-151
1945,5,29,92,58,34,1945-5-29,24
1945,5,30,82,73,9,1945-5-30,64
1945,5,31,125,97,28,1945-5-31,69
1945,6,1,123,117,6,1945-6-1,111
1945,6,2,137,137,0,1945-6-2,137
1945,6,3,117,23,94,1945-6-3,-71
1945,6,4,83,0,83,1945-6-4,-83
1945,6,5,86,0,86,1945-6-5,-86
1945,6,6,82,0,82,1945-6-6,-82
1945,6,7,44,0,44,1945-6-7,-44
1945,6,8,25,0,25,1945-6-8,-25
1945,6,9,57,0,57,1945-6-9,-57
1945,6,10,223,0,223,1945-6-10,-223
1945,6,11,741,0,741,1945-6-11,-741
1945,6,12,595,0,595,1945-6-12,-595
1945,6,13,738,0,738,1945-6-13,-738
1945,6,14,726,0,726,1945-6-14,-726
1945,6,15,625,10,615,1945-6-15,-605
1945,6,16,647,5,642,1945-6-16,-637
1945,6,17,698,0,698,1945-6-17,-698
1945,6,18,695,0,695,1945-6-18,-695
1945,6,19,682,18,664,1945-6-19,-646
1945,6,20,700,88,612,1945-6-20,-524
1945,6,21,869,74,795,1945-6-21,-721
1945,6,22,795,48,747,1945-6-22,-699
1945,6,23,784,22,762,1945-6-23,-740
1945,6,24,533,32,501,1945-6-24,-469
1945,6,25,231,31,200,1945-6-25,-169
1945,6,26,235,27,208,1945-6-26,-181
1945,6,27,161,0,161,1945-6-27,-161
1945,6,28,214,0,214,1945-6-28,-214
1945,6,29,192,0,192,1945-6-29,-192
1945,6,30,139,0,139,1945-6-30,-139
1945,7,1,71,0,71,1945-7-1,-71
1945,7,2,0,0,0,1945-7-2,0
1945,7,3,0,0,0,1945-7-3,0
1945,7,4,51,0,51,1945-7-4,-51
1945,7,5,120,0,120,1945-7-5,-120
1945,7,6,303,0,303,1945-7-6,-303
1945,7,7,172,0,172,1945-7-7,-172
1945,7,8,34,28,6,1945-7-8,22
1945,7,9,736,210,526,1945-7-9,-316
1945,7,10,749,218,531,1945-7-10,-313
1945,7,11,1061,291,770,1945-7-11,-479
1945,7,12,1205,299,906,1945-7-12,-607
1945,7,13,1397,372,1025,1945-7-13,-653
1945,7,14,1491,321,1170,1945-7-14,-849
1945,7,15,1453,294,1159,1945-7-15,-865
1945,7,16,1132,162,970,1945-7-16,-808
1945,7,17,844,58,786,1945-7-17,-728
1945,7,18,767,66,701,1945-7-18,-635
1945,7,19,751,181,570,1945-7-19,-389
1945,7,20,712,293,419,1945-7-20,-126
1945,7,21,329,226,103,1945-7-21,123
1945,7,22,314,297,17,1945-7-22,280
1945,7,23,345,329,16,1945-7-23,313
1945,7,24,373,361,12,1945-7-24,349
1945,7,25,208,198,10,1945-7-25,188
1945,7,26,294,294,0,1945-7-26,294
1945,7,27,168,163,5,1945-7-27,158
1945,7,28,168,164,4,1945-7-28,160
1945,7,29,164,164,0,1945-7-29,164
1945,7,30,144,144,0,1945-7-30,144
1945,7,31,117,117,0,1945-7-31,117
1945,8,1,124,124,0,1945-8-1,124
1945,8,2,122,122,0,1945-8-2,122
1945,8,3,106,106,0,1945-8-3,106
1945,8,4,193,120,73,1945-8-4,47
1945,8,5,135,94,41,1945-8-5,53
1945,8,6,219,183,36,1945-8-6,147
1945,8,7,317,283,34,1945-8-7,249
1945,8,8,362,339,23,1945-8-8,316
1945,8,9,362,362,0,1945-8-9,362
1945,8,10,387,360,27,1945-8-10,333
1945,8,11,402,384,18,1945-8-11,366
1945,8,12,444,433,11,1945-8-12,422
1945,8,13,498,475,23,1945-8-13,452
1945,8,14,977,929,48,1945-8-14,881
1945,8,15,1143,1130,13,1945-8-15,1117
1945,8,16,727,727,0,1945-8-16,727
1945,8,17,529,529,0,1945-8-17,529
1945,8,18,429,395,34,1945-8-18,361
1945,8,19,433,389,44,1945-8-19,345
1945,8,20,242,242,0,1945-8-20,242
1945,8,21,21,0,21,1945-8-21,-21
1945,8,22,0,0,0,1945-8-22,0
1945,8,23,10,5,5,1945-8-23,0
1945,8,24,25,0,25,1945-8-24,-25
1945,8,25,10,0,10,1945-8-25,-10
1945,8,26,0,0,0,1945-8-26,0
1945,8,27,15,0,15,1945-8-27,-15
1945,8,28,37,0,37,1945-8-28,-37
1945,8,29,52,10,42,1945-8-29,-32
1945,8,30,29,12,17,1945-8-30,-5
1945,8,31,43,0,43,1945-8-31,-43
1945,9,1,413,0,413,1945-9-1,-413
1945,9,2,379,0,379,1945-9-2,-379
1945,9,3,395,0,395,1945-9-3,-395
1945,9,4,242,0,242,1945-9-4,-242
1945,9,5,295,39,256,1945-9-5,-217
1945,9,6,421,240,181,1945-9-6,59
1945,9,7,385,197,188,1945-9-7,9
1945,9,8,315,128,187,1945-9-8,-59
1945,9,9,170,75,95,1945-9-9,-20
1945,9,10,123,36,87,1945-9-10,-51
1945,9,11,58,25,33,1945-9-11,-8
1945,9,12,48,0,48,1945-9-12,-48
1945,9,13,14,0,14,1945-9-13,-14
1945,9,14,6,0,6,1945-9-14,-6
1945,9,15,0,0,0,1945-9-15,0
1945,9,16,11,0,11,1945-9-16,-11
1945,9,17,23,0,23,1945-9-17,-23
1945,9,18,15,0,15,1945-9-18,-15
1945,9,19,68,0,68,1945-9-19,-68
1945,9,20,75,0,75,1945-9-20,-75
1945,9,21,41,0,41,1945-9-21,-41
1945,9,22,135,93,42,1945-9-22,51
1945,9,23,504,144,360,1945-9-23,-216
1945,9,24,1107,153,954,1945-9-24,-801
1945,9,25,1462,322,1140,1945-9-25,-818
1945,9,26,1320,243,1077,1945-9-26,-834
1945,9,27,1605,400,1205,1945-9-27,-805
1945,9,28,1219,70,1149,1945-9-28,-1079
1945,9,29,1143,205,938,1945-9-29,-733
1945,9,30,1528,638,890,1945-9-30,-252
1945,10,1,1686,730,956,1945-10-1,-226
1945,10,2,1879,752,1127,1945-10-2,-375
1945,10,3,2034,776,1258,1945-10-3,-482
1945,10,4,1779,830,949,1945-10-4,-119
1945,10,5,1590,862,728,1945-10-5,134
1945,10,6,1603,828,775,1945-10-6,53
1945,10,7,1725,987,738,1945-10-7,249
1945,10,8,1587,894,693,1945-10-8,201
1945,10,9,1391,744,647,1945-10-9,97
1945,10,10,667,283,384,1945-10-10,-101
1945,10,11,223,42,181,1945-10-11,-139
1945,10,12,131,14,117,1945-10-12,-103
1945,10,13,322,214,108,1945-10-13,106
1945,10,14,492,244,248,1945-10-14,-4
1945,10,15,701,278,423,1945-10-15,-145
1945,10,16,841,266,575,1945-10-16,-309
1945,10,17,1006,216,790,1945-10-17,-574
1945,10,18,1060,212,848,1945-10-18,-636
1945,10,19,1092,204,888,1945-10-19,-684
1945,10,20,1023,176,847,1945-10-20,-671
1945,10,21,1054,117,937,1945-10-21,-820
1945,10,22,902,131,771,1945-10-22,-640
1945,10,23,706,174,532,1945-10-23,-358
1945,10,24,702,187,515,1945-10-24,-328
1945,10,25,979,345,634,1945-10-25,-289
1945,10,26,1037,319,718,1945-10-26,-399
1945,10,27,1525,587,938,1945-10-27,-351
1945,10,28,1679,917,762,1945-10-28,155
1945,10,29,974,591,383,1945-10-29,208
1945,10,30,1001,547,454,1945-10-30,93
1945,10,31,1056,510,546,1945-10-31,-36
1945,11,1,893,418,475,1945-11-1,-57
1945,11,2,816,303,513,1945-11-2,-210
1945,11,3,375,0,375,1945-11-3,-375
1945,11,4,347,21,326,1945-11-4,-305
1945,11,5,250,5,245,1945-11-5,-240
1945,11,6,301,0,301,1945-11-6,-301
1945,11,7,75,0,75,1945-11-7,-75
1945,11,8,87,0,87,1945-11-8,-87
1945,11,9,213,0,213,1945-11-9,-213
1945,11,10,255,7,248,1945-11-10,-241
1945,11,11,420,39,381,1945-11-11,-342
1945,11,12,402,80,322,1945-11-12,-242
1945,11,13,558,129,429,1945-11-13,-300
1945,11,14,563,184,379,1945-11-14,-195
1945,11,15,546,222,324,1945-11-15,-102
1945,11,16,212,0,212,1945-11-16,-212
1945,11,17,234,0,234,1945-11-17,-234
1945,11,18,215,4,211,1945-11-18,-207
1945,11,19,123,0,123,1945-11-19,-123
1945,11,20,263,79,184,1945-11-20,-105
1945,11,21,524,28,496,1945-11-21,-468
1945,11,22,598,49,549,1945-11-22,-500
1945,11,23,212,104,108,1945-11-23,-4
1945,11,24,500,440,60,1945-11-24,380
1945,11,25,553,540,13,1945-11-25,527
1945,11,26,548,542,6,1945-11-26,536
1945,11,27,479,446,33,1945-11-27,413
1945,11,28,481,392,89,1945-11-28,303
1945,11,29,377,247,130,1945-11-29,117
1945,11,30,538,130,408,1945-11-30,-278
1945,12,1,625,255,370,1945-12-1,-115
1945,12,2,389,21,368,1945-12-2,-347
1945,12,3,374,0,374,1945-12-3,-374
1945,12,4,526,0,526,1945-12-4,-526
1945,12,5,497,0,497,1945-12-5,-497
1945,12,6,420,0,420,1945-12-6,-420
1945,12,7,222,0,222,1945-12-7,-222
1945,12,8,270,0,270,1945-12-8,-270
1945,12,9,231,0,231,1945-12-9,-231
1945,12,10,147,0,147,1945-12-10,-147
1945,12,11,147,0,147,1945-12-11,-147
1945,12,12,97,21,76,1945-12-12,-55
1945,12,13,152,92,60,1945-12-13,32
1945,12,14,266,224,42,1945-12-14,182
1945,12,15,189,148,41,1945-12-15,107
1945,12,16,368,361,7,1945-12-16,354
1945,12,17,372,361,11,1945-12-17,350
1945,12,18,294,294,0,1945-12-18,294
1945,12,19,255,255,0,1945-12-19,255
1945,12,20,251,251,0,1945-12-20,251
1945,12,21,217,217,0,1945-12-21,217
1945,12,22,202,202,0,1945-12-22,202
1945,12,23,215,215,0,1945-12-23,215
1945,12,24,688,215,473,1945-12-24,-258
1945,12,25,464,150,314,1945-12-25,-164
1945,12,26,492,187,305,1945-12-26,-118
1945,12,27,484,176,308,1945-12-27,-132
1945,12,28,405,129,276,1945-12-28,-147
1945,12,29,278,0,278,1945-12-29,-278
1945,12,30,224,0,224,1945-12-30,-224
1945,12,31,324,0,324,1945-12-31,-324
1946,1,1,275,55,220,1946-1-1,-165
1946,1,2,326,79,247,1946-1-2,-168
1946,1,3,311,38,273,1946-1-3,-235
1946,1,4,294,0,294,1946-1-4,-294
1946,1,5,212,0,212,1946-1-5,-212
1946,1,6,54,0,54,1946-1-6,-54
1946,1,7,58,0,58,1946-1-7,-58
1946,1,8,34,0,34,1946-1-8,-34
1946,1,9,87,0,87,1946-1-9,-87
1946,1,10,187,142,45,1946-1-10,97
1946,1,11,183,170,13,1946-1-11,157
1946,1,12,210,194,16,1946-1-12,178
1946,1,13,835,630,205,1946-1-13,425
1946,1,14,1526,1394,132,1946-1-14,1262
1946,1,15,2101,1933,168,1946-1-15,1765
1946,1,16,2117,1999,118,1946-1-16,1881
1946,1,17,2394,2273,121,1946-1-17,2152
1946,1,18,2269,2133,136,1946-1-18,1997
1946,1,19,1952,1835,117,1946-1-19,1718
1946,1,20,1949,1248,701,1946-1-20,547
1946,1,21,2303,1099,1204,1946-1-21,-105
1946,1,22,2344,1059,1285,1946-1-22,-226
1946,1,23,1987,902,1085,1946-1-23,-183
1946,1,24,1188,221,967,1946-1-24,-746
1946,1,25,1106,204,902,1946-1-25,-698
1946,1,26,942,83,859,1946-1-26,-776
1946,1,27,867,58,809,1946-1-27,-751
1946,1,28,851,26,825,1946-1-28,-799
1946,1,29,1364,419,945,1946-1-29,-526
1946,1,30,3078,2186,892,1946-1-30,1294
1946,1,31,4957,4225,732,1946-1-31,3493
1946,2,1,5436,4799,637,1946-2-1,4162
1946,2,2,6279,4950,1329,1946-2-2,3621
1946,2,3,6442,5080,1362,1946-2-3,3718
1946,2,4,6130,4977,1153,1946-2-4,3824
1946,2,5,5865,4653,1212,1946-2-5,3441
1946,2,6,5939,4902,1037,1946-2-6,3865
1946,2,7,6258,5486,772,1946-2-7,4714
1946,2,8,5522,5233,289,1946-2-8,4944
1946,2,9,5419,5102,317,1946-2-9,4785
1946,2,10,5445,5183,262,1946-2-10,4921
1946,2,11,4947,4645,302,1946-2-11,4343
1946,2,12,3338,3114,224,1946-2-12,2890
1946,2,13,1558,1319,239,1946-2-13,1080
1946,2,14,1325,1119,206,1946-2-14,913
1946,2,15,954,954,0,1946-2-15,954
1946,2,16,854,816,38,1946-2-16,778
1946,2,17,1270,1080,190,1946-2-17,890
1946,2,18,1013,871,142,1946-2-18,729
1946,2,19,807,663,144,1946-2-19,519
1946,2,20,662,477,185,1946-2-20,292
1946,2,21,862,457,405,1946-2-21,52
1946,2,22,826,400,426,1946-2-22,-26
1946,2,23,905,359,546,1946-2-23,-187
1946,2,24,1043,334,709,1946-2-24,-375
1946,2,25,1360,280,1080,1946-2-25,-800
1946,2,26,1501,276,1225,1946-2-26,-949
1946,2,27,1954,381,1573,1946-2-27,-1192
1946,2,28,2635,1270,1365,1946-2-28,-95
1946,3,1,2867,1956,911,1946-3-1,1045
1946,3,2,2719,1836,883,1946-3-2,953
1946,3,3,2921,2223,698,1946-3-3,1525
1946,3,4,2889,2311,578,1946-3-4,1733
1946,3,5,3078,2434,644,1946-3-5,1790
1946,3,6,2245,1948,297,1946-3-6,1651
1946,3,7,1818,1486,332,1946-3-7,1154
1946,3,8,1922,1490,432,1946-3-8,1058
1946,3,9,1639,1197,442,1946-3-9,755
1946,3,10,1419,949,470,1946-3-10,479
1946,3,11,1398,874,524,1946-3-11,350
1946,3,12,1304,615,689,1946-3-12,-74
1946,3,13,966,68,898,1946-3-13,-830
1946,3,14,1426,39,1387,1946-3-14,-1348
1946,3,15,933,0,933,1946-3-15,-933
1946,3,16,641,0,641,1946-3-16,-641
1946,3,17,875,56,819,1946-3-17,-763
1946,3,18,895,71,824,1946-3-18,-753
1946,3,19,682,42,640,1946-3-19,-598
1946,3,20,573,0,573,1946-3-20,-573
1946,3,21,1359,537,822,1946-3-21,-285
1946,3,22,1716,626,1090,1946-3-22,-464
1946,3,23,1944,979,965,1946-3-23,14
1946,3,24,1266,883,383,1946-3-24,500
1946,3,25,969,899,70,1946-3-25,829
1946,3,26,793,716,77,1946-3-26,639
1946,3,27,907,887,20,1946-3-27,867
1946,3,28,1268,778,490,1946-3-28,288
1946,3,29,1539,998,541,1946-3-29,457
1946,3,30,1601,972,629,1946-3-30,343
1946,3,31,1507,980,527,1946-3-31,453
1946,4,1,1814,1238,576,1946-4-1,662
1946,4,2,1658,796,862,1946-4-2,-66
1946,4,3,1624,733,891,1946-4-3,-158
1946,4,4,1406,584,822,1946-4-4,-238
1946,4,5,1142,444,698,1946-4-5,-254
1946,4,6,1056,409,647,1946-4-6,-238
1946,4,7,1094,357,737,1946-4-7,-380
1946,4,8,1474,294,1180,1946-4-8,-886
1946,4,9,1874,367,1507,1946-4-9,-1140
1946,4,10,1697,375,1322,1946-4-10,-947
1946,4,11,1252,0,1252,1946-4-11,-1252
1946,4,12,1336,0,1336,1946-4-12,-1336
1946,4,13,1112,0,1112,1946-4-13,-1112
1946,4,14,1165,0,1165,1946-4-14,-1165
1946,4,15,1369,0,1369,1946-4-15,-1369
1946,4,16,1345,0,1345,1946-4-16,-1345
1946,4,17,1115,0,1115,1946-4-17,-1115
1946,4,18,1247,257,990,1946-4-18,-733
1946,4,19,1398,301,1097,1946-4-19,-796
1946,4,20,1768,681,1087,1946-4-20,-406
1946,4,21,1587,1008,579,1946-4-21,429
1946,4,22,1200,1091,109,1946-4-22,982
1946,4,23,1171,1095,76,1946-4-23,1019
1946,4,24,1348,1176,172,1946-4-24,1004
1946,4,25,1258,1072,186,1946-4-25,886
1946,4,26,1281,1154,127,1946-4-26,1027
1946,4,27,1313,1070,243,1946-4-27,827
1946,4,28,1884,906,978,1946-4-28,-72
1946,4,29,2134,815,1319,1946-4-29,-504
1946,4,30,1882,667,1215,1946-4-30,-548
1946,5,1,1936,342,1594,1946-5-1,-1252
1946,5,2,1822,254,1568,1946-5-2,-1314
1946,5,3,2232,173,2059,1946-5-3,-1886
1946,5,4,2484,154,2330,1946-5-4,-2176
1946,5,5,2940,186,2754,1946-5-5,-2568
1946,5,6,2071,116,1955,1946-5-6,-1839
1946,5,7,1641,112,1529,1946-5-7,-1417
1946,5,8,1313,100,1213,1946-5-8,-1113
1946,5,9,884,4,880,1946-5-9,-876
1946,5,10,600,52,548,1946-5-10,-496
1946,5,11,526,151,375,1946-5-11,-224
1946,5,12,488,381,107,1946-5-12,274
1946,5,13,546,490,56,1946-5-13,434
1946,5,14,449,418,31,1946-5-14,387
1946,5,15,363,356,7,1946-5-15,349
1946,5,16,399,380,19,1946-5-16,361
1946,5,17,479,442,37,1946-5-17,405
1946,5,18,799,750,49,1946-5-18,701
1946,5,19,853,806,47,1946-5-19,759
1946,5,20,698,615,83,1946-5-20,532
1946,5,21,764,755,9,1946-5-21,746
1946,5,22,874,686,188,1946-5-22,498
1946,5,23,983,741,242,1946-5-23,499
1946,5,24,1098,913,185,1946-5-24,728
1946,5,25,1213,1156,57,1946-5-25,1099
1946,5,26,1272,1074,198,1946-5-26,876
1946,5,27,1152,968,184,1946-5-27,784
1946,5,28,917,792,125,1946-5-28,667
1946,5,29,921,807,114,1946-5-29,693
1946,5,30,746,695,51,1946-5-30,644
1946,5,31,169,122,47,1946-5-31,75
1946,6,1,113,59,54,1946-6-1,5
1946,6,2,272,110,162,1946-6-2,-52
1946,6,3,280,167,113,1946-6-3,54
1946,6,4,296,180,116,1946-6-4,64
1946,6,5,226,157,69,1946-6-5,88
1946,6,6,302,132,170,1946-6-6,-38
1946,6,7,330,61,269,1946-6-7,-208
1946,6,8,290,31,259,1946-6-8,-228
1946,6,9,337,124,213,1946-6-9,-89
1946,6,10,345,218,127,1946-6-10,91
1946,6,11,383,194,189,1946-6-11,5
1946,6,12,675,433,242,1946-6-12,191
1946,6,13,644,488,156,1946-6-13,332
1946,6,14,923,861,62,1946-6-14,799
1946,6,15,1099,1013,86,1946-6-15,927
1946,6,16,888,834,54,1946-6-16,780
1946,6,17,803,759,44,1946-6-17,715
1946,6,18,1040,799,241,1946-6-18,558
1946,6,19,987,598,389,1946-6-19,209
1946,6,20,1146,605,541,1946-6-20,64
1946,6,21,866,511,355,1946-6-21,156
1946,6,22,836,427,409,1946-6-22,18
1946,6,23,1170,502,668,1946-6-23,-166
1946,6,24,1226,381,845,1946-6-24,-464
1946,6,25,1239,310,929,1946-6-25,-619
1946,6,26,1291,286,1005,1946-6-26,-719
1946,6,27,975,121,854,1946-6-27,-733
1946,6,28,645,106,539,1946-6-28,-433
1946,6,29,823,421,402,1946-6-29,19
1946,6,30,1021,719,302,1946-6-30,417
1946,7,1,1227,694,533,1946-7-1,161
1946,7,2,1400,701,699,1946-7-2,2
1946,7,3,1654,736,918,1946-7-3,-182
1946,7,4,1533,681,852,1946-7-4,-171
1946,7,5,1716,726,990,1946-7-5,-264
1946,7,6,1793,831,962,1946-7-6,-131
1946,7,7,1539,749,790,1946-7-7,-41
1946,7,8,1183,501,682,1946-7-8,-181
1946,7,9,1064,480,584,1946-7-9,-104
1946,7,10,839,315,524,1946-7-10,-209
1946,7,11,820,234,586,1946-7-11,-352
1946,7,12,991,464,527,1946-7-12,-63
1946,7,13,1089,468,621,1946-7-13,-153
1946,7,14,1075,497,578,1946-7-14,-81
1946,7,15,939,475,464,1946-7-15,11
1946,7,16,1110,655,455,1946-7-16,200
1946,7,17,1608,914,694,1946-7-17,220
1946,7,18,1851,1050,801,1946-7-18,249
1946,7,19,2414,1414,1000,1946-7-19,414
1946,7,20,3528,2631,897,1946-7-20,1734
1946,7,21,5052,4500,552,1946-7-21,3948
1946,7,22,5213,4521,692,1946-7-22,3829
1946,7,23,6066,5298,768,1946-7-23,4530
1946,7,24,4912,4363,549,1946-7-24,3814
1946,7,25,4712,4506,206,1946-7-25,4300
1946,7,26,4626,4258,368,1946-7-26,3890
1946,7,27,4696,3964,732,1946-7-27,3232
1946,7,28,5537,4351,1186,1946-7-28,3165
1946,7,29,7175,5560,1615,1946-7-29,3945
1946,7,30,6766,4819,1947,1946-7-30,2872
1946,7,31,6157,4565,1592,1946-7-31,2973
1946,8,1,6142,4518,1624,1946-8-1,2894
1946,8,2,4673,3074,1599,1946-8-2,1475
1946,8,3,3073,1465,1608,1946-8-3,-143
1946,8,4,3554,1406,2148,1946-8-4,-742
1946,8,5,3936,1510,2426,1946-8-5,-916
1946,8,6,3273,1084,2189,1946-8-6,-1105
1946,8,7,3017,1030,1987,1946-8-7,-957
1946,8,8,2159,481,1678,1946-8-8,-1197
1946,8,9,1772,509,1263,1946-8-9,-754
1946,8,10,1742,551,1191,1946-8-10,-640
1946,8,11,1977,900,1077,1946-8-11,-177
1946,8,12,1669,781,888,1946-8-12,-107
1946,8,13,1786,928,858,1946-8-13,70
1946,8,14,1711,1043,668,1946-8-14,375
1946,8,15,1889,1243,646,1946-8-15,597
1946,8,16,1648,1158,490,1946-8-16,668
1946,8,17,1714,1281,433,1946-8-17,848
1946,8,18,2053,1876,177,1946-8-18,1699
1946,8,19,2313,2147,166,1946-8-19,1981
1946,8,20,2031,1896,135,1946-8-20,1761
1946,8,21,1731,1718,13,1946-8-21,1705
1946,8,22,2060,2060,0,1946-8-22,2060
1946,8,23,1996,1978,18,1946-8-23,1960
1946,8,24,1871,1847,24,1946-8-24,1823
1946,8,25,1511,1507,4,1946-8-25,1503
1946,8,26,1177,1123,54,1946-8-26,1069
1946,8,27,1400,1086,314,1946-8-27,772
1946,8,28,1370,904,466,1946-8-28,438
1946,8,29,1778,1283,495,1946-8-29,788
1946,8,30,1911,1380,531,1946-8-30,849
1946,8,31,2076,1499,577,1946-8-31,922
1946,9,1,2301,1800,501,1946-9-1,1299
1946,9,2,2512,2055,457,1946-9-2,1598
1946,9,3,2630,2202,428,1946-9-3,1774
1946,9,4,2075,1527,548,1946-9-4,979
1946,9,5,1187,762,425,1946-9-5,337
1946,9,6,1187,745,442,1946-9-6,303
1946,9,7,957,644,313,1946-9-7,331
1946,9,8,474,265,209,1946-9-8,56
1946,9,9,438,258,180,1946-9-9,78
1946,9,10,374,183,191,1946-9-10,-8
1946,9,11,475,183,292,1946-9-11,-109
1946,9,12,516,76,440,1946-9-12,-364
1946,9,13,2837,2197,640,1946-9-13,1557
1946,9,14,2770,2127,643,1946-9-14,1484
1946,9,15,2524,2061,463,1946-9-15,1598
1946,9,16,2567,2145,422,1946-9-16,1723
1946,9,17,2516,2268,248,1946-9-17,2020
1946,9,18,2383,2191,192,1946-9-18,1999
1946,9,19,2349,2163,186,1946-9-19,1977
1946,9,20,2139,2121,18,1946-9-20,2103
1946,9,21,2097,2097,0,1946-9-21,2097
1946,9,22,1249,1226,23,1946-9-22,1203
1946,9,23,1475,1293,182,1946-9-23,1111
1946,9,24,1648,1383,265,1946-9-24,1118
1946,9,25,2160,1634,526,1946-9-25,1108
1946,9,26,2647,1895,752,1946-9-26,1143
1946,9,27,3003,1672,1331,1946-9-27,341
1946,9,28,3034,1489,1545,1946-9-28,-56
1946,9,29,2067,1447,620,1946-9-29,827
1946,9,30,1204,683,521,1946-9-30,162
1946,10,1,954,503,451,1946-10-1,52
1946,10,2,1092,540,552,1946-10-2,-12
1946,10,3,802,230,572,1946-10-3,-342
1946,10,4,601,165,436,1946-10-4,-271
1946,10,5,730,238,492,1946-10-5,-254
1946,10,6,838,218,620,1946-10-6,-402
1946,10,7,633,141,492,1946-10-7,-351
1946,10,8,640,69,571,1946-10-8,-502
1946,10,9,774,60,714,1946-10-9,-654
1946,10,10,433,39,394,1946-10-10,-355
1946,10,11,540,34,506,1946-10-11,-472
1946,10,12,691,200,491,1946-10-12,-291
1946,10,13,1338,382,956,1946-10-13,-574
1946,10,14,1893,615,1278,1946-10-14,-663
1946,10,15,1877,642,1235,1946-10-15,-593
1946,10,16,1941,967,974,1946-10-16,-7
1946,10,17,1773,844,929,1946-10-17,-85
1946,10,18,1660,858,802,1946-10-18,56
1946,10,19,1685,844,841,1946-10-19,3
1946,10,20,1693,828,865,1946-10-20,-37
1946,10,21,1681,793,888,1946-10-21,-95
1946,10,22,2298,979,1319,1946-10-22,-340
1946,10,23,2286,1136,1150,1946-10-23,-14
1946,10,24,2188,914,1274,1946-10-24,-360
1946,10,25,2523,883,1640,1946-10-25,-757
1946,10,26,1993,804,1189,1946-10-26,-385
1946,10,27,1684,576,1108,1946-10-27,-532
1946,10,28,1342,447,895,1946-10-28,-448
1946,10,29,1086,387,699,1946-10-29,-312
1946,10,30,990,306,684,1946-10-30,-378
1946,10,31,1022,165,857,1946-10-31,-692
1946,11,1,886,87,799,1946-11-1,-712
1946,11,2,916,40,876,1946-11-2,-836
1946,11,3,632,45,587,1946-11-3,-542
1946,11,4,729,43,686,1946-11-4,-643
1946,11,5,889,116,773,1946-11-5,-657
1946,11,6,1489,637,852,1946-11-6,-215
1946,11,7,1553,829,724,1946-11-7,105
1946,11,8,1365,756,609,1946-11-8,147
1946,11,9,1477,936,541,1946-11-9,395
1946,11,10,1437,766,671,1946-11-10,95
1946,11,11,1557,715,842,1946-11-11,-127
1946,11,12,1820,741,1079,1946-11-12,-338
1946,11,13,2014,955,1059,1946-11-13,-104
1946,11,14,1988,806,1182,1946-11-14,-376
1946,11,15,2583,1078,1505,1946-11-15,-427
1946,11,16,2255,1020,1235,1946-11-16,-215
1946,11,17,1941,921,1020,1946-11-17,-99
1946,11,18,1743,789,954,1946-11-18,-165
1946,11,19,1934,908,1026,1946-11-19,-118
1946,11,20,1967,968,999,1946-11-20,-31
1946,11,21,2010,1172,838,1946-11-21,334
1946,11,22,2775,1904,871,1946-11-22,1033
1946,11,23,3357,2446,911,1946-11-23,1535
1946,11,24,3223,2292,931,1946-11-24,1361
1946,11,25,3492,2221,1271,1946-11-25,950
1946,11,26,3113,1877,1236,1946-11-26,641
1946,11,27,2047,1677,370,1946-11-27,1307
1946,11,28,1850,1346,504,1946-11-28,842
1946,11,29,1668,1298,370,1946-11-29,928
1946,11,30,861,538,323,1946-11-30,215
1946,12,1,841,298,543,1946-12-1,-245
1946,12,2,775,240,535,1946-12-2,-295
1946,12,3,1314,548,766,1946-12-3,-218
1946,12,4,957,450,507,1946-12-4,-57
1946,12,5,772,407,365,1946-12-5,42
1946,12,6,733,475,258,1946-12-6,217
1946,12,7,866,336,530,1946-12-7,-194
1946,12,8,508,81,427,1946-12-8,-346
1946,12,9,427,146,281,1946-12-9,-135
1946,12,10,1252,567,685,1946-12-10,-118
1946,12,11,3356,611,2745,1946-12-11,-2134
1946,12,12,3943,475,3468,1946-12-12,-2993
1946,12,13,3642,452,3190,1946-12-13,-2738
1946,12,14,3511,599,2912,1946-12-14,-2313
1946,12,15,3876,1167,2709,1946-12-15,-1542
1946,12,16,4031,1084,2947,1946-12-16,-1863
1946,12,17,4399,1343,3056,1946-12-17,-1713
1946,12,18,3770,1467,2303,1946-12-18,-836
1946,12,19,3379,1454,1925,1946-12-19,-471
1946,12,20,3971,1831,2140,1946-12-20,-309
1946,12,21,3707,1839,1868,1946-12-21,-29
1946,12,22,3577,2305,1272,1946-12-22,1033
1946,12,23,3174,2570,604,1946-12-23,1966
1946,12,24,3431,2881,550,1946-12-24,2331
1946,12,25,3382,2762,620,1946-12-25,2142
1946,12,26,3127,2552,575,1946-12-26,1977
1946,12,27,2874,2462,412,1946-12-27,2050
1946,12,28,2660,2196,464,1946-12-28,1732
1946,12,29,2183,1870,313,1946-12-29,1557
1946,12,30,2257,2016,241,1946-12-30,1775
1946,12,31,1224,1101,123,1946-12-31,978
1947,1,1,1205,918,287,1947-1-1,631
1947,1,2,1161,811,350,1947-1-2,461
1947,1,3,660,374,286,1947-1-3,88
1947,1,4,621,304,317,1947-1-4,-13
1947,1,5,811,473,338,1947-1-5,135
1947,1,6,1002,292,710,1947-1-6,-418
1947,1,7,1801,414,1387,1947-1-7,-973
1947,1,8,2383,927,1456,1947-1-8,-529
1947,1,9,2280,871,1409,1947-1-9,-538
1947,1,10,2322,810,1512,1947-1-10,-702
1947,1,11,2424,773,1651,1947-1-11,-878
1947,1,12,2853,1131,1722,1947-1-12,-591
1947,1,13,3430,1081,2349,1947-1-13,-1268
1947,1,14,3146,979,2167,1947-1-14,-1188
1947,1,15,4160,1121,3039,1947-1-15,-1918
1947,1,16,3990,1154,2836,1947-1-16,-1682
1947,1,17,4363,1213,3150,1947-1-17,-1937
1947,1,18,4109,1210,2899,1947-1-18,-1689
1947,1,19,2909,1199,1710,1947-1-19,-511
1947,1,20,2747,1321,1426,1947-1-20,-105
1947,1,21,2172,1121,1051,1947-1-21,70
1947,1,22,2088,1148,940,1947-1-22,208
1947,1,23,2107,1135,972,1947-1-23,163
1947,1,24,2547,836,1711,1947-1-24,-875
1947,1,25,2922,841,2081,1947-1-25,-1240
1947,1,26,2716,1103,1613,1947-1-26,-510
1947,1,27,2537,1111,1426,1947-1-27,-315
1947,1,28,1827,698,1129,1947-1-28,-431
1947,1,29,1029,9,1020,1947-1-29,-1011
1947,1,30,1343,58,1285,1947-1-30,-1227
1947,1,31,1870,22,1848,1947-1-31,-1826
1947,2,1,1827,0,1827,1947-2-1,-1827
1947,2,2,1715,0,1715,1947-2-2,-1715
1947,2,3,1757,0,1757,1947-2-3,-1757
1947,2,4,2232,20,2212,1947-2-4,-2192
1947,2,5,1715,24,1691,1947-2-5,-1667
1947,2,6,2030,29,2001,1947-2-6,-1972
1947,2,7,2373,0,2373,1947-2-7,-2373
1947,2,8,3540,166,3374,1947-2-8,-3208
1947,2,9,4061,268,3793,1947-2-9,-3525
1947,2,10,4617,228,4389,1947-2-10,-4161
1947,2,11,3871,187,3684,1947-2-11,-3497
1947,2,12,3874,324,3550,1947-2-12,-3226
1947,2,13,3876,225,3651,1947-2-13,-3426
1947,2,14,4076,303,3773,1947-2-14,-3470
1947,2,15,4118,338,3780,1947-2-15,-3442
1947,2,16,3895,193,3702,1947-2-16,-3509
1947,2,17,4162,295,3867,1947-2-17,-3572
1947,2,18,1859,172,1687,1947-2-18,-1515
1947,2,19,1817,520,1297,1947-2-19,-777
1947,2,20,1600,303,1297,1947-2-20,-994
1947,2,21,1781,184,1597,1947-2-21,-1413
1947,2,22,1324,222,1102,1947-2-22,-880
1947,2,23,1740,217,1523,1947-2-23,-1306
1947,2,24,1428,273,1155,1947-2-24,-882
1947,2,25,1608,177,1431,1947-2-25,-1254
1947,2,26,2670,605,2065,1947-2-26,-1460
1947,2,27,3456,1059,2397,1947-2-27,-1338
1947,2,28,3166,1138,2028,1947-2-28,-890
1947,3,1,2094,1215,879,1947-3-1,336
1947,3,2,2244,1186,1058,1947-3-2,128
1947,3,3,2089,935,1154,1947-3-3,-219
1947,3,4,4534,1177,3357,1947-3-4,-2180
1947,3,5,6922,2411,4511,1947-3-5,-2100
1947,3,6,7378,2763,4615,1947-3-6,-1852
1947,3,7,6933,1581,5352,1947-3-7,-3771
1947,3,8,7015,1522,5493,1947-3-8,-3971
1947,3,9,6703,1554,5149,1947-3-9,-3595
1947,3,10,6696,1332,5364,1947-3-10,-4032
1947,3,11,6688,1149,5539,1947-3-11,-4390
1947,3,12,6699,1005,5694,1947-3-12,-4689
1947,3,13,5764,683,5081,1947-3-13,-4398
1947,3,14,5103,448,4655,1947-3-14,-4207
1947,3,15,5452,614,4838,1947-3-15,-4224
1947,3,16,4529,171,4358,1947-3-16,-4187
1947,3,17,1348,14,1334,1947-3-17,-1320
1947,3,18,499,0,499,1947-3-18,-499
1947,3,19,376,0,376,1947-3-19,-376
1947,3,20,384,18,366,1947-3-20,-348
1947,3,21,694,279,415,1947-3-21,-136
1947,3,22,1016,297,719,1947-3-22,-422
1947,3,23,1709,389,1320,1947-3-23,-931
1947,3,24,1734,327,1407,1947-3-24,-1080
1947,3,25,1795,334,1461,1947-3-25,-1127
1947,3,26,1952,443,1509,1947-3-26,-1066
1947,3,27,1782,599,1183,1947-3-27,-584
1947,3,28,2121,647,1474,1947-3-28,-827
1947,3,29,2273,823,1450,1947-3-29,-627
1947,3,30,2781,754,2027,1947-3-30,-1273
1947,3,31,4162,752,3410,1947-3-31,-2658
1947,4,1,7547,702,6845,1947-4-1,-6143
1947,4,2,7324,655,6669,1947-4-2,-6014
1947,4,3,7519,553,6966,1947-4-3,-6413
1947,4,4,7187,437,6750,1947-4-4,-6313
1947,4,5,7245,464,6781,1947-4-5,-6317
1947,4,6,7352,421,6931,1947-4-6,-6510
1947,4,7,7505,215,7290,1947-4-7,-7075
1947,4,8,8382,142,8240,1947-4-8,-8098
1947,4,9,8094,87,8007,1947-4-9,-7920
1947,4,10,6390,179,6211,1947-4-10,-6032
1947,4,11,5395,193,5202,1947-4-11,-5009
1947,4,12,5724,149,5575,1947-4-12,-5426
1947,4,13,3959,98,3861,1947-4-13,-3763
1947,4,14,2421,181,2240,1947-4-14,-2059
1947,4,15,238,87,151,1947-4-15,-64
1947,4,16,213,68,145,1947-4-16,-77
1947,4,17,463,73,390,1947-4-17,-317
1947,4,18,643,94,549,1947-4-18,-455
1947,4,19,782,101,681,1947-4-19,-580
1947,4,20,657,154,503,1947-4-20,-349
1947,4,21,626,203,423,1947-4-21,-220
1947,4,22,726,115,611,1947-4-22,-496
1947,4,23,1624,234,1390,1947-4-23,-1156
1947,4,24,1904,460,1444,1947-4-24,-984
1947,4,25,3368,1481,1887,1947-4-25,-406
1947,4,26,3191,1707,1484,1947-4-26,223
1947,4,27,2863,1394,1469,1947-4-27,-75
1947,4,28,2858,1372,1486,1947-4-28,-114
1947,4,29,3057,1338,1719,1947-4-29,-381
1947,4,30,3252,1469,1783,1947-4-30,-314
1947,5,1,3351,1448,1903,1947-5-1,-455
1947,5,2,2889,974,1915,1947-5-2,-941
1947,5,3,2180,294,1886,1947-5-3,-1592
1947,5,4,3402,837,2565,1947-5-4,-1728
1947,5,5,2955,872,2083,1947-5-5,-1211
1947,5,6,2896,769,2127,1947-5-6,-1358
1947,5,7,3520,1008,2512,1947-5-7,-1504
1947,5,8,3270,1011,2259,1947-5-8,-1248
1947,5,9,2825,1443,1382,1947-5-9,61
1947,5,10,3547,2086,1461,1947-5-10,625
1947,5,11,3538,2210,1328,1947-5-11,882
1947,5,12,3027,2083,944,1947-5-12,1139
1947,5,13,2523,1645,878,1947-5-13,767
1947,5,14,2215,1637,578,1947-5-14,1059
1947,5,15,1851,1506,345,1947-5-15,1161
1947,5,16,1797,1636,161,1947-5-16,1475
1947,5,17,2353,2197,156,1947-5-17,2041
1947,5,18,4015,2939,1076,1947-5-18,1863
1947,5,19,4604,2901,1703,1947-5-19,1198
1947,5,20,5441,3302,2139,1947-5-20,1163
1947,5,21,4745,2586,2159,1947-5-21,427
1947,5,22,4840,2457,2383,1947-5-22,74
1947,5,23,5613,3175,2438,1947-5-23,737
1947,5,24,5186,2662,2524,1947-5-24,138
1947,5,25,5553,2611,2942,1947-5-25,-331
1947,5,26,4660,2007,2653,1947-5-26,-646
1947,5,27,4932,1841,3091,1947-5-27,-1250
1947,5,28,4666,1621,3045,1947-5-28,-1424
1947,5,29,5209,1840,3369,1947-5-29,-1529
1947,5,30,4596,1481,3115,1947-5-30,-1634
1947,5,31,3780,1257,2523,1947-5-31,-1266
1947,6,1,1997,353,1644,1947-6-1,-1291
1947,6,2,1737,426,1311,1947-6-2,-885
1947,6,3,1815,563,1252,1947-6-3,-689
1947,6,4,1732,1002,730,1947-6-4,272
1947,6,5,1699,1201,498,1947-6-5,703
1947,6,6,1751,1492,259,1947-6-6,1233
1947,6,7,1738,1599,139,1947-6-7,1460
1947,6,8,1631,1549,82,1947-6-8,1467
1947,6,9,1351,1324,27,1947-6-9,1297
1947,6,10,1126,1100,26,1947-6-10,1074
1947,6,11,882,868,14,1947-6-11,854
1947,6,12,979,973,6,1947-6-12,967
1947,6,13,922,867,55,1947-6-13,812
1947,6,14,739,717,22,1947-6-14,695
1947,6,15,2450,1506,944,1947-6-15,562
1947,6,16,1715,927,788,1947-6-16,139
1947,6,17,2022,957,1065,1947-6-17,-108
1947,6,18,2009,923,1086,1947-6-18,-163
1947,6,19,2791,1232,1559,1947-6-19,-327
1947,6,20,2482,1365,1117,1947-6-20,248
1947,6,21,3045,1708,1337,1947-6-21,371
1947,6,22,3380,1960,1420,1947-6-22,540
1947,6,23,3051,1691,1360,1947-6-23,331
1947,6,24,2759,2201,558,1947-6-24,1643
1947,6,25,2396,2038,358,1947-6-25,1680
1947,6,26,2594,2412,182,1947-6-26,2230
1947,6,27,2205,2042,163,1947-6-27,1879
1947,6,28,1617,1439,178,1947-6-28,1261
1947,6,29,1611,1112,499,1947-6-29,613
1947,6,30,1789,1112,677,1947-6-30,435
1947,7,1,1299,708,591,1947-7-1,117
1947,7,2,1147,663,484,1947-7-2,179
1947,7,3,1060,655,405,1947-7-3,250
1947,7,4,1303,587,716,1947-7-4,-129
1947,7,5,1502,526,976,1947-7-5,-450
1947,7,6,1316,453,863,1947-7-6,-410
1947,7,7,1162,267,895,1947-7-7,-628
1947,7,8,1195,238,957,1947-7-8,-719
1947,7,9,1868,292,1576,1947-7-9,-1284
1947,7,10,2140,651,1489,1947-7-10,-838
1947,7,11,1752,690,1062,1947-7-11,-372
1947,7,12,2604,1702,902,1947-7-12,800
1947,7,13,2488,1570,918,1947-7-13,652
1947,7,14,2914,2026,888,1947-7-14,1138
1947,7,15,3082,2270,812,1947-7-15,1458
1947,7,16,3073,2399,674,1947-7-16,1725
1947,7,17,3771,3240,531,1947-7-17,2709
1947,7,18,4304,3742,562,1947-7-18,3180
1947,7,19,4824,3606,1218,1947-7-19,2388
1947,7,20,4571,3326,1245,1947-7-20,2081
1947,7,21,4441,3051,1390,1947-7-21,1661
1947,7,22,3877,3188,689,1947-7-22,2499
1947,7,23,3266,2691,575,1947-7-23,2116
1947,7,24,2605,1946,659,1947-7-24,1287
1947,7,25,2695,2176,519,1947-7-25,1657
1947,7,26,2791,2287,504,1947-7-26,1783
1947,7,27,1402,797,605,1947-7-27,192
1947,7,28,1238,655,583,1947-7-28,72
1947,7,29,1698,572,1126,1947-7-29,-554
1947,7,30,2175,511,1664,1947-7-30,-1153
1947,7,31,2421,240,2181,1947-7-31,-1941
1947,8,1,3523,251,3272,1947-8-1,-3021
1947,8,2,4020,282,3738,1947-8-2,-3456
1947,8,3,4085,414,3671,1947-8-3,-3257
1947,8,4,4041,483,3558,1947-8-4,-3075
1947,8,5,3396,409,2987,1947-8-5,-2578
1947,8,6,3993,752,3241,1947-8-6,-2489
1947,8,7,4673,942,3731,1947-8-7,-2789
1947,8,8,5027,1404,3623,1947-8-8,-2219
1947,8,9,5150,1897,3253,1947-8-9,-1356
1947,8,10,5947,2465,3482,1947-8-10,-1017
1947,8,11,5357,2500,2857,1947-8-11,-357
1947,8,12,5022,2759,2263,1947-8-12,496
1947,8,13,4476,3292,1184,1947-8-13,2108
1947,8,14,4249,3640,609,1947-8-14,3031
1947,8,15,3969,3133,836,1947-8-15,2297
1947,8,16,3672,2701,971,1947-8-16,1730
1947,8,17,3179,2344,835,1947-8-17,1509
1947,8,18,2960,2003,957,1947-8-18,1046
1947,8,19,1587,845,742,1947-8-19,103
1947,8,20,1308,799,509,1947-8-20,290
1947,8,21,1335,673,662,1947-8-21,11
1947,8,22,971,565,406,1947-8-22,159
1947,8,23,549,187,362,1947-8-23,-175
1947,8,24,608,343,265,1947-8-24,78
1947,8,25,1518,1185,333,1947-8-25,852
1947,8,26,1386,971,415,1947-8-26,556
1947,8,27,2037,1096,941,1947-8-27,155
1947,8,28,2498,1009,1489,1947-8-28,-480
1947,8,29,2395,902,1493,1947-8-29,-591
1947,8,30,2895,1118,1777,1947-8-30,-659
1947,8,31,3601,1835,1766,1947-8-31,69
1947,9,1,3034,1393,1641,1947-9-1,-248
1947,9,2,2959,1358,1601,1947-9-2,-243
1947,9,3,2478,1121,1357,1947-9-3,-236
1947,9,4,2073,921,1152,1947-9-4,-231
1947,9,5,2075,981,1094,1947-9-5,-113
1947,9,6,2383,1317,1066,1947-9-6,251
1947,9,7,2432,1286,1146,1947-9-7,140
1947,9,8,2453,1321,1132,1947-9-8,189
1947,9,9,2341,1288,1053,1947-9-9,235
1947,9,10,1706,587,1119,1947-9-10,-532
1947,9,11,1456,628,828,1947-9-11,-200
1947,9,12,1876,822,1054,1947-9-12,-232
1947,9,13,1816,1106,710,1947-9-13,396
1947,9,14,1613,1054,559,1947-9-14,495
1947,9,15,1633,1084,549,1947-9-15,535
1947,9,16,1911,1098,813,1947-9-16,285
1947,9,17,1435,940,495,1947-9-17,445
1947,9,18,1440,936,504,1947-9-18,432
1947,9,19,902,655,247,1947-9-19,408
1947,9,20,996,696,300,1947-9-20,396
1947,9,21,1280,825,455,1947-9-21,370
1947,9,22,1413,984,429,1947-9-22,555
1947,9,23,1721,1183,538,1947-9-23,645
1947,9,24,1709,1318,391,1947-9-24,927
1947,9,25,2186,1491,695,1947-9-25,796
1947,9,26,2130,1190,940,1947-9-26,250
1947,9,27,2316,1304,1012,1947-9-27,292
1947,9,28,2579,1230,1349,1947-9-28,-119
1947,9,29,2906,1371,1535,1947-9-29,-164
1947,9,30,2496,1388,1108,1947-9-30,280
1947,10,1,2677,1681,996,1947-10-1,685
1947,10,2,3417,2015,1402,1947-10-2,613
1947,10,3,3419,2218,1201,1947-10-3,1017
1947,10,4,3940,2292,1648,1947-10-4,644
1947,10,5,3802,2398,1404,1947-10-5,994
1947,10,6,3299,2047,1252,1947-10-6,795
1947,10,7,2461,1726,735,1947-10-7,991
1947,10,8,2150,1674,476,1947-10-8,1198
1947,10,9,2246,1819,427,1947-10-9,1392
1947,10,10,2296,1533,763,1947-10-10,770
1947,10,11,1851,1257,594,1947-10-11,663
1947,10,12,2033,1389,644,1947-10-12,745
1947,10,13,1562,926,636,1947-10-13,290
1947,10,14,967,456,511,1947-10-14,-55
1947,10,15,1152,500,652,1947-10-15,-152
1947,10,16,1980,806,1174,1947-10-16,-368
1947,10,17,1571,797,774,1947-10-17,23
1947,10,18,1525,613,912,1947-10-18,-299
1947,10,19,1509,586,923,1947-10-19,-337
1947,10,20,1928,978,950,1947-10-20,28
1947,10,21,2435,807,1628,1947-10-21,-821
1947,10,22,2733,804,1929,1947-10-22,-1125
1947,10,23,2888,791,2097,1947-10-23,-1306
1947,10,24,3163,1241,1922,1947-10-24,-681
1947,10,25,3444,1723,1721,1947-10-25,2
1947,10,26,2558,1345,1213,1947-10-26,132
1947,10,27,2852,1534,1318,1947-10-27,216
1947,10,28,2388,1121,1267,1947-10-28,-146
1947,10,29,1984,589,1395,1947-10-29,-806
1947,10,30,1920,539,1381,1947-10-30,-842
1947,10,31,1623,228,1395,1947-10-31,-1167
1947,11,1,1097,174,923,1947-11-1,-749
1947,11,2,1256,172,1084,1947-11-2,-912
1947,11,3,924,210,714,1947-11-3,-504
1947,11,4,935,216,719,1947-11-4,-503
1947,11,5,737,177,560,1947-11-5,-383
1947,11,6,953,459,494,1947-11-6,-35
1947,11,7,1204,733,471,1947-11-7,262
1947,11,8,976,653,323,1947-11-8,330
1947,11,9,992,720,272,1947-11-9,448
1947,11,10,719,719,0,1947-11-10,719
1947,11,11,943,914,29,1947-11-11,885
1947,11,12,1279,1042,237,1947-11-12,805
1947,11,13,1631,1067,564,1947-11-13,503
1947,11,14,2242,1485,757,1947-11-14,728
1947,11,15,2584,1551,1033,1947-11-15,518
1947,11,16,2275,878,1397,1947-11-16,-519
1947,11,17,2691,870,1821,1947-11-17,-951
1947,11,18,2070,488,1582,1947-11-18,-1094
1947,11,19,2480,737,1743,1947-11-19,-1006
1947,11,20,2441,665,1776,1947-11-20,-1111
1947,11,21,2513,714,1799,1947-11-21,-1085
1947,11,22,2351,753,1598,1947-11-22,-845
1947,11,23,1797,647,1150,1947-11-23,-503
1947,11,24,2625,714,1911,1947-11-24,-1197
1947,11,25,2642,950,1692,1947-11-25,-742
1947,11,26,2259,618,1641,1947-11-26,-1023
1947,11,27,2014,345,1669,1947-11-27,-1324
1947,11,28,2150,229,1921,1947-11-28,-1692
1947,11,29,1182,181,1001,1947-11-29,-820
1947,11,30,630,131,499,1947-11-30,-368
1947,12,1,989,208,781,1947-12-1,-573
1947,12,2,1020,339,681,1947-12-2,-342
1947,12,3,735,246,489,1947-12-3,-243
1947,12,4,825,412,413,1947-12-4,-1
1947,12,5,993,435,558,1947-12-5,-123
1947,12,6,1648,439,1209,1947-12-6,-770
1947,12,7,1512,320,1192,1947-12-7,-872
1947,12,8,2166,372,1794,1947-12-8,-1422
1947,12,9,1798,230,1568,1947-12-9,-1338
1947,12,10,1730,257,1473,1947-12-10,-1216
1947,12,11,1405,193,1212,1947-12-11,-1019
1947,12,12,1706,162,1544,1947-12-12,-1382
1947,12,13,1324,136,1188,1947-12-13,-1052
1947,12,14,1660,156,1504,1947-12-14,-1348
1947,12,15,1512,236,1276,1947-12-15,-1040
1947,12,16,2251,430,1821,1947-12-16,-1391
1947,12,17,2392,649,1743,1947-12-17,-1094
1947,12,18,2673,918,1755,1947-12-18,-837
1947,12,19,2305,1132,1173,1947-12-19,-41
1947,12,20,1891,1406,485,1947-12-20,921
1947,12,21,1103,1017,86,1947-12-21,931
1947,12,22,1165,878,287,1947-12-22,591
1947,12,23,1082,572,510,1947-12-23,62
1947,12,24,811,522,289,1947-12-24,233
1947,12,25,976,240,736,1947-12-25,-496
1947,12,26,1400,162,1238,1947-12-26,-1076
1947,12,27,1942,166,1776,1947-12-27,-1610
1947,12,28,2304,469,1835,1947-12-28,-1366
1947,12,29,3059,943,2116,1947-12-29,-1173
1947,12,30,2655,695,1960,1947-12-30,-1265
1947,12,31,1888,428,1460,1947-12-31,-1032
1948,1,1,1777,485,1292,1948-1-1,-807
1948,1,2,1936,603,1333,1948-1-2,-730
1948,1,3,2006,961,1045,1948-1-3,-84
1948,1,4,1763,735,1028,1948-1-4,-293
1948,1,5,1538,625,913,1948-1-5,-288
1948,1,6,1057,234,823,1948-1-6,-589
1948,1,7,885,215,670,1948-1-7,-455
1948,1,8,820,204,616,1948-1-8,-412
1948,1,9,758,186,572,1948-1-9,-386
1948,1,10,993,119,874,1948-1-10,-755
1948,1,11,610,50,560,1948-1-11,-510
1948,1,12,635,205,430,1948-1-12,-225
1948,1,13,799,205,594,1948-1-13,-389
1948,1,14,792,150,642,1948-1-14,-492
1948,1,15,839,210,629,1948-1-15,-419
1948,1,16,939,283,656,1948-1-16,-373
1948,1,17,540,181,359,1948-1-17,-178
1948,1,18,536,156,380,1948-1-18,-224
1948,1,19,737,178,559,1948-1-19,-381
1948,1,20,923,161,762,1948-1-20,-601
1948,1,21,1376,156,1220,1948-1-21,-1064
1948,1,22,1557,183,1374,1948-1-22,-1191
1948,1,23,1598,200,1398,1948-1-23,-1198
1948,1,24,1774,279,1495,1948-1-24,-1216
1948,1,25,1553,116,1437,1948-1-25,-1321
1948,1,26,1017,65,952,1948-1-26,-887
1948,1,27,922,148,774,1948-1-27,-626
1948,1,28,908,154,754,1948-1-28,-600
1948,1,29,682,87,595,1948-1-29,-508
1948,1,30,1216,76,1140,1948-1-30,-1064
1948,1,31,1019,26,993,1948-1-31,-967
1948,2,1,803,58,745,1948-2-1,-687
1948,2,2,888,134,754,1948-2-2,-620
1948,2,3,984,89,895,1948-2-3,-806
1948,2,4,1044,88,956,1948-2-4,-868
1948,2,5,798,73,725,1948-2-5,-652
1948,2,6,981,96,885,1948-2-6,-789
1948,2,7,1112,167,945,1948-2-7,-778
1948,2,8,840,192,648,1948-2-8,-456
1948,2,9,938,349,589,1948-2-9,-240
1948,2,10,1207,694,513,1948-2-10,181
1948,2,11,805,425,380,1948-2-11,45
1948,2,12,558,183,375,1948-2-12,-192
1948,2,13,341,57,284,1948-2-13,-227
1948,2,14,560,127,433,1948-2-14,-306
1948,2,15,288,153,135,1948-2-15,18
1948,2,16,496,155,341,1948-2-16,-186
1948,2,17,628,156,472,1948-2-17,-316
1948,2,18,1209,439,770,1948-2-18,-331
1948,2,19,1312,710,602,1948-2-19,108
1948,2,20,3385,2400,985,1948-2-20,1415
1948,2,21,3319,2578,741,1948-2-21,1837
1948,2,22,1888,1548,340,1948-2-22,1208
1948,2,23,934,268,666,1948-2-23,-398
1948,2,24,385,160,225,1948-2-24,-65
1948,2,25,609,371,238,1948-2-25,133
1948,2,26,1507,1156,351,1948-2-26,805
1948,2,27,1254,909,345,1948-2-27,564
1948,2,28,1180,826,354,1948-2-28,472
1948,2,29,1345,1010,335,1948-2-29,675
1948,3,1,1479,1103,376,1948-3-1,727
1948,3,2,1436,1039,397,1948-3-2,642
1948,3,3,1299,959,340,1948-3-3,619
1948,3,4,1201,934,267,1948-3-4,667
1948,3,5,1231,962,269,1948-3-5,693
1948,3,6,1187,897,290,1948-3-6,607
1948,3,7,966,736,230,1948-3-7,506
1948,3,8,1210,861,349,1948-3-8,512
1948,3,9,2528,1673,855,1948-3-9,818
1948,3,10,1957,1275,682,1948-3-10,593
1948,3,11,1923,1105,818,1948-3-11,287
1948,3,12,2214,1230,984,1948-3-12,246
1948,3,13,1714,1096,618,1948-3-13,478
1948,3,14,1427,887,540,1948-3-14,347
1948,3,15,1301,840,461,1948-3-15,379
1948,3,16,1312,883,429,1948-3-16,454
1948,3,17,1297,992,305,1948-3-17,687
1948,3,18,1245,968,277,1948-3-18,691
1948,3,19,1234,830,404,1948-3-19,426
1948,3,20,1092,720,372,1948-3-20,348
1948,3,21,569,452,117,1948-3-21,335
1948,3,22,47,18,29,1948-3-22,-11
1948,3,23,9,0,9,1948-3-23,-9
1948,3,24,549,504,45,1948-3-24,459
1948,3,25,588,513,75,1948-3-25,438
1948,3,26,828,553,275,1948-3-26,278
1948,3,27,899,663,236,1948-3-27,427
1948,3,28,888,616,272,1948-3-28,344
1948,3,29,1666,1067,599,1948-3-29,468
1948,3,30,1908,1146,762,1948-3-30,384
1948,3,31,1896,1325,571,1948-3-31,754
1948,4,1,3334,2458,876,1948-4-1,1582
1948,4,2,3057,2206,851,1948-4-2,1355
1948,4,3,4007,2616,1391,1948-4-3,1225
1948,4,4,4102,2150,1952,1948-4-4,198
1948,4,5,3150,937,2213,1948-4-5,-1276
1948,4,6,2955,770,2185,1948-4-6,-1415
1948,4,7,2722,868,1854,1948-4-7,-986
1948,4,8,2647,797,1850,1948-4-8,-1053
1948,4,9,3115,805,2310,1948-4-9,-1505
1948,4,10,1948,727,1221,1948-4-10,-494
1948,4,11,2646,1418,1228,1948-4-11,190
1948,4,12,2964,1574,1390,1948-4-12,184
1948,4,13,3518,1745,1773,1948-4-13,-28
1948,4,14,3474,1808,1666,1948-4-14,142
1948,4,15,3392,1827,1565,1948-4-15,262
1948,4,16,3876,1834,2042,1948-4-16,-208
1948,4,17,4147,1412,2735,1948-4-17,-1323
1948,4,18,3716,1253,2463,1948-4-18,-1210
1948,4,19,4693,2249,2444,1948-4-19,-195
1948,4,20,5581,3535,2046,1948-4-20,1489
1948,4,21,3617,3225,392,1948-4-21,2833
1948,4,22,3465,2928,537,1948-4-22,2391
1948,4,23,3710,3061,649,1948-4-23,2412
1948,4,24,4051,2933,1118,1948-4-24,1815
1948,4,25,4261,2801,1460,1948-4-25,1341
1948,4,26,3642,2700,942,1948-4-26,1758
1948,4,27,3435,2640,795,1948-4-27,1845
1948,4,28,2806,2090,716,1948-4-28,1374
1948,4,29,2561,1876,685,1948-4-29,1191
1948,4,30,2371,1682,689,1948-4-30,993
1948,5,1,2005,1431,574,1948-5-1,857
1948,5,2,1980,1511,469,1948-5-2,1042
1948,5,3,1767,975,792,1948-5-3,183
1948,5,4,3059,1080,1979,1948-5-4,-899
1948,5,5,3303,1077,2226,1948-5-5,-1149
1948,5,6,5129,1121,4008,1948-5-6,-2887
1948,5,7,5625,1461,4164,1948-5-7,-2703
1948,5,8,6079,2120,3959,1948-5-8,-1839
1948,5,9,5593,1543,4050,1948-5-9,-2507
1948,5,10,6068,1448,4620,1948-5-10,-3172
1948,5,11,6473,1494,4979,1948-5-11,-3485
1948,5,12,6399,1432,4967,1948-5-12,-3535
1948,5,13,5777,1572,4205,1948-5-13,-2633
1948,5,14,4764,1007,3757,1948-5-14,-2750
1948,5,15,3581,847,2734,1948-5-15,-1887
1948,5,16,2946,613,2333,1948-5-16,-1720
1948,5,17,2989,1053,1936,1948-5-17,-883
1948,5,18,2226,503,1723,1948-5-18,-1220
1948,5,19,1664,438,1226,1948-5-19,-788
1948,5,20,1501,426,1075,1948-5-20,-649
1948,5,21,1226,298,928,1948-5-21,-630
1948,5,22,1344,361,983,1948-5-22,-622
1948,5,23,1136,395,741,1948-5-23,-346
1948,5,24,1424,420,1004,1948-5-24,-584
1948,5,25,1549,840,709,1948-5-25,131
1948,5,26,1929,1435,494,1948-5-26,941
1948,5,27,3528,3075,453,1948-5-27,2622
1948,5,28,3337,2978,359,1948-5-28,2619
1948,5,29,2911,2592,319,1948-5-29,2273
1948,5,30,2773,2340,433,1948-5-30,1907
1948,5,31,2377,2071,306,1948-5-31,1765
1948,6,1,2193,1959,234,1948-6-1,1725
1948,6,2,2122,1878,244,1948-6-2,1634
1948,6,3,2297,1614,683,1948-6-3,931
1948,6,4,2256,1385,871,1948-6-4,514
1948,6,5,2450,1495,955,1948-6-5,540
1948,6,6,2212,1284,928,1948-6-6,356
1948,6,7,2452,1207,1245,1948-6-7,-38
1948,6,8,2413,1171,1242,1948-6-8,-71
1948,6,9,1796,111,1685,1948-6-9,-1574
1948,6,10,1896,197,1699,1948-6-10,-1502
1948,6,11,1418,42,1376,1948-6-11,-1334
1948,6,12,1157,99,1058,1948-6-12,-959
1948,6,13,897,110,787,1948-6-13,-677
1948,6,14,1113,329,784,1948-6-14,-455
1948,6,15,1333,590,743,1948-6-15,-153
1948,6,16,1601,767,834,1948-6-16,-67
1948,6,17,2340,1603,737,1948-6-17,866
1948,6,18,3065,2437,628,1948-6-18,1809
1948,6,19,3413,2351,1062,1948-6-19,1289
1948,6,20,3709,1885,1824,1948-6-20,61
1948,6,21,3657,1741,1916,1948-6-21,-175
1948,6,22,3253,1450,1803,1948-6-22,-353
1948,6,23,3829,1745,2084,1948-6-23,-339
1948,6,24,4383,2092,2291,1948-6-24,-199
1948,6,25,4183,1912,2271,1948-6-25,-359
1948,6,26,3351,1703,1648,1948-6-26,55
1948,6,27,3167,1752,1415,1948-6-27,337
1948,6,28,2576,1569,1007,1948-6-28,562
1948,6,29,3328,2133,1195,1948-6-29,938
1948,6,30,2923,2152,771,1948-6-30,1381
1948,7,1,2503,1921,582,1948-7-1,1339
1948,7,2,2080,1777,303,1948-7-2,1474
1948,7,3,1974,1536,438,1948-7-3,1098
1948,7,4,2002,1547,455,1948-7-4,1092
1948,7,5,2280,1627,653,1948-7-5,974
1948,7,6,810,486,324,1948-7-6,162
1948,7,7,830,509,321,1948-7-7,188
1948,7,8,801,531,270,1948-7-8,261
1948,7,9,1009,807,202,1948-7-9,605
1948,7,10,1019,772,247,1948-7-10,525
1948,7,11,1654,1210,444,1948-7-11,766
1948,7,12,1457,1169,288,1948-7-12,881
1948,7,13,1475,1188,287,1948-7-13,901
1948,7,14,1395,1185,210,1948-7-14,975
1948,7,15,1526,1350,176,1948-7-15,1174
1948,7,16,1287,1084,203,1948-7-16,881
1948,7,17,1383,1078,305,1948-7-17,773
1948,7,18,1415,1070,345,1948-7-18,725
1948,7,19,1339,1027,312,1948-7-19,715
1948,7,20,1785,1339,446,1948-7-20,893
1948,7,21,2309,1831,478,1948-7-21,1353
1948,7,22,2328,1762,566,1948-7-22,1196
1948,7,23,2129,1463,666,1948-7-23,797
1948,7,24,1707,1198,509,1948-7-24,689
1948,7,25,2298,1611,687,1948-7-25,924
1948,7,26,2068,1576,492,1948-7-26,1084
1948,7,27,2042,1693,349,1948-7-27,1344
1948,7,28,2089,1681,408,1948-7-28,1273
1948,7,29,2500,1911,589,1948-7-29,1322
1948,7,30,2539,1856,683,1948-7-30,1173
1948,7,31,2713,1612,1101,1948-7-31,511
1948,8,1,3091,1252,1839,1948-8-1,-587
1948,8,2,2575,851,1724,1948-8-2,-873
1948,8,3,3148,494,2654,1948-8-3,-2160
1948,8,4,4134,625,3509,1948-8-4,-2884
1948,8,5,3718,597,3121,1948-8-5,-2524
1948,8,6,3160,413,2747,1948-8-6,-2334
1948,8,7,2707,373,2334,1948-8-7,-1961
1948,8,8,2431,389,2042,1948-8-8,-1653
1948,8,9,1991,264,1727,1948-8-9,-1463
1948,8,10,1551,226,1325,1948-8-10,-1099
1948,8,11,1262,169,1093,1948-8-11,-924
1948,8,12,1185,151,1034,1948-8-12,-883
1948,8,13,1504,534,970,1948-8-13,-436
1948,8,14,1731,692,1039,1948-8-14,-347
1948,8,15,1351,830,521,1948-8-15,309
1948,8,16,1646,913,733,1948-8-16,180
1948,8,17,1990,1145,845,1948-8-17,300
1948,8,18,2034,1116,918,1948-8-18,198
1948,8,19,2559,1423,1136,1948-8-19,287
1948,8,20,2160,1196,964,1948-8-20,232
1948,8,21,2443,1603,840,1948-8-21,763
1948,8,22,1729,1224,505,1948-8-22,719
1948,8,23,1438,1075,363,1948-8-23,712
1948,8,24,1521,981,540,1948-8-24,441
1948,8,25,1148,667,481,1948-8-25,186
1948,8,26,1243,725,518,1948-8-26,207
1948,8,27,1576,996,580,1948-8-27,416
1948,8,28,1655,968,687,1948-8-28,281
1948,8,29,1811,718,1093,1948-8-29,-375
1948,8,30,1934,608,1326,1948-8-30,-718
1948,8,31,1907,788,1119,1948-8-31,-331
1948,9,1,1793,672,1121,1948-9-1,-449
1948,9,2,1355,541,814,1948-9-2,-273
1948,9,3,1510,600,910,1948-9-3,-310
1948,9,4,1229,558,671,1948-9-4,-113
1948,9,5,1176,705,471,1948-9-5,234
1948,9,6,1144,825,319,1948-9-6,506
1948,9,7,1098,846,252,1948-9-7,594
1948,9,8,855,483,372,1948-9-8,111
1948,9,9,590,172,418,1948-9-9,-246
1948,9,10,371,95,276,1948-9-10,-181
1948,9,11,557,214,343,1948-9-11,-129
1948,9,12,2267,407,1860,1948-9-12,-1453
1948,9,13,2083,360,1723,1948-9-13,-1363
1948,9,14,2000,436,1564,1948-9-14,-1128
1948,9,15,2350,299,2051,1948-9-15,-1752
1948,9,16,2443,156,2287,1948-9-16,-2131
1948,9,17,2750,88,2662,1948-9-17,-2574
1948,9,18,3337,289,3048,1948-9-18,-2759
1948,9,19,2872,568,2304,1948-9-19,-1736
1948,9,20,2910,750,2160,1948-9-20,-1410
1948,9,21,3000,729,2271,1948-9-21,-1542
1948,9,22,3338,1403,1935,1948-9-22,-532
1948,9,23,3725,1799,1926,1948-9-23,-127
1948,9,24,2920,1419,1501,1948-9-24,-82
1948,9,25,1984,1278,706,1948-9-25,572
1948,9,26,1827,963,864,1948-9-26,99
1948,9,27,1542,831,711,1948-9-27,120
1948,9,28,1425,596,829,1948-9-28,-233
1948,9,29,657,341,316,1948-9-29,25
1948,9,30,840,382,458,1948-9-30,-76
1948,10,1,817,441,376,1948-10-1,65
1948,10,2,1013,705,308,1948-10-2,397
1948,10,3,806,608,198,1948-10-3,410
1948,10,4,1609,1203,406,1948-10-4,797
1948,10,5,2049,1642,407,1948-10-5,1235
1948,10,6,1528,1297,231,1948-10-6,1066
1948,10,7,840,685,155,1948-10-7,530
1948,10,8,583,420,163,1948-10-8,257
1948,10,9,1194,383,811,1948-10-9,-428
1948,10,10,1583,419,1164,1948-10-10,-745
1948,10,11,2444,1301,1143,1948-10-11,158
1948,10,12,2429,1452,977,1948-10-12,475
1948,10,13,3460,2086,1374,1948-10-13,712
1948,10,14,3622,2134,1488,1948-10-14,646
1948,10,15,3036,1874,1162,1948-10-15,712
1948,10,16,2299,1545,754,1948-10-16,791
1948,10,17,2126,1378,748,1948-10-17,630
1948,10,18,1726,1065,661,1948-10-18,404
1948,10,19,1875,1186,689,1948-10-19,497
1948,10,20,1576,941,635,1948-10-20,306
1948,10,21,1824,1512,312,1948-10-21,1200
1948,10,22,2295,1945,350,1948-10-22,1595
1948,10,23,1698,1314,384,1948-10-23,930
1948,10,24,1453,1038,415,1948-10-24,623
1948,10,25,1451,911,540,1948-10-25,371
1948,10,26,1696,765,931,1948-10-26,-166
1948,10,27,1673,695,978,1948-10-27,-283
1948,10,28,1511,679,832,1948-10-28,-153
1948,10,29,1556,843,713,1948-10-29,130
1948,10,30,1312,664,648,1948-10-30,16
1948,10,31,1020,629,391,1948-10-31,238
1948,11,1,1216,898,318,1948-11-1,580
1948,11,2,719,505,214,1948-11-2,291
1948,11,3,928,928,0,1948-11-3,928
1948,11,4,1063,1053,10,1948-11-4,1043
1948,11,5,744,718,26,1948-11-5,692
1948,11,6,917,883,34,1948-11-6,849
1948,11,7,785,635,150,1948-11-7,485
1948,11,8,885,571,314,1948-11-8,257
1948,11,9,931,523,408,1948-11-9,115
1948,11,10,772,463,309,1948-11-10,154
1948,11,11,846,440,406,1948-11-11,34
1948,11,12,1285,419,866,1948-11-12,-447
1948,11,13,996,318,678,1948-11-13,-360
1948,11,14,721,231,490,1948-11-14,-259
1948,11,15,1315,748,567,1948-11-15,181
1948,11,16,1384,647,737,1948-11-16,-90
1948,11,17,1807,544,1263,1948-11-17,-719
1948,11,18,1678,396,1282,1948-11-18,-886
1948,11,19,2301,289,2012,1948-11-19,-1723
1948,11,20,1559,273,1286,1948-11-20,-1013
1948,11,21,1608,237,1371,1948-11-21,-1134
1948,11,22,1220,302,918,1948-11-22,-616
1948,11,23,1413,545,868,1948-11-23,-323
1948,11,24,660,493,167,1948-11-24,326
1948,11,25,661,647,14,1948-11-25,633
1948,11,26,564,559,5,1948-11-26,554
1948,11,27,405,405,0,1948-11-27,405
1948,11,28,345,345,0,1948-11-28,345
1948,11,29,224,224,0,1948-11-29,224
1948,11,30,230,230,0,1948-11-30,230
1948,12,1,570,178,392,1948-12-1,-214
1948,12,2,567,183,384,1948-12-2,-201
1948,12,3,558,275,283,1948-12-3,-8
1948,12,4,1116,303,813,1948-12-4,-510
1948,12,5,1076,185,891,1948-12-5,-706
1948,12,6,1171,92,1079,1948-12-6,-987
1948,12,7,1405,128,1277,1948-12-7,-1149
1948,12,8,2659,127,2532,1948-12-8,-2405
1948,12,9,3514,101,3413,1948-12-9,-3312
1948,12,10,2950,107,2843,1948-12-10,-2736
1948,12,11,2097,66,2031,1948-12-11,-1965
1948,12,12,2282,123,2159,1948-12-12,-2036
1948,12,13,2077,122,1955,1948-12-13,-1833
1948,12,14,2463,182,2281,1948-12-14,-2099
1948,12,15,2710,333,2377,1948-12-15,-2044
1948,12,16,2273,429,1844,1948-12-16,-1415
1948,12,17,2988,989,1999,1948-12-17,-1010
1948,12,18,2850,1332,1518,1948-12-18,-186
1948,12,19,2696,1139,1557,1948-12-19,-418
1948,12,20,3044,1475,1569,1948-12-20,-94
1948,12,21,3025,1617,1408,1948-12-21,209
1948,12,22,3037,1192,1845,1948-12-22,-653
1948,12,23,3321,981,2340,1948-12-23,-1359
1948,12,24,4335,1091,3244,1948-12-24,-2153
1948,12,25,4959,1373,3586,1948-12-25,-2213
1948,12,26,4036,907,3129,1948-12-26,-2222
1948,12,27,3710,738,2972,1948-12-27,-2234
1948,12,28,3303,711,2592,1948-12-28,-1881
1948,12,29,3219,843,2376,1948-12-29,-1533
1948,12,30,1686,820,866,1948-12-30,-46
1948,12,31,1087,645,442,1948-12-31,203
1949,1,1,1263,638,625,1949-1-1,13
1949,1,2,1214,499,715,1949-1-2,-216
1949,1,3,1182,398,784,1949-1-3,-386
1949,1,4,1076,327,749,1949-1-4,-422
1949,1,5,936,433,503,1949-1-5,-70
1949,1,6,906,219,687,1949-1-6,-468
1949,1,7,818,229,589,1949-1-7,-360
1949,1,8,918,166,752,1949-1-8,-586
1949,1,9,1307,69,1238,1949-1-9,-1169
1949,1,10,1018,39,979,1949-1-10,-940
1949,1,11,1143,273,870,1949-1-11,-597
1949,1,12,1121,394,727,1949-1-12,-333
1949,1,13,1609,396,1213,1949-1-13,-817
1949,1,14,1335,273,1062,1949-1-14,-789
1949,1,15,1584,383,1201,1949-1-15,-818
1949,1,16,2960,1950,1010,1949-1-16,940
1949,1,17,3981,2929,1052,1949-1-17,1877
1949,1,18,4338,3205,1133,1949-1-18,2072
1949,1,19,3832,2592,1240,1949-1-19,1352
1949,1,20,4771,2960,1811,1949-1-20,1149
1949,1,21,4734,2913,1821,1949-1-21,1092
1949,1,22,3427,2605,822,1949-1-22,1783
1949,1,23,3281,2660,621,1949-1-23,2039
1949,1,24,3445,2854,591,1949-1-24,2263
1949,1,25,3482,2697,785,1949-1-25,1912
1949,1,26,3381,2683,698,1949-1-26,1985
1949,1,27,2836,2297,539,1949-1-27,1758
1949,1,28,2437,1781,656,1949-1-28,1125
1949,1,29,1056,237,819,1949-1-29,-582
1949,1,30,2027,849,1178,1949-1-30,-329
1949,1,31,2023,850,1173,1949-1-31,-323
1949,2,1,2901,895,2006,1949-2-1,-1111
1949,2,2,3281,1049,2232,1949-2-2,-1183
1949,2,3,3822,938,2884,1949-2-3,-1946
1949,2,4,4369,935,3434,1949-2-4,-2499
1949,2,5,4549,969,3580,1949-2-5,-2611
1949,2,6,4608,907,3701,1949-2-6,-2794
1949,2,7,4105,667,3438,1949-2-7,-2771
1949,2,8,3967,582,3385,1949-2-8,-2803
1949,2,9,3683,378,3305,1949-2-9,-2927
1949,2,10,4010,410,3600,1949-2-10,-3190
1949,2,11,3873,957,2916,1949-2-11,-1959
1949,2,12,2714,1132,1582,1949-2-12,-450
1949,2,13,3650,1896,1754,1949-2-13,142
1949,2,14,3741,1920,1821,1949-2-14,99
1949,2,15,3586,1849,1737,1949-2-15,112
1949,2,16,3540,1739,1801,1949-2-16,-62
1949,2,17,4374,1763,2611,1949-2-17,-848
1949,2,18,3969,1594,2375,1949-2-18,-781
1949,2,19,4635,2032,2603,1949-2-19,-571
1949,2,20,4318,1877,2441,1949-2-20,-564
1949,2,21,3296,1553,1743,1949-2-21,-190
1949,2,22,3493,1476,2017,1949-2-22,-541
1949,2,23,2714,1705,1009,1949-2-23,696
1949,2,24,2967,2278,689,1949-2-24,1589
1949,2,25,2843,2213,630,1949-2-25,1583
1949,2,26,2868,1812,1056,1949-2-26,756
1949,2,27,3123,2010,1113,1949-2-27,897
1949,2,28,2929,2309,620,1949-2-28,1689
1949,3,1,3269,2576,693,1949-3-1,1883
1949,3,2,3287,2659,628,1949-3-2,2031
1949,3,3,3856,3393,463,1949-3-3,2930
1949,3,4,4268,3905,363,1949-3-4,3542
1949,3,5,3876,3476,400,1949-3-5,3076
1949,3,6,2819,2376,443,1949-3-6,1933
1949,3,7,2864,2177,687,1949-3-7,1490
1949,3,8,3240,2391,849,1949-3-8,1542
1949,3,9,3459,2062,1397,1949-3-9,665
1949,3,10,3540,1951,1589,1949-3-10,362
1949,3,11,3270,1859,1411,1949-3-11,448
1949,3,12,3342,1919,1423,1949-3-12,496
1949,3,13,3726,2362,1364,1949-3-13,998
1949,3,14,4457,2180,2277,1949-3-14,-97
1949,3,15,4404,2049,2355,1949-3-15,-306
1949,3,16,4027,1827,2200,1949-3-16,-373
1949,3,17,4096,1867,2229,1949-3-17,-362
1949,3,18,4047,1844,2203,1949-3-18,-359
1949,3,19,4483,1931,2552,1949-3-19,-621
1949,3,20,4979,2257,2722,1949-3-20,-465
1949,3,21,4750,2633,2117,1949-3-21,516
1949,3,22,4207,2543,1664,1949-3-22,879
1949,3,23,3255,1961,1294,1949-3-23,667
1949,3,24,3625,2485,1140,1949-3-24,1345
1949,3,25,2742,1956,786,1949-3-25,1170
1949,3,26,1745,754,991,1949-3-26,-237
1949,3,27,1352,795,557,1949-3-27,238
1949,3,28,1192,771,421,1949-3-28,350
1949,3,29,1094,909,185,1949-3-29,724
1949,3,30,1280,1021,259,1949-3-30,762
1949,3,31,1027,829,198,1949-3-31,631
1949,4,1,1498,1064,434,1949-4-1,630
1949,4,2,1780,1380,400,1949-4-2,980
1949,4,3,1640,1045,595,1949-4-3,450
1949,4,4,2001,1000,1001,1949-4-4,-1
1949,4,5,1884,809,1075,1949-4-5,-266
1949,4,6,1889,1290,599,1949-4-6,691
1949,4,7,1967,1270,697,1949-4-7,573
1949,4,8,2431,1757,674,1949-4-8,1083
1949,4,9,2005,1326,679,1949-4-9,647
1949,4,10,2687,1980,707,1949-4-10,1273
1949,4,11,1660,901,759,1949-4-11,142
1949,4,12,1802,859,943,1949-4-12,-84
1949,4,13,2105,1168,937,1949-4-13,231
1949,4,14,2024,1097,927,1949-4-14,170
1949,4,15,1737,982,755,1949-4-15,227
1949,4,16,1794,1062,732,1949-4-16,330
1949,4,17,1898,1024,874,1949-4-17,150
1949,4,18,1991,1317,674,1949-4-18,643
1949,4,19,2334,1227,1107,1949-4-19,120
1949,4,20,2496,1480,1016,1949-4-20,464
1949,4,21,2336,1375,961,1949-4-21,414
1949,4,22,1935,1094,841,1949-4-22,253
1949,4,23,1724,972,752,1949-4-23,220
1949,4,24,1883,945,938,1949-4-24,7
1949,4,25,1786,955,831,1949-4-25,124
1949,4,26,1593,862,731,1949-4-26,131
1949,4,27,1572,814,758,1949-4-27,56
1949,4,28,1240,405,835,1949-4-28,-430
1949,4,29,1591,604,987,1949-4-29,-383
1949,4,30,1185,430,755,1949-4-30,-325
1949,5,1,1279,533,746,1949-5-1,-213
1949,5,2,877,422,455,1949-5-2,-33
1949,5,3,1414,992,422,1949-5-3,570
1949,5,4,1475,1331,144,1949-5-4,1187
1949,5,5,2126,1417,709,1949-5-5,708
1949,5,6,1979,1404,575,1949-5-6,829
1949,5,7,1704,1163,541,1949-5-7,622
1949,5,8,1513,898,615,1949-5-8,283
1949,5,9,1487,717,770,1949-5-9,-53
1949,5,10,1295,498,797,1949-5-10,-299
1949,5,11,1420,719,701,1949-5-11,18
1949,5,12,820,53,767,1949-5-12,-714
1949,5,13,714,161,553,1949-5-13,-392
1949,5,14,722,236,486,1949-5-14,-250
1949,5,15,538,107,431,1949-5-15,-324
1949,5,16,877,130,747,1949-5-16,-617
1949,5,17,1017,198,819,1949-5-17,-621
1949,5,18,1197,448,749,1949-5-18,-301
1949,5,19,1139,443,696,1949-5-19,-253
1949,5,20,1134,502,632,1949-5-20,-130
1949,5,21,883,357,526,1949-5-21,-169
1949,5,22,927,476,451,1949-5-22,25
1949,5,23,1000,604,396,1949-5-23,208
1949,5,24,920,501,419,1949-5-24,82
1949,5,25,901,389,512,1949-5-25,-123
1949,5,26,1344,883,461,1949-5-26,422
1949,5,27,1065,847,218,1949-5-27,629
1949,5,28,1006,861,145,1949-5-28,716
1949,5,29,1564,1414,150,1949-5-29,1264
1949,5,30,1627,1476,151,1949-5-30,1325
1949,5,31,1765,1522,243,1949-5-31,1279
1949,6,1,1416,1149,267,1949-6-1,882
1949,6,2,1402,1192,210,1949-6-2,982
1949,6,3,1118,936,182,1949-6-3,754
1949,6,4,1250,1073,177,1949-6-4,896
1949,6,5,1327,1186,141,1949-6-5,1045
1949,6,6,1430,1316,114,1949-6-6,1202
1949,6,7,824,665,159,1949-6-7,506
1949,6,8,1089,887,202,1949-6-8,685
1949,6,9,1276,1183,93,1949-6-9,1090
1949,6,10,1645,674,971,1949-6-10,-297
1949,6,11,1824,622,1202,1949-6-11,-580
1949,6,12,1172,15,1157,1949-6-12,-1142
1949,6,13,1210,252,958,1949-6-13,-706
1949,6,14,1174,301,873,1949-6-14,-572
1949,6,15,744,31,713,1949-6-15,-682
1949,6,16,1152,312,840,1949-6-16,-528
1949,6,17,815,185,630,1949-6-17,-445
1949,6,18,941,159,782,1949-6-18,-623
1949,6,19,1014,216,798,1949-6-19,-582
1949,6,20,1158,511,647,1949-6-20,-136
1949,6,21,1418,782,636,1949-6-21,146
1949,6,22,2095,1036,1059,1949-6-22,-23
1949,6,23,2175,1324,851,1949-6-23,473
1949,6,24,2425,1331,1094,1949-6-24,237
1949,6,25,2169,1218,951,1949-6-25,267
1949,6,26,2331,1446,885,1949-6-26,561
1949,6,27,2374,1491,883,1949-6-27,608
1949,6,28,3260,2230,1030,1949-6-28,1200
1949,6,29,3040,2180,860,1949-6-29,1320
1949,6,30,2923,1871,1052,1949-6-30,819
1949,7,1,2138,1103,1035,1949-7-1,68
1949,7,2,1971,882,1089,1949-7-2,-207
1949,7,3,1821,772,1049,1949-7-3,-277
1949,7,4,1055,427,628,1949-7-4,-201
1949,7,5,345,166,179,1949-7-5,-13
1949,7,6,522,88,434,1949-7-6,-346
1949,7,7,881,83,798,1949-7-7,-715
1949,7,8,734,6,728,1949-7-8,-722
1949,7,9,573,0,573,1949-7-9,-573
1949,7,10,571,58,513,1949-7-10,-455
1949,7,11,536,342,194,1949-7-11,148
1949,7,12,610,425,185,1949-7-12,240
1949,7,13,963,654,309,1949-7-13,345
1949,7,14,1589,1096,493,1949-7-14,603
1949,7,15,1636,1272,364,1949-7-15,908
1949,7,16,1553,1105,448,1949-7-16,657
1949,7,17,1143,763,380,1949-7-17,383
1949,7,18,1268,914,354,1949-7-18,560
1949,7,19,1415,780,635,1949-7-19,145
1949,7,20,1745,1335,410,1949-7-20,925
1949,7,21,1519,1159,360,1949-7-21,799
1949,7,22,1607,1203,404,1949-7-22,799
1949,7,23,1724,1355,369,1949-7-23,986
1949,7,24,2066,1673,393,1949-7-24,1280
1949,7,25,2216,1584,632,1949-7-25,952
1949,7,26,3339,1504,1835,1949-7-26,-331
1949,7,27,4082,1325,2757,1949-7-27,-1432
1949,7,28,4042,1028,3014,1949-7-28,-1986
1949,7,29,3394,164,3230,1949-7-29,-3066
1949,7,30,3676,148,3528,1949-7-30,-3380
1949,7,31,3577,75,3502,1949-7-31,-3427
1949,8,1,2895,31,2864,1949-8-1,-2833
1949,8,2,2649,128,2521,1949-8-2,-2393
1949,8,3,2336,90,2246,1949-8-3,-2156
1949,8,4,2222,85,2137,1949-8-4,-2052
1949,8,5,2503,448,2055,1949-8-5,-1607
1949,8,6,1808,436,1372,1949-8-6,-936
1949,8,7,1024,393,631,1949-8-7,-238
1949,8,8,351,344,7,1949-8-8,337
1949,8,9,410,410,0,1949-8-9,410
1949,8,10,308,308,0,1949-8-10,308
1949,8,11,208,195,13,1949-8-11,182
1949,8,12,561,492,69,1949-8-12,423
1949,8,13,1260,1135,125,1949-8-13,1010
1949,8,14,1978,1675,303,1949-8-14,1372
1949,8,15,2294,2060,234,1949-8-15,1826
1949,8,16,2103,2038,65,1949-8-16,1973
1949,8,17,2638,2563,75,1949-8-17,2488
1949,8,18,2698,2482,216,1949-8-18,2266
1949,8,19,2398,2152,246,1949-8-19,1906
1949,8,20,3022,2583,439,1949-8-20,2144
1949,8,21,3175,2536,639,1949-8-21,1897
1949,8,22,3267,2594,673,1949-8-22,1921
1949,8,23,2688,2022,666,1949-8-23,1356
1949,8,24,2875,2091,784,1949-8-24,1307
1949,8,25,3744,2910,834,1949-8-25,2076
1949,8,26,3737,2971,766,1949-8-26,2205
1949,8,27,3284,2635,649,1949-8-27,1986
1949,8,28,2942,2148,794,1949-8-28,1354
1949,8,29,3029,2122,907,1949-8-29,1215
1949,8,30,2955,1945,1010,1949-8-30,935
1949,8,31,2855,1424,1431,1949-8-31,-7
1949,9,1,2909,1277,1632,1949-9-1,-355
1949,9,2,2707,1265,1442,1949-9-2,-177
1949,9,3,2280,1187,1093,1949-9-3,94
1949,9,4,2152,896,1256,1949-9-4,-360
1949,9,5,2113,774,1339,1949-9-5,-565
1949,9,6,1839,670,1169,1949-9-6,-499
1949,9,7,2175,709,1466,1949-9-7,-757
1949,9,8,2327,690,1637,1949-9-8,-947
1949,9,9,2273,703,1570,1949-9-9,-867
1949,9,10,2439,714,1725,1949-9-10,-1011
1949,9,11,3254,1075,2179,1949-9-11,-1104
1949,9,12,3132,842,2290,1949-9-12,-1448
1949,9,13,3544,916,2628,1949-9-13,-1712
1949,9,14,3016,680,2336,1949-9-14,-1656
1949,9,15,3165,685,2480,1949-9-15,-1795
1949,9,16,2804,682,2122,1949-9-16,-1440
1949,9,17,2914,575,2339,1949-9-17,-1764
1949,9,18,2769,575,2194,1949-9-18,-1619
1949,9,19,2479,517,1962,1949-9-19,-1445
1949,9,20,2686,491,2195,1949-9-20,-1704
1949,9,21,2232,391,1841,1949-9-21,-1450
1949,9,22,1986,303,1683,1949-9-22,-1380
1949,9,23,1866,181,1685,1949-9-23,-1504
1949,9,24,1403,124,1279,1949-9-24,-1155
1949,9,25,1441,172,1269,1949-9-25,-1097
1949,9,26,1322,252,1070,1949-9-26,-818
1949,9,27,861,242,619,1949-9-27,-377
1949,9,28,592,15,577,1949-9-28,-562
1949,9,29,309,0,309,1949-9-29,-309
1949,9,30,575,0,575,1949-9-30,-575
1949,10,1,1609,915,694,1949-10-1,221
1949,10,2,2056,1271,785,1949-10-2,486
1949,10,3,2842,2002,840,1949-10-3,1162
1949,10,4,2844,1852,992,1949-10-4,860
1949,10,5,3325,2246,1079,1949-10-5,1167
1949,10,6,3185,2241,944,1949-10-6,1297
1949,10,7,3484,2509,975,1949-10-7,1534
1949,10,8,3701,2805,896,1949-10-8,1909
1949,10,9,3460,2546,914,1949-10-9,1632
1949,10,10,3080,2237,843,1949-10-10,1394
1949,10,11,2889,1895,994,1949-10-11,901
1949,10,12,2879,2026,853,1949-10-12,1173
1949,10,13,2380,1993,387,1949-10-13,1606
1949,10,14,1407,1065,342,1949-10-14,723
1949,10,15,1332,1048,284,1949-10-15,764
1949,10,16,1294,926,368,1949-10-16,558
1949,10,17,958,737,221,1949-10-17,516
1949,10,18,785,623,162,1949-10-18,461
1949,10,19,595,441,154,1949-10-19,287
1949,10,20,493,457,36,1949-10-20,421
1949,10,21,793,626,167,1949-10-21,459
1949,10,22,1536,1120,416,1949-10-22,704
1949,10,23,1789,1324,465,1949-10-23,859
1949,10,24,1327,983,344,1949-10-24,639
1949,10,25,1166,1098,68,1949-10-25,1030
1949,10,26,756,654,102,1949-10-26,552
1949,10,27,839,713,126,1949-10-27,587
1949,10,28,777,633,144,1949-10-28,489
1949,10,29,726,632,94,1949-10-29,538
1949,10,30,990,836,154,1949-10-30,682
1949,10,31,969,869,100,1949-10-31,769
1949,11,1,912,808,104,1949-11-1,704
1949,11,2,2135,820,1315,1949-11-2,-495
1949,11,3,1945,837,1108,1949-11-3,-271
1949,11,4,1914,692,1222,1949-11-4,-530
1949,11,5,2099,1031,1068,1949-11-5,-37
1949,11,6,2776,1769,1007,1949-11-6,762
1949,11,7,2402,1479,923,1949-11-7,556
1949,11,8,2491,1579,912,1949-11-8,667
1949,11,9,2576,1801,775,1949-11-9,1026
1949,11,10,2619,2046,573,1949-11-10,1473
1949,11,11,2563,2080,483,1949-11-11,1597
1949,11,12,2207,1678,529,1949-11-12,1149
1949,11,13,2022,1627,395,1949-11-13,1232
1949,11,14,1720,1304,416,1949-11-14,888
1949,11,15,1805,1356,449,1949-11-15,907
1949,11,16,2339,1376,963,1949-11-16,413
1949,11,17,2611,1233,1378,1949-11-17,-145
1949,11,18,3120,1579,1541,1949-11-18,38
1949,11,19,2877,1556,1321,1949-11-19,235
1949,11,20,2430,1488,942,1949-11-20,546
1949,11,21,2436,2173,263,1949-11-21,1910
1949,11,22,1733,1475,258,1949-11-22,1217
1949,11,23,2556,1907,649,1949-11-23,1258
1949,11,24,2414,1644,770,1949-11-24,874
1949,11,25,2623,1532,1091,1949-11-25,441
1949,11,26,2268,1300,968,1949-11-26,332
1949,11,27,1957,1438,519,1949-11-27,919
1949,11,28,2461,1787,674,1949-11-28,1113
1949,11,29,2657,1783,874,1949-11-29,909
1949,11,30,2721,1793,928,1949-11-30,865
1949,12,1,1979,1446,533,1949-12-1,913
1949,12,2,1527,1146,381,1949-12-2,765
1949,12,3,1273,748,525,1949-12-3,223
1949,12,4,1195,546,649,1949-12-4,-103
1949,12,5,1172,516,656,1949-12-5,-140
1949,12,6,1122,518,604,1949-12-6,-86
1949,12,7,1526,867,659,1949-12-7,208
1949,12,8,1640,846,794,1949-12-8,52
1949,12,9,2837,1910,927,1949-12-9,983
1949,12,10,1919,988,931,1949-12-10,57
1949,12,11,1375,428,947,1949-12-11,-519
1949,12,12,1200,553,647,1949-12-12,-94
1949,12,13,1557,1030,527,1949-12-13,503
1949,12,14,1696,1279,417,1949-12-14,862
1949,12,15,1453,1051,402,1949-12-15,649
1949,12,16,1075,898,177,1949-12-16,721
1949,12,17,1004,922,82,1949-12-17,840
1949,12,18,795,706,89,1949-12-18,617
1949,12,19,961,886,75,1949-12-19,811
1949,12,20,1019,940,79,1949-12-20,861
1949,12,21,979,921,58,1949-12-21,863
1949,12,22,888,798,90,1949-12-22,708
1949,12,23,1177,1047,130,1949-12-23,917
1949,12,24,1738,1435,303,1949-12-24,1132
1949,12,25,2401,1772,629,1949-12-25,1143
1949,12,26,1997,1403,594,1949-12-26,809
1949,12,27,1973,1296,677,1949-12-27,619
1949,12,28,1708,1133,575,1949-12-28,558
1949,12,29,2273,1261,1012,1949-12-29,249
1949,12,30,1435,1189,246,1949-12-30,943
1949,12,31,1186,1034,152,1949-12-31,882
1950,1,1,1740,1740,0,1950-1-1,1740
1950,1,2,1821,1821,0,1950-1-2,1821
1950,1,3,1651,1526,125,1950-1-3,1401
1950,1,4,1263,1167,96,1950-1-4,1071
1950,1,5,1389,1329,60,1950-1-5,1269
1950,1,6,934,905,29,1950-1-6,876
1950,1,7,614,562,52,1950-1-7,510
1950,1,8,465,424,41,1950-1-8,383
1950,1,9,433,391,42,1950-1-9,349
1950,1,10,498,485,13,1950-1-10,472
1950,1,11,440,440,0,1950-1-11,440
1950,1,12,814,805,9,1950-1-12,796
1950,1,13,888,863,25,1950-1-13,838
1950,1,14,1356,1067,289,1950-1-14,778
1950,1,15,864,542,322,1950-1-15,220
1950,1,16,627,317,310,1950-1-16,7
1950,1,17,897,613,284,1950-1-17,329
1950,1,18,1012,743,269,1950-1-18,474
1950,1,19,1722,1424,298,1950-1-19,1126
1950,1,20,1859,1590,269,1950-1-20,1321
1950,1,21,3184,2740,444,1950-1-21,2296
1950,1,22,3395,2870,525,1950-1-22,2345
1950,1,23,3321,2675,646,1950-1-23,2029
1950,1,24,3035,2383,652,1950-1-24,1731
1950,1,25,2524,2063,461,1950-1-25,1602
1950,1,26,2318,1841,477,1950-1-26,1364
1950,1,27,1225,1084,141,1950-1-27,943
1950,1,28,1225,1153,72,1950-1-28,1081
1950,1,29,1197,1143,54,1950-1-29,1089
1950,1,30,693,666,27,1950-1-30,639
1950,1,31,499,476,23,1950-1-31,453
1950,2,1,385,356,29,1950-2-1,327
1950,2,2,126,110,16,1950-2-2,94
1950,2,3,51,51,0,1950-2-3,51
1950,2,4,142,116,26,1950-2-4,90
1950,2,5,70,57,13,1950-2-5,44
1950,2,6,16,16,0,1950-2-6,16
1950,2,7,34,34,0,1950-2-7,34
1950,2,8,249,249,0,1950-2-8,249
1950,2,9,210,210,0,1950-2-9,210
1950,2,10,449,240,209,1950-2-10,31
1950,2,11,989,569,420,1950-2-11,149
1950,2,12,1200,460,740,1950-2-12,-280
1950,2,13,2342,1279,1063,1950-2-13,216
1950,2,14,3717,2716,1001,1950-2-14,1715
1950,2,15,4429,3079,1350,1950-2-15,1729
1950,2,16,5919,4099,1820,1950-2-16,2279
1950,2,17,5351,3933,1418,1950-2-17,2515
1950,2,18,4452,3559,893,1950-2-18,2666
1950,2,19,4404,3629,775,1950-2-19,2854
1950,2,20,4251,3524,727,1950-2-20,2797
1950,2,21,3680,3537,143,1950-2-21,3394
1950,2,22,3137,3033,104,1950-2-22,2929
1950,2,23,3052,3052,0,1950-2-23,3052
1950,2,24,2107,2107,0,1950-2-24,2107
1950,2,25,1694,1689,5,1950-2-25,1684
1950,2,26,524,524,0,1950-2-26,524
1950,2,27,428,392,36,1950-2-27,356
1950,2,28,557,340,217,1950-2-28,123
1950,3,1,831,565,266,1950-3-1,299
1950,3,2,759,459,300,1950-3-2,159
1950,3,3,692,441,251,1950-3-3,190
1950,3,4,941,384,557,1950-3-4,-173
1950,3,5,1122,441,681,1950-3-5,-240
1950,3,6,1778,509,1269,1950-3-6,-760
1950,3,7,2651,856,1795,1950-3-7,-939
1950,3,8,3084,1180,1904,1950-3-8,-724
1950,3,9,2857,1163,1694,1950-3-9,-531
1950,3,10,2844,1203,1641,1950-3-10,-438
1950,3,11,2777,1443,1334,1950-3-11,109
1950,3,12,3415,2128,1287,1950-3-12,841
1950,3,13,3118,2175,943,1950-3-13,1232
1950,3,14,2755,1877,878,1950-3-14,999
1950,3,15,2439,1562,877,1950-3-15,685
1950,3,16,2546,1658,888,1950-3-16,770
1950,3,17,2160,1310,850,1950-3-17,460
1950,3,18,2154,1282,872,1950-3-18,410
1950,3,19,1619,805,814,1950-3-19,-9
1950,3,20,782,695,87,1950-3-20,608
1950,3,21,760,606,154,1950-3-21,452
1950,3,22,675,573,102,1950-3-22,471
1950,3,23,448,388,60,1950-3-23,328
1950,3,24,373,263,110,1950-3-24,153
1950,3,25,818,551,267,1950-3-25,284
1950,3,26,773,454,319,1950-3-26,135
1950,3,27,1118,367,751,1950-3-27,-384
1950,3,28,981,340,641,1950-3-28,-301
1950,3,29,1593,927,666,1950-3-29,261
1950,3,30,1340,930,410,1950-3-30,520
1950,3,31,1266,861,405,1950-3-31,456
1950,4,1,1101,810,291,1950-4-1,519
1950,4,2,1315,939,376,1950-4-2,563
1950,4,3,1887,1187,700,1950-4-3,487
1950,4,4,2075,1165,910,1950-4-4,255
1950,4,5,2369,1248,1121,1950-4-5,127
1950,4,6,2351,1211,1140,1950-4-6,71
1950,4,7,2873,1665,1208,1950-4-7,457
1950,4,8,3291,2337,954,1950-4-8,1383
1950,4,9,3072,2302,770,1950-4-9,1532
1950,4,10,2678,2412,266,1950-4-10,2146
1950,4,11,2296,2047,249,1950-4-11,1798
1950,4,12,2157,1949,208,1950-4-12,1741
1950,4,13,2387,2231,156,1950-4-13,2075
1950,4,14,2269,2130,139,1950-4-14,1991
1950,4,15,2535,2439,96,1950-4-15,2343
1950,4,16,2360,2333,27,1950-4-16,2306
1950,4,17,2580,2570,10,1950-4-17,2560
1950,4,18,2505,2505,0,1950-4-18,2505
1950,4,19,2657,2572,85,1950-4-19,2487
1950,4,20,1726,1584,142,1950-4-20,1442
1950,4,21,1550,1197,353,1950-4-21,844
1950,4,22,1159,366,793,1950-4-22,-427
1950,4,23,1924,273,1651,1950-4-23,-1378
1950,4,24,2112,230,1882,1950-4-24,-1652
1950,4,25,2537,203,2334,1950-4-25,-2131
1950,4,26,2592,327,2265,1950-4-26,-1938
1950,4,27,2992,246,2746,1950-4-27,-2500
1950,4,28,3316,728,2588,1950-4-28,-1860
1950,4,29,3148,678,2470,1950-4-29,-1792
1950,4,30,2958,659,2299,1950-4-30,-1640
1950,5,1,2757,770,1987,1950-5-1,-1217
1950,5,2,2188,970,1218,1950-5-2,-248
1950,5,3,1894,886,1008,1950-5-3,-122
1950,5,4,1254,925,329,1950-5-4,596
1950,5,5,1413,1248,165,1950-5-5,1083
1950,5,6,1788,1698,90,1950-5-6,1608
1950,5,7,2212,2151,61,1950-5-7,2090
1950,5,8,2431,2071,360,1950-5-8,1711
1950,5,9,1424,1012,412,1950-5-9,600
1950,5,10,883,790,93,1950-5-10,697
1950,5,11,1096,1005,91,1950-5-11,914
1950,5,12,850,814,36,1950-5-12,778
1950,5,13,788,788,0,1950-5-13,788
1950,5,14,578,578,0,1950-5-14,578
1950,5,15,529,529,0,1950-5-15,529
1950,5,16,613,497,116,1950-5-16,381
1950,5,17,1006,516,490,1950-5-17,26
1950,5,18,1479,457,1022,1950-5-18,-565
1950,5,19,1387,209,1178,1950-5-19,-969
1950,5,20,1478,603,875,1950-5-20,-272
1950,5,21,2044,1281,763,1950-5-21,518
1950,5,22,1880,1254,626,1950-5-22,628
1950,5,23,1879,1390,489,1950-5-23,901
1950,5,24,2428,1950,478,1950-5-24,1472
1950,5,25,2407,2072,335,1950-5-25,1737
1950,5,26,2327,2091,236,1950-5-26,1855
1950,5,27,2249,2026,223,1950-5-27,1803
1950,5,28,2122,1958,164,1950-5-28,1794
1950,5,29,1317,1133,184,1950-5-29,949
1950,5,30,1179,994,185,1950-5-30,809
1950,5,31,1040,1031,9,1950-5-31,1022
1950,6,1,537,537,0,1950-6-1,537
1950,6,2,773,773,0,1950-6-2,773
1950,6,3,756,756,0,1950-6-3,756
1950,6,4,616,616,0,1950-6-4,616
1950,6,5,631,631,0,1950-6-5,631
1950,6,6,511,511,0,1950-6-6,511
1950,6,7,291,291,0,1950-6-7,291
1950,6,8,963,171,792,1950-6-8,-621
1950,6,9,1302,105,1197,1950-6-9,-1092
1950,6,10,1723,233,1490,1950-6-10,-1257
1950,6,11,1568,193,1375,1950-6-11,-1182
1950,6,12,1275,65,1210,1950-6-12,-1145
1950,6,13,1480,136,1344,1950-6-13,-1208
1950,6,14,1787,450,1337,1950-6-14,-887
1950,6,15,1382,165,1217,1950-6-15,-1052
1950,6,16,1635,489,1146,1950-6-16,-657
1950,6,17,1705,525,1180,1950-6-17,-655
1950,6,18,1454,491,963,1950-6-18,-472
1950,6,19,1252,381,871,1950-6-19,-490
1950,6,20,1217,399,818,1950-6-20,-419
1950,6,21,662,636,26,1950-6-21,610
1950,6,22,714,692,22,1950-6-22,670
1950,6,23,838,790,48,1950-6-23,742
1950,6,24,934,894,40,1950-6-24,854
1950,6,25,1138,1106,32,1950-6-25,1074
1950,6,26,1077,951,126,1950-6-26,825
1950,6,27,932,853,79,1950-6-27,774
1950,6,28,834,760,74,1950-6-28,686
1950,6,29,757,654,103,1950-6-29,551
1950,6,30,706,483,223,1950-6-30,260
1950,7,1,803,476,327,1950-7-1,149
1950,7,2,584,158,426,1950-7-2,-268
1950,7,3,520,153,367,1950-7-3,-214
1950,7,4,438,252,186,1950-7-4,66
1950,7,5,561,406,155,1950-7-5,251
1950,7,6,810,551,259,1950-7-6,292
1950,7,7,1539,1335,204,1950-7-7,1131
1950,7,8,1405,1190,215,1950-7-8,975
1950,7,9,962,780,182,1950-7-9,598
1950,7,10,1812,1608,204,1950-7-10,1404
1950,7,11,1364,1165,199,1950-7-11,966
1950,7,12,991,826,165,1950-7-12,661
1950,7,13,766,561,205,1950-7-13,356
1950,7,14,610,402,208,1950-7-14,194
1950,7,15,608,328,280,1950-7-15,48
1950,7,16,704,483,221,1950-7-16,262
1950,7,17,1021,781,240,1950-7-17,541
1950,7,18,1031,961,70,1950-7-18,891
1950,7,19,1805,1183,622,1950-7-19,561
1950,7,20,2068,1320,748,1950-7-20,572
1950,7,21,2097,1373,724,1950-7-21,649
1950,7,22,2042,1284,758,1950-7-22,526
1950,7,23,1994,1244,750,1950-7-23,494
1950,7,24,1782,1030,752,1950-7-24,278
1950,7,25,1682,839,843,1950-7-25,-4
1950,7,26,1895,871,1024,1950-7-26,-153
1950,7,27,1478,336,1142,1950-7-27,-806
1950,7,28,1171,301,870,1950-7-28,-569
1950,7,29,1407,368,1039,1950-7-29,-671
1950,7,30,1501,165,1336,1950-7-30,-1171
1950,7,31,1476,179,1297,1950-7-31,-1118
1950,8,1,1170,192,978,1950-8-1,-786
1950,8,2,1263,209,1054,1950-8-2,-845
1950,8,3,1587,187,1400,1950-8-3,-1213
1950,8,4,1572,162,1410,1950-8-4,-1248
1950,8,5,1371,176,1195,1950-8-5,-1019
1950,8,6,1449,170,1279,1950-8-6,-1109
1950,8,7,1269,202,1067,1950-8-7,-865
1950,8,8,1050,214,836,1950-8-8,-622
1950,8,9,993,217,776,1950-8-9,-559
1950,8,10,922,279,643,1950-8-10,-364
1950,8,11,704,404,300,1950-8-11,104
1950,8,12,1011,738,273,1950-8-12,465
1950,8,13,1075,808,267,1950-8-13,541
1950,8,14,881,643,238,1950-8-14,405
1950,8,15,1168,743,425,1950-8-15,318
1950,8,16,1258,749,509,1950-8-16,240
1950,8,17,1321,800,521,1950-8-17,279
1950,8,18,1103,664,439,1950-8-18,225
1950,8,19,1411,738,673,1950-8-19,65
1950,8,20,1314,591,723,1950-8-20,-132
1950,8,21,1243,557,686,1950-8-21,-129
1950,8,22,1206,472,734,1950-8-22,-262
1950,8,23,1089,303,786,1950-8-23,-483
1950,8,24,1148,191,957,1950-8-24,-766
1950,8,25,1287,100,1187,1950-8-25,-1087
1950,8,26,1248,45,1203,1950-8-26,-1158
1950,8,27,434,35,399,1950-8-27,-364
1950,8,28,260,57,203,1950-8-28,-146
1950,8,29,509,296,213,1950-8-29,83
1950,8,30,487,352,135,1950-8-30,217
1950,8,31,322,279,43,1950-8-31,236
1950,9,1,385,356,29,1950-9-1,327
1950,9,2,326,306,20,1950-9-2,286
1950,9,3,373,352,21,1950-9-3,331
1950,9,4,296,260,36,1950-9-4,224
1950,9,5,126,113,13,1950-9-5,100
1950,9,6,195,114,81,1950-9-6,33
1950,9,7,205,106,99,1950-9-7,7
1950,9,8,175,85,90,1950-9-8,-5
1950,9,9,252,151,101,1950-9-9,50
1950,9,10,103,0,103,1950-9-10,-103
1950,9,11,405,17,388,1950-9-11,-371
1950,9,12,379,22,357,1950-9-12,-335
1950,9,13,821,428,393,1950-9-13,35
1950,9,14,1087,673,414,1950-9-14,259
1950,9,15,1050,689,361,1950-9-15,328
1950,9,16,1015,688,327,1950-9-16,361
1950,9,17,878,684,194,1950-9-17,490
1950,9,18,767,640,127,1950-9-18,513
1950,9,19,761,549,212,1950-9-19,337
1950,9,20,847,701,146,1950-9-20,555
1950,9,21,607,487,120,1950-9-21,367
1950,9,22,563,475,88,1950-9-22,387
1950,9,23,468,422,46,1950-9-23,376
1950,9,24,449,449,0,1950-9-24,449
1950,9,25,435,435,0,1950-9-25,435
1950,9,26,495,494,1,1950-9-26,493
1950,9,27,399,383,16,1950-9-27,367
1950,9,28,127,96,31,1950-9-28,65
1950,9,29,328,227,101,1950-9-29,126
1950,9,30,335,224,111,1950-9-30,113
1950,10,1,369,221,148,1950-10-1,73
1950,10,2,416,248,168,1950-10-2,80
1950,10,3,481,253,228,1950-10-3,25
1950,10,4,521,259,262,1950-10-4,-3
1950,10,5,489,282,207,1950-10-5,75
1950,10,6,375,220,155,1950-10-6,65
1950,10,7,338,185,153,1950-10-7,32
1950,10,8,1035,454,581,1950-10-8,-127
1950,10,9,1016,434,582,1950-10-9,-148
1950,10,10,931,436,495,1950-10-10,-59
1950,10,11,760,411,349,1950-10-11,62
1950,10,12,909,541,368,1950-10-12,173
1950,10,13,564,214,350,1950-10-13,-136
1950,10,14,529,185,344,1950-10-14,-159
1950,10,15,755,285,470,1950-10-15,-185
1950,10,16,1012,46,966,1950-10-16,-920
1950,10,17,938,25,913,1950-10-17,-888
1950,10,18,902,15,887,1950-10-18,-872
1950,10,19,644,0,644,1950-10-19,-644
1950,10,20,522,0,522,1950-10-20,-522
1950,10,21,23,0,23,1950-10-21,-23
1950,10,22,44,0,44,1950-10-22,-44
1950,10,23,184,0,184,1950-10-23,-184
1950,10,24,240,5,235,1950-10-24,-230
1950,10,25,392,21,371,1950-10-25,-350
1950,10,26,490,36,454,1950-10-26,-418
1950,10,27,364,41,323,1950-10-27,-282
1950,10,28,376,195,181,1950-10-28,14
1950,10,29,831,550,281,1950-10-29,269
1950,10,30,695,422,273,1950-10-30,149
1950,10,31,558,290,268,1950-10-31,22
1950,11,1,485,233,252,1950-11-1,-19
1950,11,2,549,182,367,1950-11-2,-185
1950,11,3,445,124,321,1950-11-3,-197
1950,11,4,728,167,561,1950-11-4,-394
1950,11,5,859,246,613,1950-11-5,-367
1950,11,6,1044,548,496,1950-11-6,52
1950,11,7,1123,717,406,1950-11-7,311
1950,11,8,1043,742,301,1950-11-8,441
1950,11,9,1170,915,255,1950-11-9,660
1950,11,10,1355,1196,159,1950-11-10,1037
1950,11,11,1477,1252,225,1950-11-11,1027
1950,11,12,969,749,220,1950-11-12,529
1950,11,13,766,556,210,1950-11-13,346
1950,11,14,834,672,162,1950-11-14,510
1950,11,15,946,806,140,1950-11-15,666
1950,11,16,1086,900,186,1950-11-16,714
1950,11,17,934,925,9,1950-11-17,916
1950,11,18,637,637,0,1950-11-18,637
1950,11,19,634,634,0,1950-11-19,634
1950,11,20,461,461,0,1950-11-20,461
1950,11,21,243,243,0,1950-11-21,243
1950,11,22,112,112,0,1950-11-22,112
1950,11,23,138,138,0,1950-11-23,138
1950,11,24,132,132,0,1950-11-24,132
1950,11,25,113,83,30,1950-11-25,53
1950,11,26,161,118,43,1950-11-26,75
1950,11,27,749,523,226,1950-11-27,297
1950,11,28,838,348,490,1950-11-28,-142
1950,11,29,1342,396,946,1950-11-29,-550
1950,11,30,975,347,628,1950-11-30,-281
1950,12,1,912,309,603,1950-12-1,-294
1950,12,2,1206,311,895,1950-12-2,-584
1950,12,3,1328,270,1058,1950-12-3,-788
1950,12,4,1206,199,1007,1950-12-4,-808
1950,12,5,940,216,724,1950-12-5,-508
1950,12,6,674,162,512,1950-12-6,-350
1950,12,7,1494,1009,485,1950-12-7,524
1950,12,8,1312,912,400,1950-12-8,512
1950,12,9,1418,1135,283,1950-12-9,852
1950,12,10,1171,977,194,1950-12-10,783
1950,12,11,1254,1052,202,1950-12-11,850
1950,12,12,1059,839,220,1950-12-12,619
1950,12,13,1250,1045,205,1950-12-13,840
1950,12,14,780,610,170,1950-12-14,440
1950,12,15,456,298,158,1950-12-15,140
1950,12,16,114,104,10,1950-12-16,94
1950,12,17,76,70,6,1950-12-17,64
1950,12,18,21,21,0,1950-12-18,21
1950,12,19,15,15,0,1950-12-19,15
1950,12,20,7,7,0,1950-12-20,7
1950,12,21,0,0,0,1950-12-21,0
1950,12,22,0,0,0,1950-12-22,0
1950,12,23,0,0,0,1950-12-23,0
1950,12,24,91,65,26,1950-12-24,39
1950,12,25,177,139,38,1950-12-25,101
1950,12,26,432,403,29,1950-12-26,374
1950,12,27,512,496,16,1950-12-27,480
1950,12,28,424,424,0,1950-12-28,424
1950,12,29,222,222,0,1950-12-29,222
1950,12,30,217,217,0,1950-12-30,217
1950,12,31,148,148,0,1950-12-31,148
1951,1,1,72,40,32,1951-1-1,8
1951,1,2,50,25,25,1951-1-2,0
1951,1,3,205,0,205,1951-1-3,-205
1951,1,4,209,17,192,1951-1-4,-175
1951,1,5,251,0,251,1951-1-5,-251
1951,1,6,507,0,507,1951-1-6,-507
1951,1,7,722,9,713,1951-1-7,-704
1951,1,8,587,16,571,1951-1-8,-555
1951,1,9,659,15,644,1951-1-9,-629
1951,1,10,521,58,463,1951-1-10,-405
1951,1,11,496,74,422,1951-1-11,-348
1951,1,12,226,96,130,1951-1-12,-34
1951,1,13,81,81,0,1951-1-13,81
1951,1,14,72,72,0,1951-1-14,72
1951,1,15,37,37,0,1951-1-15,37
1951,1,16,116,116,0,1951-1-16,116
1951,1,17,207,207,0,1951-1-17,207
1951,1,18,331,331,0,1951-1-18,331
1951,1,19,256,256,0,1951-1-19,256
1951,1,20,351,343,8,1951-1-20,335
1951,1,21,226,215,11,1951-1-21,204
1951,1,22,217,159,58,1951-1-22,101
1951,1,23,1210,816,394,1951-1-23,422
1951,1,24,1529,1173,356,1951-1-24,817
1951,1,25,1601,1277,324,1951-1-25,953
1951,1,26,1733,1326,407,1951-1-26,919
1951,1,27,2214,1846,368,1951-1-27,1478
1951,1,28,1946,1704,242,1951-1-28,1462
1951,1,29,2415,2204,211,1951-1-29,1993
1951,1,30,2033,1779,254,1951-1-30,1525
1951,1,31,2059,1817,242,1951-1-31,1575
1951,2,1,1591,1394,197,1951-2-1,1197
1951,2,2,1554,1365,189,1951-2-2,1176
1951,2,3,1505,1210,295,1951-2-3,915
1951,2,4,382,220,162,1951-2-4,58
1951,2,5,248,96,152,1951-2-5,-56
1951,2,6,184,73,111,1951-2-6,-38
1951,2,7,248,101,147,1951-2-7,-46
1951,2,8,210,110,100,1951-2-8,10
1951,2,9,294,104,190,1951-2-9,-86
1951,2,10,507,194,313,1951-2-10,-119
1951,2,11,527,413,114,1951-2-11,299
1951,2,12,631,542,89,1951-2-12,453
1951,2,13,423,367,56,1951-2-13,311
1951,2,14,411,354,57,1951-2-14,297
1951,2,15,333,289,44,1951-2-15,245
1951,2,16,233,206,27,1951-2-16,179
1951,2,17,177,166,11,1951-2-17,155
1951,2,18,177,169,8,1951-2-18,161
1951,2,19,868,860,8,1951-2-19,852
1951,2,20,890,890,0,1951-2-20,890
1951,2,21,785,785,0,1951-2-21,785
1951,2,22,711,711,0,1951-2-22,711
1951,2,23,784,784,0,1951-2-23,784
1951,2,24,873,873,0,1951-2-24,873
1951,2,25,914,914,0,1951-2-25,914
1951,2,26,831,814,17,1951-2-26,797
1951,2,27,638,618,20,1951-2-27,598
1951,2,28,619,578,41,1951-2-28,537
1951,3,1,607,576,31,1951-3-1,545
1951,3,2,528,482,46,1951-3-2,436
1951,3,3,192,100,92,1951-3-3,8
1951,3,4,136,41,95,1951-3-4,-54
1951,3,5,195,70,125,1951-3-5,-55
1951,3,6,376,324,52,1951-3-6,272
1951,3,7,293,226,67,1951-3-7,159
1951,3,8,284,233,51,1951-3-8,182
1951,3,9,232,220,12,1951-3-9,208
1951,3,10,200,194,6,1951-3-10,188
1951,3,11,284,158,126,1951-3-11,32
1951,3,12,460,181,279,1951-3-12,-98
1951,3,13,413,160,253,1951-3-13,-93
1951,3,14,373,145,228,1951-3-14,-83
1951,3,15,257,135,122,1951-3-15,13
1951,3,16,271,198,73,1951-3-16,125
1951,3,17,1046,1015,31,1951-3-17,984
1951,3,18,1156,1128,28,1951-3-18,1100
1951,3,19,1032,1022,10,1951-3-19,1012
1951,3,20,1128,1128,0,1951-3-20,1128
1951,3,21,1141,1134,7,1951-3-21,1127
1951,3,22,1808,1798,10,1951-3-22,1788
1951,3,23,1819,1753,66,1951-3-23,1687
1951,3,24,2198,1932,266,1951-3-24,1666
1951,3,25,2265,1846,419,1951-3-25,1427
1951,3,26,2163,1701,462,1951-3-26,1239
1951,3,27,2008,1588,420,1951-3-27,1168
1951,3,28,1708,1430,278,1951-3-28,1152
1951,3,29,1041,992,49,1951-3-29,943
1951,3,30,392,232,160,1951-3-30,72
1951,3,31,196,79,117,1951-3-31,-38
1951,4,1,133,44,89,1951-4-1,-45
1951,4,2,104,55,49,1951-4-2,6
1951,4,3,116,87,29,1951-4-3,58
1951,4,4,116,66,50,1951-4-4,16
1951,4,5,249,179,70,1951-4-5,109
1951,4,6,379,293,86,1951-4-6,207
1951,4,7,608,477,131,1951-4-7,346
1951,4,8,944,735,209,1951-4-8,526
1951,4,9,955,819,136,1951-4-9,683
1951,4,10,846,688,158,1951-4-10,530
1951,4,11,730,484,246,1951-4-11,238
1951,4,12,1272,788,484,1951-4-12,304
1951,4,13,2349,1859,490,1951-4-13,1369
1951,4,14,2409,1911,498,1951-4-14,1413
1951,4,15,2629,2205,424,1951-4-15,1781
1951,4,16,2679,2350,329,1951-4-16,2021
1951,4,17,2560,2303,257,1951-4-17,2046
1951,4,18,2868,2552,316,1951-4-18,2236
1951,4,19,2864,2590,274,1951-4-19,2316
1951,4,20,2687,2383,304,1951-4-20,2079
1951,4,21,2324,1974,350,1951-4-21,1624
1951,4,22,2519,2160,359,1951-4-22,1801
1951,4,23,2579,2134,445,1951-4-23,1689
1951,4,24,2536,1982,554,1951-4-24,1428
1951,4,25,1481,702,779,1951-4-25,-77
1951,4,26,1494,467,1027,1951-4-26,-560
1951,4,27,1789,446,1343,1951-4-27,-897
1951,4,28,2377,423,1954,1951-4-28,-1531
1951,4,29,1703,358,1345,1951-4-29,-987
1951,4,30,1670,380,1290,1951-4-30,-910
1951,5,1,1007,368,639,1951-5-1,-271
1951,5,2,927,502,425,1951-5-2,77
1951,5,3,405,5,400,1951-5-3,-395
1951,5,4,330,13,317,1951-5-4,-304
1951,5,5,439,3,436,1951-5-5,-433
1951,5,6,250,0,250,1951-5-6,-250
1951,5,7,515,264,251,1951-5-7,13
1951,5,8,224,216,8,1951-5-8,208
1951,5,9,619,619,0,1951-5-9,619
1951,5,10,2762,2725,37,1951-5-10,2688
1951,5,11,3660,3574,86,1951-5-11,3488
1951,5,12,3723,3654,69,1951-5-12,3585
1951,5,13,4376,4355,21,1951-5-13,4334
1951,5,14,4435,4435,0,1951-5-14,4435
1951,5,15,4798,4512,286,1951-5-15,4226
1951,5,16,5132,4761,371,1951-5-16,4390
1951,5,17,5352,4963,389,1951-5-17,4574
1951,5,18,6066,5717,349,1951-5-18,5368
1951,5,19,6702,6300,402,1951-5-19,5898
1951,5,20,5916,5340,576,1951-5-20,4764
1951,5,21,6294,5246,1048,1951-5-21,4198
1951,5,22,4930,3790,1140,1951-5-22,2650
1951,5,23,2956,1835,1121,1951-5-23,714
1951,5,24,2998,2008,990,1951-5-24,1018
1951,5,25,3151,2213,938,1951-5-25,1275
1951,5,26,3102,2262,840,1951-5-26,1422
1951,5,27,2927,2120,807,1951-5-27,1313
1951,5,28,2987,2386,601,1951-5-28,1785
1951,5,29,1015,457,558,1951-5-29,-101
1951,5,30,922,398,524,1951-5-30,-126
1951,5,31,950,374,576,1951-5-31,-202
1951,6,1,892,368,524,1951-6-1,-156
1951,6,2,856,344,512,1951-6-2,-168
1951,6,3,692,383,309,1951-6-3,74
1951,6,4,364,334,30,1951-6-4,304
1951,6,5,1828,1729,99,1951-6-5,1630
1951,6,6,3037,2639,398,1951-6-6,2241
1951,6,7,3017,2158,859,1951-6-7,1299
1951,6,8,3561,2780,781,1951-6-8,1999
1951,6,9,3762,3060,702,1951-6-9,2358
1951,6,10,3225,2701,524,1951-6-10,2177
1951,6,11,3008,2579,429,1951-6-11,2150
1951,6,12,4359,2105,2254,1951-6-12,-149
1951,6,13,4234,2098,2136,1951-6-13,-38
1951,6,14,4125,1978,2147,1951-6-14,-169
1951,6,15,3864,1608,2256,1951-6-15,-648
1951,6,16,3762,1388,2374,1951-6-16,-986
1951,6,17,4047,1431,2616,1951-6-17,-1185
1951,6,18,3900,1082,2818,1951-6-18,-1736
1951,6,19,3415,653,2762,1951-6-19,-2109
1951,6,20,3193,385,2808,1951-6-20,-2423
1951,6,21,3482,439,3043,1951-6-21,-2604
1951,6,22,3701,379,3322,1951-6-22,-2943
1951,6,23,3567,349,3218,1951-6-23,-2869
1951,6,24,2279,331,1948,1951-6-24,-1617
1951,6,25,686,368,318,1951-6-25,50
1951,6,26,604,440,164,1951-6-26,276
1951,6,27,309,233,76,1951-6-27,157
1951,6,28,223,173,50,1951-6-28,123
1951,6,29,180,150,30,1951-6-29,120
1951,6,30,140,130,10,1951-6-30,120
1951,7,1,130,130,0,1951-7-1,130
1951,7,2,122,107,15,1951-7-2,92
1951,7,3,263,244,19,1951-7-3,225
1951,7,4,432,414,18,1951-7-4,396
1951,7,5,383,383,0,1951-7-5,383
1951,7,6,499,338,161,1951-7-6,177
1951,7,7,704,620,84,1951-7-7,536
1951,7,8,1539,616,923,1951-7-8,-307
1951,7,9,2130,475,1655,1951-7-9,-1180
1951,7,10,1902,307,1595,1951-7-10,-1288
1951,7,11,1663,184,1479,1951-7-11,-1295
1951,7,12,1732,125,1607,1951-7-12,-1482
1951,7,13,1452,86,1366,1951-7-13,-1280
1951,7,14,1379,69,1310,1951-7-14,-1241
1951,7,15,1296,22,1274,1951-7-15,-1252
1951,7,16,1143,29,1114,1951-7-16,-1085
1951,7,17,984,0,984,1951-7-17,-984
1951,7,18,993,0,993,1951-7-18,-993
1951,7,19,853,11,842,1951-7-19,-831
1951,7,20,737,8,729,1951-7-20,-721
1951,7,21,169,3,166,1951-7-21,-163
1951,7,22,402,0,402,1951-7-22,-402
1951,7,23,439,71,368,1951-7-23,-297
1951,7,24,422,164,258,1951-7-24,-94
1951,7,25,328,99,229,1951-7-25,-130
1951,7,26,292,75,217,1951-7-26,-142
1951,7,27,220,33,187,1951-7-27,-154
1951,7,28,315,20,295,1951-7-28,-275
1951,7,29,403,9,394,1951-7-29,-385
1951,7,30,485,12,473,1951-7-30,-461
1951,7,31,367,12,355,1951-7-31,-343
1951,8,1,382,10,372,1951-8-1,-362
1951,8,2,400,30,370,1951-8-2,-340
1951,8,3,295,81,214,1951-8-3,-133
1951,8,4,639,257,382,1951-8-4,-125
1951,8,5,890,582,308,1951-8-5,274
1951,8,6,1059,705,354,1951-8-6,351
1951,8,7,978,546,432,1951-8-7,114
1951,8,8,1578,745,833,1951-8-8,-88
1951,8,9,1967,1089,878,1951-8-9,211
1951,8,10,1694,904,790,1951-8-10,114
1951,8,11,1610,963,647,1951-8-11,316
1951,8,12,1350,807,543,1951-8-12,264
1951,8,13,1159,703,456,1951-8-13,247
1951,8,14,984,599,385,1951-8-14,214
1951,8,15,1011,561,450,1951-8-15,111
1951,8,16,698,381,317,1951-8-16,64
1951,8,17,290,0,290,1951-8-17,-290
1951,8,18,327,0,327,1951-8-18,-327
1951,8,19,382,0,382,1951-8-19,-382
1951,8,20,439,17,422,1951-8-20,-405
1951,8,21,411,20,391,1951-8-21,-371
1951,8,22,398,12,386,1951-8-22,-374
1951,8,23,412,12,400,1951-8-23,-388
1951,8,24,276,9,267,1951-8-24,-258
1951,8,25,101,0,101,1951-8-25,-101
1951,8,26,19,11,8,1951-8-26,3
1951,8,27,0,0,0,1951-8-27,0
1951,8,28,0,0,0,1951-8-28,0
1951,8,29,101,18,83,1951-8-29,-65
1951,8,30,252,178,74,1951-8-30,104
1951,8,31,481,382,99,1951-8-31,283
1951,9,1,481,391,90,1951-9-1,301
1951,9,2,520,440,80,1951-9-2,360
1951,9,3,495,412,83,1951-9-3,329
1951,9,4,678,363,315,1951-9-4,48
1951,9,5,833,318,515,1951-9-5,-197
1951,9,6,860,299,561,1951-9-6,-262
1951,9,7,751,280,471,1951-9-7,-191
1951,9,8,859,409,450,1951-9-8,-41
1951,9,9,1577,1026,551,1951-9-9,475
1951,9,10,1631,1003,628,1951-9-10,375
1951,9,11,1738,1050,688,1951-9-11,362
1951,9,12,1506,836,670,1951-9-12,166
1951,9,13,1344,726,618,1951-9-13,108
1951,9,14,1196,673,523,1951-9-14,150
1951,9,15,1026,529,497,1951-9-15,32
1951,9,16,889,811,78,1951-9-16,733
1951,9,17,785,738,47,1951-9-17,691
1951,9,18,890,860,30,1951-9-18,830
1951,9,19,1437,1418,19,1951-9-19,1399
1951,9,20,1487,1485,2,1951-9-20,1483
1951,9,21,1432,1368,64,1951-9-21,1304
1951,9,22,1333,1264,69,1951-9-22,1195
1951,9,23,1000,938,62,1951-9-23,876
1951,9,24,917,895,22,1951-9-24,873
1951,9,25,840,840,0,1951-9-25,840
1951,9,26,900,878,22,1951-9-26,856
1951,9,27,512,502,10,1951-9-27,492
1951,9,28,464,464,0,1951-9-28,464
1951,9,29,113,113,0,1951-9-29,113
1951,9,30,304,41,263,1951-9-30,-222
1951,10,1,403,154,249,1951-10-1,-95
1951,10,2,590,340,250,1951-10-2,90
1951,10,3,554,308,246,1951-10-3,62
1951,10,4,509,280,229,1951-10-4,51
1951,10,5,344,152,192,1951-10-5,-40
1951,10,6,268,69,199,1951-10-6,-130
1951,10,7,213,9,204,1951-10-7,-195
1951,10,8,606,18,588,1951-10-8,-570
1951,10,9,992,228,764,1951-10-9,-536
1951,10,10,1246,493,753,1951-10-10,-260
1951,10,11,1223,418,805,1951-10-11,-387
1951,10,12,1360,326,1034,1951-10-12,-708
1951,10,13,1087,323,764,1951-10-13,-441
1951,10,14,891,246,645,1951-10-14,-399
1951,10,15,1027,246,781,1951-10-15,-535
1951,10,16,1086,228,858,1951-10-16,-630
1951,10,17,1194,208,986,1951-10-17,-778
1951,10,18,1161,238,923,1951-10-18,-685
1951,10,19,1473,394,1079,1951-10-19,-685
1951,10,20,1314,549,765,1951-10-20,-216
1951,10,21,406,406,0,1951-10-21,406
1951,10,22,337,337,0,1951-10-22,337
1951,10,23,93,93,0,1951-10-23,93
1951,10,24,19,19,0,1951-10-24,19
1951,10,25,42,27,15,1951-10-25,12
1951,10,26,501,179,322,1951-10-26,-143
1951,10,27,917,165,752,1951-10-27,-587
1951,10,28,949,192,757,1951-10-28,-565
1951,10,29,952,240,712,1951-10-29,-472
1951,10,30,926,276,650,1951-10-30,-374
1951,10,31,795,246,549,1951-10-31,-303
1951,11,1,716,136,580,1951-11-1,-444
1951,11,2,479,112,367,1951-11-2,-255
1951,11,3,457,107,350,1951-11-3,-243
1951,11,4,1139,40,1099,1951-11-4,-1059
1951,11,5,1076,16,1060,1951-11-5,-1044
1951,11,6,1068,20,1048,1951-11-6,-1028
1951,11,7,979,53,926,1951-11-7,-873
1951,11,8,726,4,722,1951-11-8,-718
1951,11,9,866,23,843,1951-11-9,-820
1951,11,10,817,87,730,1951-11-10,-643
1951,11,11,719,79,640,1951-11-11,-561
1951,11,12,652,108,544,1951-11-12,-436
1951,11,13,472,43,429,1951-11-13,-386
1951,11,14,573,21,552,1951-11-14,-531
1951,11,15,511,16,495,1951-11-15,-479
1951,11,16,528,151,377,1951-11-16,-226
1951,11,17,447,407,40,1951-11-17,367
1951,11,18,589,589,0,1951-11-18,589
1951,11,19,446,423,23,1951-11-19,400
1951,11,20,479,464,15,1951-11-20,449
1951,11,21,438,438,0,1951-11-21,438
1951,11,22,457,457,0,1951-11-22,457
1951,11,23,636,636,0,1951-11-23,636
1951,11,24,549,549,0,1951-11-24,549
1951,11,25,669,621,48,1951-11-25,573
1951,11,26,660,644,16,1951-11-26,628
1951,11,27,684,684,0,1951-11-27,684
1951,11,28,820,820,0,1951-11-28,820
1951,11,29,1146,1146,0,1951-11-29,1146
1951,11,30,183,183,0,1951-11-30,183
1951,12,1,110,72,38,1951-12-1,34
1951,12,2,71,41,30,1951-12-2,11
1951,12,3,74,52,22,1951-12-3,30
1951,12,4,247,241,6,1951-12-4,235
1951,12,5,269,235,34,1951-12-5,201
1951,12,6,116,0,116,1951-12-6,-116
1951,12,7,206,0,206,1951-12-7,-206
1951,12,8,285,0,285,1951-12-8,-285
1951,12,9,175,0,175,1951-12-9,-175
1951,12,10,177,74,103,1951-12-10,-29
1951,12,11,126,126,0,1951-12-11,126
1951,12,12,58,35,23,1951-12-12,12
1951,12,13,164,55,109,1951-12-13,-54
1951,12,14,584,456,128,1951-12-14,328
1951,12,15,395,321,74,1951-12-15,247
1951,12,16,702,691,11,1951-12-16,680
1951,12,17,937,882,55,1951-12-17,827
1951,12,18,1063,945,118,1951-12-18,827
1951,12,19,1189,1043,146,1951-12-19,897
1951,12,20,1291,1216,75,1951-12-20,1141
1951,12,21,1405,1371,34,1951-12-21,1337
1951,12,22,1430,1406,24,1951-12-22,1382
1951,12,23,1349,1335,14,1951-12-23,1321
1951,12,24,1344,1344,0,1951-12-24,1344
1951,12,25,1205,1205,0,1951-12-25,1205
1951,12,26,898,898,0,1951-12-26,898
1951,12,27,300,300,0,1951-12-27,300
1951,12,28,746,743,3,1951-12-28,740
1951,12,29,588,588,0,1951-12-29,588
1951,12,30,589,589,0,1951-12-30,589
1951,12,31,584,555,29,1951-12-31,526
1952,1,1,546,450,96,1952-1-1,354
1952,1,2,368,318,50,1952-1-2,268
1952,1,3,348,303,45,1952-1-3,258
1952,1,4,228,194,34,1952-1-4,160
1952,1,5,211,171,40,1952-1-5,131
1952,1,6,16,0,16,1952-1-6,-16
1952,1,7,101,17,84,1952-1-7,-67
1952,1,8,384,314,70,1952-1-8,244
1952,1,9,946,925,21,1952-1-9,904
1952,1,10,952,910,42,1952-1-10,868
1952,1,11,953,893,60,1952-1-11,833
1952,1,12,946,946,0,1952-1-12,946
1952,1,13,988,988,0,1952-1-13,988
1952,1,14,879,879,0,1952-1-14,879
1952,1,15,1101,1101,0,1952-1-15,1101
1952,1,16,957,957,0,1952-1-16,957
1952,1,17,606,606,0,1952-1-17,606
1952,1,18,698,698,0,1952-1-18,698
1952,1,19,476,476,0,1952-1-19,476
1952,1,20,493,449,44,1952-1-20,405
1952,1,21,188,188,0,1952-1-21,188
1952,1,22,103,103,0,1952-1-22,103
1952,1,23,178,80,98,1952-1-23,-18
1952,1,24,420,79,341,1952-1-24,-262
1952,1,25,349,0,349,1952-1-25,-349
1952,1,26,314,9,305,1952-1-26,-296
1952,1,27,256,8,248,1952-1-27,-240
1952,1,28,126,0,126,1952-1-28,-126
1952,1,29,78,0,78,1952-1-29,-78
1952,1,30,111,35,76,1952-1-30,-41
1952,1,31,63,16,47,1952-1-31,-31
1952,2,1,56,25,31,1952-2-1,-6
1952,2,2,23,0,23,1952-2-2,-23
1952,2,3,28,0,28,1952-2-3,-28
1952,2,4,40,29,11,1952-2-4,18
1952,2,5,157,24,133,1952-2-5,-109
1952,2,6,217,0,217,1952-2-6,-217
1952,2,7,148,0,148,1952-2-7,-148
1952,2,8,129,0,129,1952-2-8,-129
1952,2,9,85,0,85,1952-2-9,-85
1952,2,10,53,0,53,1952-2-10,-53
1952,2,11,9,0,9,1952-2-11,-9
1952,2,12,247,0,247,1952-2-12,-247
1952,2,13,904,23,881,1952-2-13,-858
1952,2,14,934,63,871,1952-2-14,-808
1952,2,15,940,151,789,1952-2-15,-638
1952,2,16,927,167,760,1952-2-16,-593
1952,2,17,791,107,684,1952-2-17,-577
1952,2,18,730,84,646,1952-2-18,-562
1952,2,19,700,73,627,1952-2-19,-554
1952,2,20,506,45,461,1952-2-20,-416
1952,2,21,375,39,336,1952-2-21,-297
1952,2,22,283,34,249,1952-2-22,-215
1952,2,23,259,39,220,1952-2-23,-181
1952,2,24,298,29,269,1952-2-24,-240
1952,2,25,18,18,0,1952-2-25,18
1952,2,26,0,0,0,1952-2-26,0
1952,2,27,0,0,0,1952-2-27,0
1952,2,28,0,0,0,1952-2-28,0
1952,2,29,0,0,0,1952-2-29,0
1952,3,1,0,0,0,1952-3-1,0
1952,3,2,0,0,0,1952-3-2,0
1952,3,3,0,0,0,1952-3-3,0
1952,3,4,0,0,0,1952-3-4,0
1952,3,5,110,110,0,1952-3-5,110
1952,3,6,97,97,0,1952-3-6,97
1952,3,7,43,43,0,1952-3-7,43
1952,3,8,31,31,0,1952-3-8,31
1952,3,9,30,26,4,1952-3-9,22
1952,3,10,274,14,260,1952-3-10,-246
1952,3,11,263,7,256,1952-3-11,-249
1952,3,12,217,14,203,1952-3-12,-189
1952,3,13,223,5,218,1952-3-13,-213
1952,3,14,219,0,219,1952-3-14,-219
1952,3,15,129,0,129,1952-3-15,-129
1952,3,16,85,0,85,1952-3-16,-85
1952,3,17,104,0,104,1952-3-17,-104
1952,3,18,36,0,36,1952-3-18,-36
1952,3,19,24,0,24,1952-3-19,-24
1952,3,20,0,0,0,1952-3-20,0
1952,3,21,5,0,5,1952-3-21,-5
1952,3,22,0,0,0,1952-3-22,0
1952,3,23,0,0,0,1952-3-23,0
1952,3,24,70,0,70,1952-3-24,-70
1952,3,25,186,0,186,1952-3-25,-186
1952,3,26,220,0,220,1952-3-26,-220
1952,3,27,314,15,299,1952-3-27,-284
1952,3,28,502,41,461,1952-3-28,-420
1952,3,29,566,28,538,1952-3-29,-510
1952,3,30,411,15,396,1952-3-30,-381
1952,3,31,241,0,241,1952-3-31,-241
1952,4,1,215,0,215,1952-4-1,-215
1952,4,2,139,0,139,1952-4-2,-139
1952,4,3,140,37,103,1952-4-3,-66
1952,4,4,248,194,54,1952-4-4,140
1952,4,5,413,390,23,1952-4-5,367
1952,4,6,382,382,0,1952-4-6,382
1952,4,7,409,409,0,1952-4-7,409
1952,4,8,332,332,0,1952-4-8,332
1952,4,9,316,316,0,1952-4-9,316
1952,4,10,373,373,0,1952-4-10,373
1952,4,11,567,559,8,1952-4-11,551
1952,4,12,584,584,0,1952-4-12,584
1952,4,13,758,751,7,1952-4-13,744
1952,4,14,576,576,0,1952-4-14,576
1952,4,15,29,29,0,1952-4-15,29
1952,4,16,13,13,0,1952-4-16,13
1952,4,17,12,0,12,1952-4-17,-12
1952,4,18,90,0,90,1952-4-18,-90
1952,4,19,257,19,238,1952-4-19,-219
1952,4,20,490,59,431,1952-4-20,-372
1952,4,21,842,174,668,1952-4-21,-494
1952,4,22,1010,156,854,1952-4-22,-698
1952,4,23,893,151,742,1952-4-23,-591
1952,4,24,640,107,533,1952-4-24,-426
1952,4,25,157,124,33,1952-4-25,91
1952,4,26,150,114,36,1952-4-26,78
1952,4,27,113,94,19,1952-4-27,75
1952,4,28,89,68,21,1952-4-28,47
1952,4,29,114,80,34,1952-4-29,46
1952,4,30,180,91,89,1952-4-30,2
1952,5,1,160,99,61,1952-5-1,38
1952,5,2,41,41,0,1952-5-2,41
1952,5,3,15,15,0,1952-5-3,15
1952,5,4,66,12,54,1952-5-4,-42
1952,5,5,225,0,225,1952-5-5,-225
1952,5,6,762,0,762,1952-5-6,-762
1952,5,7,864,0,864,1952-5-7,-864
1952,5,8,584,0,584,1952-5-8,-584
1952,5,9,519,0,519,1952-5-9,-519
1952,5,10,0,0,0,1952-5-10,0
1952,5,11,7,0,7,1952-5-11,-7
1952,5,12,0,0,0,1952-5-12,0
1952,5,13,21,0,21,1952-5-13,-21
1952,5,14,25,0,25,1952-5-14,-25
1952,5,15,65,0,65,1952-5-15,-65
1952,5,16,102,0,102,1952-5-16,-102
1952,5,17,85,0,85,1952-5-17,-85
1952,5,18,179,0,179,1952-5-18,-179
1952,5,19,208,0,208,1952-5-19,-208
1952,5,20,150,0,150,1952-5-20,-150
1952,5,21,72,0,72,1952-5-21,-72
1952,5,22,385,0,385,1952-5-22,-385
1952,5,23,363,0,363,1952-5-23,-363
1952,5,24,368,0,368,1952-5-24,-368
1952,5,25,259,0,259,1952-5-25,-259
1952,5,26,257,0,257,1952-5-26,-257
1952,5,27,320,23,297,1952-5-27,-274
1952,5,28,583,66,517,1952-5-28,-451
1952,5,29,580,69,511,1952-5-29,-442
1952,5,30,452,42,410,1952-5-30,-368
1952,5,31,237,0,237,1952-5-31,-237
1952,6,1,271,33,238,1952-6-1,-205
1952,6,2,213,10,203,1952-6-2,-193
1952,6,3,112,11,101,1952-6-3,-90
1952,6,4,9,9,0,1952-6-4,9
1952,6,5,12,0,12,1952-6-5,-12
1952,6,6,16,0,16,1952-6-6,-16
1952,6,7,92,14,78,1952-6-7,-64
1952,6,8,76,12,64,1952-6-8,-52
1952,6,9,59,0,59,1952-6-9,-59
1952,6,10,37,0,37,1952-6-10,-37
1952,6,11,22,0,22,1952-6-11,-22
1952,6,12,36,0,36,1952-6-12,-36
1952,6,13,116,0,116,1952-6-13,-116
1952,6,14,187,43,144,1952-6-14,-101
1952,6,15,460,48,412,1952-6-15,-364
1952,6,16,407,48,359,1952-6-16,-311
1952,6,17,407,41,366,1952-6-17,-325
1952,6,18,346,52,294,1952-6-18,-242
1952,6,19,353,66,287,1952-6-19,-221
1952,6,20,433,146,287,1952-6-20,-141
1952,6,21,466,126,340,1952-6-21,-214
1952,6,22,529,149,380,1952-6-22,-231
1952,6,23,1100,230,870,1952-6-23,-640
1952,6,24,954,188,766,1952-6-24,-578
1952,6,25,862,144,718,1952-6-25,-574
1952,6,26,819,122,697,1952-6-26,-575
1952,6,27,700,58,642,1952-6-27,-584
1952,6,28,891,48,843,1952-6-28,-795
1952,6,29,873,21,852,1952-6-29,-831
1952,6,30,935,27,908,1952-6-30,-881
1952,7,1,790,29,761,1952-7-1,-732
1952,7,2,761,9,752,1952-7-2,-743
1952,7,3,776,15,761,1952-7-3,-746
1952,7,4,702,0,702,1952-7-4,-702
1952,7,5,619,14,605,1952-7-5,-591
1952,7,6,135,11,124,1952-7-6,-113
1952,7,7,30,6,24,1952-7-7,-18
1952,7,8,133,133,0,1952-7-8,133
1952,7,9,1434,349,1085,1952-7-9,-736
1952,7,10,1438,290,1148,1952-7-10,-858
1952,7,11,1514,276,1238,1952-7-11,-962
1952,7,12,1362,273,1089,1952-7-12,-816
1952,7,13,1217,319,898,1952-7-13,-579
1952,7,14,1191,309,882,1952-7-14,-573
1952,7,15,1074,254,820,1952-7-15,-566
1952,7,16,1100,242,858,1952-7-16,-616
1952,7,17,710,204,506,1952-7-17,-302
1952,7,18,573,177,396,1952-7-18,-219
1952,7,19,476,154,322,1952-7-19,-168
1952,7,20,681,155,526,1952-7-20,-371
1952,7,21,193,0,193,1952-7-21,-193
1952,7,22,186,0,186,1952-7-22,-186
1952,7,23,156,0,156,1952-7-23,-156
1952,7,24,148,0,148,1952-7-24,-148
1952,7,25,171,14,157,1952-7-25,-143
1952,7,26,152,0,152,1952-7-26,-152
1952,7,27,392,0,392,1952-7-27,-392
1952,7,28,513,0,513,1952-7-28,-513
1952,7,29,408,0,408,1952-7-29,-408
1952,7,30,504,0,504,1952-7-30,-504
1952,7,31,745,56,689,1952-7-31,-633
1952,8,1,584,25,559,1952-8-1,-534
1952,8,2,172,5,167,1952-8-2,-162
1952,8,3,161,46,115,1952-8-3,-69
1952,8,4,189,104,85,1952-8-4,19
1952,8,5,352,197,155,1952-8-5,42
1952,8,6,309,117,192,1952-8-6,-75
1952,8,7,494,349,145,1952-8-7,204
1952,8,8,614,517,97,1952-8-8,420
1952,8,9,571,489,82,1952-8-9,407
1952,8,10,716,665,51,1952-8-10,614
1952,8,11,484,458,26,1952-8-11,432
1952,8,12,396,352,44,1952-8-12,308
1952,8,13,371,289,82,1952-8-13,207
1952,8,14,377,267,110,1952-8-14,157
1952,8,15,442,205,237,1952-8-15,-32
1952,8,16,632,187,445,1952-8-16,-258
1952,8,17,542,164,378,1952-8-17,-214
1952,8,18,469,194,275,1952-8-18,-81
1952,8,19,164,133,31,1952-8-19,102
1952,8,20,613,572,41,1952-8-20,531
1952,8,21,583,534,49,1952-8-21,485
1952,8,22,473,437,36,1952-8-22,401
1952,8,23,678,462,216,1952-8-23,246
1952,8,24,851,486,365,1952-8-24,121
1952,8,25,864,516,348,1952-8-25,168
1952,8,26,999,493,506,1952-8-26,-13
1952,8,27,1549,785,764,1952-8-27,21
1952,8,28,1805,878,927,1952-8-28,-49
1952,8,29,2024,973,1051,1952-8-29,-78
1952,8,30,1594,573,1021,1952-8-30,-448
1952,8,31,1279,413,866,1952-8-31,-453
1952,9,1,1316,365,951,1952-9-1,-586
1952,9,2,1006,217,789,1952-9-2,-572
1952,9,3,551,132,419,1952-9-3,-287
1952,9,4,393,66,327,1952-9-4,-261
1952,9,5,448,57,391,1952-9-5,-334
1952,9,6,379,26,353,1952-9-6,-327
1952,9,7,310,14,296,1952-9-7,-282
1952,9,8,0,0,0,1952-9-8,0
1952,9,9,13,13,0,1952-9-9,13
1952,9,10,22,22,0,1952-9-10,22
1952,9,11,0,0,0,1952-9-11,0
1952,9,12,0,0,0,1952-9-12,0
1952,9,13,10,10,0,1952-9-13,10
1952,9,14,0,0,0,1952-9-14,0
1952,9,15,0,0,0,1952-9-15,0
1952,9,16,76,76,0,1952-9-16,76
1952,9,17,153,153,0,1952-9-17,153
1952,9,18,191,122,69,1952-9-18,53
1952,9,19,155,53,102,1952-9-19,-49
1952,9,20,163,49,114,1952-9-20,-65
1952,9,21,605,548,57,1952-9-21,491
1952,9,22,671,474,197,1952-9-22,277
1952,9,23,603,397,206,1952-9-23,191
1952,9,24,498,332,166,1952-9-24,166
1952,9,25,431,262,169,1952-9-25,93
1952,9,26,367,207,160,1952-9-26,47
1952,9,27,284,151,133,1952-9-27,18
1952,9,28,248,96,152,1952-9-28,-56
1952,9,29,188,43,145,1952-9-29,-102
1952,9,30,128,9,119,1952-9-30,-110
1952,10,1,130,0,130,1952-10-1,-130
1952,10,2,163,0,163,1952-10-2,-163
1952,10,3,95,0,95,1952-10-3,-95
1952,10,4,698,614,84,1952-10-4,530
1952,10,5,625,598,27,1952-10-5,571
1952,10,6,516,491,25,1952-10-6,466
1952,10,7,453,438,15,1952-10-7,423
1952,10,8,399,389,10,1952-10-8,379
1952,10,9,346,346,0,1952-10-9,346
1952,10,10,326,326,0,1952-10-10,326
1952,10,11,250,250,0,1952-10-11,250
1952,10,12,238,238,0,1952-10-12,238
1952,10,13,242,242,0,1952-10-13,242
1952,10,14,200,200,0,1952-10-14,200
1952,10,15,177,177,0,1952-10-15,177
1952,10,16,133,133,0,1952-10-16,133
1952,10,17,0,0,0,1952-10-17,0
1952,10,18,0,0,0,1952-10-18,0
1952,10,19,153,153,0,1952-10-19,153
1952,10,20,285,285,0,1952-10-20,285
1952,10,21,624,624,0,1952-10-21,624
1952,10,22,606,606,0,1952-10-22,606
1952,10,23,548,548,0,1952-10-23,548
1952,10,24,536,536,0,1952-10-24,536
1952,10,25,533,533,0,1952-10-25,533
1952,10,26,489,483,6,1952-10-26,477
1952,10,27,413,413,0,1952-10-27,413
1952,10,28,457,457,0,1952-10-28,457
1952,10,29,441,441,0,1952-10-29,441
1952,10,30,341,341,0,1952-10-30,341
1952,10,31,107,107,0,1952-10-31,107
1952,11,1,77,77,0,1952-11-1,77
1952,11,2,18,18,0,1952-11-2,18
1952,11,3,0,0,0,1952-11-3,0
1952,11,4,0,0,0,1952-11-4,0
1952,11,5,53,9,44,1952-11-5,-35
1952,11,6,104,0,104,1952-11-6,-104
1952,11,7,256,84,172,1952-11-7,-88
1952,11,8,466,290,176,1952-11-8,114
1952,11,9,316,203,113,1952-11-9,90
1952,11,10,239,150,89,1952-11-10,61
1952,11,11,155,77,78,1952-11-11,-1
1952,11,12,119,44,75,1952-11-12,-31
1952,11,13,166,86,80,1952-11-13,6
1952,11,14,239,166,73,1952-11-14,93
1952,11,15,186,110,76,1952-11-15,34
1952,11,16,678,630,48,1952-11-16,582
1952,11,17,741,741,0,1952-11-17,741
1952,11,18,773,773,0,1952-11-18,773
1952,11,19,833,833,0,1952-11-19,833
1952,11,20,1081,1081,0,1952-11-20,1081
1952,11,21,1091,1091,0,1952-11-21,1091
1952,11,22,1159,1159,0,1952-11-22,1159
1952,11,23,987,987,0,1952-11-23,987
1952,11,24,1001,965,36,1952-11-24,929
1952,11,25,952,938,14,1952-11-25,924
1952,11,26,894,894,0,1952-11-26,894
1952,11,27,944,944,0,1952-11-27,944
1952,11,28,7,0,7,1952-11-28,-7
1952,11,29,0,0,0,1952-11-29,0
1952,11,30,127,127,0,1952-11-30,127
1952,12,1,105,105,0,1952-12-1,105
1952,12,2,100,100,0,1952-12-2,100
1952,12,3,132,132,0,1952-12-3,132
1952,12,4,73,73,0,1952-12-4,73
1952,12,5,242,242,0,1952-12-5,242
1952,12,6,390,390,0,1952-12-6,390
1952,12,7,361,361,0,1952-12-7,361
1952,12,8,477,477,0,1952-12-8,477
1952,12,9,338,338,0,1952-12-9,338
1952,12,10,311,311,0,1952-12-10,311
1952,12,11,292,150,142,1952-12-11,8
1952,12,12,1138,741,397,1952-12-12,344
1952,12,13,882,528,354,1952-12-13,174
1952,12,14,1200,516,684,1952-12-14,-168
1952,12,15,1174,441,733,1952-12-15,-292
1952,12,16,1114,403,711,1952-12-16,-308
1952,12,17,1085,446,639,1952-12-17,-193
1952,12,18,990,493,497,1952-12-18,-4
1952,12,19,782,386,396,1952-12-19,-10
1952,12,20,646,356,290,1952-12-20,66
1952,12,21,580,311,269,1952-12-21,42
1952,12,22,528,297,231,1952-12-22,66
1952,12,23,591,310,281,1952-12-23,29
1952,12,24,566,274,292,1952-12-24,-18
1952,12,25,259,0,259,1952-12-25,-259
1952,12,26,254,0,254,1952-12-26,-254
1952,12,27,5,0,5,1952-12-27,-5
1952,12,28,0,0,0,1952-12-28,0
1952,12,29,11,11,0,1952-12-29,11
1952,12,30,60,42,18,1952-12-30,24
1952,12,31,110,105,5,1952-12-31,100
1953,1,1,159,159,0,1953-1-1,159
1953,1,2,139,139,0,1953-1-2,139
1953,1,3,100,100,0,1953-1-3,100
1953,1,4,212,212,0,1953-1-4,212
1953,1,5,283,283,0,1953-1-5,283
1953,1,6,467,467,0,1953-1-6,467
1953,1,7,426,426,0,1953-1-7,426
1953,1,8,552,525,27,1953-1-8,498
1953,1,9,724,447,277,1953-1-9,170
1953,1,10,927,409,518,1953-1-10,-109
1953,1,11,866,321,545,1953-1-11,-224
1953,1,12,773,265,508,1953-1-12,-243
1953,1,13,588,164,424,1953-1-13,-260
1953,1,14,680,205,475,1953-1-14,-270
1953,1,15,489,126,363,1953-1-15,-237
1953,1,16,452,119,333,1953-1-16,-214
1953,1,17,357,99,258,1953-1-17,-159
1953,1,18,242,51,191,1953-1-18,-140
1953,1,19,152,7,145,1953-1-19,-138
1953,1,20,122,0,122,1953-1-20,-122
1953,1,21,114,0,114,1953-1-21,-114
1953,1,22,88,20,68,1953-1-22,-48
1953,1,23,21,21,0,1953-1-23,21
1953,1,24,17,17,0,1953-1-24,17
1953,1,25,0,0,0,1953-1-25,0
1953,1,26,0,0,0,1953-1-26,0
1953,1,27,0,0,0,1953-1-27,0
1953,1,28,0,0,0,1953-1-28,0
1953,1,29,0,0,0,1953-1-29,0
1953,1,30,0,0,0,1953-1-30,0
1953,1,31,0,0,0,1953-1-31,0
1953,2,1,0,0,0,1953-2-1,0
1953,2,2,37,37,0,1953-2-2,37
1953,2,3,44,44,0,1953-2-3,44
1953,2,4,44,44,0,1953-2-4,44
1953,2,5,42,42,0,1953-2-5,42
1953,2,6,31,31,0,1953-2-6,31
1953,2,7,41,24,17,1953-2-7,7
1953,2,8,13,13,0,1953-2-8,13
1953,2,9,24,24,0,1953-2-9,24
1953,2,10,7,7,0,1953-2-10,7
1953,2,11,11,11,0,1953-2-11,11
1953,2,12,0,0,0,1953-2-12,0
1953,2,13,0,0,0,1953-2-13,0
1953,2,14,0,0,0,1953-2-14,0
1953,2,15,0,0,0,1953-2-15,0
1953,2,16,0,0,0,1953-2-16,0
1953,2,17,0,0,0,1953-2-17,0
1953,2,18,0,0,0,1953-2-18,0
1953,2,19,0,0,0,1953-2-19,0
1953,2,20,0,0,0,1953-2-20,0
1953,2,21,0,0,0,1953-2-21,0
1953,2,22,0,0,0,1953-2-22,0
1953,2,23,0,0,0,1953-2-23,0
1953,2,24,0,0,0,1953-2-24,0
1953,2,25,0,0,0,1953-2-25,0
1953,2,26,0,0,0,1953-2-26,0
1953,2,27,0,0,0,1953-2-27,0
1953,2,28,0,0,0,1953-2-28,0
1953,3,1,0,0,0,1953-3-1,0
1953,3,2,0,0,0,1953-3-2,0
1953,3,3,0,0,0,1953-3-3,0
1953,3,4,0,0,0,1953-3-4,0
1953,3,5,12,0,12,1953-3-5,-12
1953,3,6,0,0,0,1953-3-6,0
1953,3,7,0,0,0,1953-3-7,0
1953,3,8,5,0,5,1953-3-8,-5
1953,3,9,0,0,0,1953-3-9,0
1953,3,10,0,0,0,1953-3-10,0
1953,3,11,0,0,0,1953-3-11,0
1953,3,12,2,2,0,1953-3-12,2
1953,3,13,22,22,0,1953-3-13,22
1953,3,14,0,0,0,1953-3-14,0
1953,3,15,14,0,14,1953-3-15,-14
1953,3,16,2,0,2,1953-3-16,-2
1953,3,17,0,0,0,1953-3-17,0
1953,3,18,92,0,92,1953-3-18,-92
1953,3,19,122,0,122,1953-3-19,-122
1953,3,20,94,0,94,1953-3-20,-94
1953,3,21,105,0,105,1953-3-21,-105
1953,3,22,77,0,77,1953-3-22,-77
1953,3,23,53,0,53,1953-3-23,-53
1953,3,24,14,0,14,1953-3-24,-14
1953,3,25,12,0,12,1953-3-25,-12
1953,3,26,0,0,0,1953-3-26,0
1953,3,27,111,111,0,1953-3-27,111
1953,3,28,156,145,11,1953-3-28,134
1953,3,29,134,105,29,1953-3-29,76
1953,3,30,606,182,424,1953-3-30,-242
1953,3,31,547,538,9,1953-3-31,529
1953,4,1,379,372,7,1953-4-1,365
1953,4,2,383,345,38,1953-4-2,307
1953,4,3,431,385,46,1953-4-3,339
1953,4,4,437,426,11,1953-4-4,415
1953,4,5,275,275,0,1953-4-5,275
1953,4,6,275,275,0,1953-4-6,275
1953,4,7,299,274,25,1953-4-7,249
1953,4,8,478,439,39,1953-4-8,400
1953,4,9,541,541,0,1953-4-9,541
1953,4,10,549,549,0,1953-4-10,549
1953,4,11,302,302,0,1953-4-11,302
1953,4,12,0,0,0,1953-4-12,0
1953,4,13,0,0,0,1953-4-13,0
1953,4,14,0,0,0,1953-4-14,0
1953,4,15,0,0,0,1953-4-15,0
1953,4,16,0,0,0,1953-4-16,0
1953,4,17,0,0,0,1953-4-17,0
1953,4,18,6,6,0,1953-4-18,6
1953,4,19,0,0,0,1953-4-19,0
1953,4,20,0,0,0,1953-4-20,0
1953,4,21,0,0,0,1953-4-21,0
1953,4,22,391,391,0,1953-4-22,391
1953,4,23,839,766,73,1953-4-23,693
1953,4,24,750,694,56,1953-4-24,638
1953,4,25,637,581,56,1953-4-25,525
1953,4,26,726,699,27,1953-4-26,672
1953,4,27,1171,1151,20,1953-4-27,1131
1953,4,28,1126,1113,13,1953-4-28,1100
1953,4,29,1131,1127,4,1953-4-29,1123
1953,4,30,1039,1039,0,1953-4-30,1039
1953,5,1,1156,1156,0,1953-5-1,1156
1953,5,2,1192,1192,0,1953-5-2,1192
1953,5,3,917,917,0,1953-5-3,917
1953,5,4,915,909,6,1953-5-4,903
1953,5,5,85,85,0,1953-5-5,85
1953,5,6,91,91,0,1953-5-6,91
1953,5,7,80,80,0,1953-5-7,80
1953,5,8,0,0,0,1953-5-8,0
1953,5,9,0,0,0,1953-5-9,0
1953,5,10,0,0,0,1953-5-10,0
1953,5,11,0,0,0,1953-5-11,0
1953,5,12,0,0,0,1953-5-12,0
1953,5,13,0,0,0,1953-5-13,0
1953,5,14,0,0,0,1953-5-14,0
1953,5,15,0,0,0,1953-5-15,0
1953,5,16,0,0,0,1953-5-16,0
1953,5,17,0,0,0,1953-5-17,0
1953,5,18,10,10,0,1953-5-18,10
1953,5,19,229,229,0,1953-5-19,229
1953,5,20,212,212,0,1953-5-20,212
1953,5,21,178,178,0,1953-5-21,178
1953,5,22,151,151,0,1953-5-22,151
1953,5,23,142,142,0,1953-5-23,142
1953,5,24,132,132,0,1953-5-24,132
1953,5,25,116,116,0,1953-5-25,116
1953,5,26,105,105,0,1953-5-26,105
1953,5,27,97,97,0,1953-5-27,97
1953,5,28,110,87,23,1953-5-28,64
1953,5,29,79,68,11,1953-5-29,57
1953,5,30,38,38,0,1953-5-30,38
1953,5,31,28,28,0,1953-5-31,28
1953,6,1,14,0,14,1953-6-1,-14
1953,6,2,286,44,242,1953-6-2,-198
1953,6,3,405,14,391,1953-6-3,-377
1953,6,4,580,259,321,1953-6-4,-62
1953,6,5,572,256,316,1953-6-5,-60
1953,6,6,489,200,289,1953-6-6,-89
1953,6,7,538,176,362,1953-6-7,-186
1953,6,8,450,107,343,1953-6-8,-236
1953,6,9,408,137,271,1953-6-9,-134
1953,6,10,357,129,228,1953-6-10,-99
1953,6,11,170,69,101,1953-6-11,-32
1953,6,12,15,15,0,1953-6-12,15
1953,6,13,0,0,0,1953-6-13,0
1953,6,14,317,313,4,1953-6-14,309
1953,6,15,288,283,5,1953-6-15,278
1953,6,16,292,292,0,1953-6-16,292
1953,6,17,291,291,0,1953-6-17,291
1953,6,18,127,127,0,1953-6-18,127
1953,6,19,178,178,0,1953-6-19,178
1953,6,20,196,196,0,1953-6-20,196
1953,6,21,134,134,0,1953-6-21,134
1953,6,22,108,108,0,1953-6-22,108
1953,6,23,85,85,0,1953-6-23,85
1953,6,24,65,65,0,1953-6-24,65
1953,6,25,77,77,0,1953-6-25,77
1953,6,26,47,24,23,1953-6-26,1
1953,6,27,15,5,10,1953-6-27,-5
1953,6,28,10,0,10,1953-6-28,-10
1953,6,29,13,4,9,1953-6-29,-5
1953,6,30,8,0,8,1953-6-30,-8
1953,7,1,0,0,0,1953-7-1,0
1953,7,2,13,0,13,1953-7-2,-13
1953,7,3,0,0,0,1953-7-3,0
1953,7,4,0,0,0,1953-7-4,0
1953,7,5,0,0,0,1953-7-5,0
1953,7,6,0,0,0,1953-7-6,0
1953,7,7,0,0,0,1953-7-7,0
1953,7,8,0,0,0,1953-7-8,0
1953,7,9,171,0,171,1953-7-9,-171
1953,7,10,394,0,394,1953-7-10,-394
1953,7,11,336,0,336,1953-7-11,-336
1953,7,12,297,0,297,1953-7-12,-297
1953,7,13,223,0,223,1953-7-13,-223
1953,7,14,202,0,202,1953-7-14,-202
1953,7,15,224,0,224,1953-7-15,-224
1953,7,16,171,0,171,1953-7-16,-171
1953,7,17,138,0,138,1953-7-17,-138
1953,7,18,149,8,141,1953-7-18,-133
1953,7,19,101,0,101,1953-7-19,-101
1953,7,20,68,0,68,1953-7-20,-68
1953,7,21,15,0,15,1953-7-21,-15
1953,7,22,0,0,0,1953-7-22,0
1953,7,23,0,0,0,1953-7-23,0
1953,7,24,0,0,0,1953-7-24,0
1953,7,25,0,0,0,1953-7-25,0
1953,7,26,0,0,0,1953-7-26,0
1953,7,27,0,0,0,1953-7-27,0
1953,7,28,0,0,0,1953-7-28,0
1953,7,29,0,0,0,1953-7-29,0
1953,7,30,0,0,0,1953-7-30,0
1953,7,31,0,0,0,1953-7-31,0
1953,8,1,0,0,0,1953-8-1,0
1953,8,2,18,18,0,1953-8-2,18
1953,8,3,162,162,0,1953-8-3,162
1953,8,4,144,144,0,1953-8-4,144
1953,8,5,59,59,0,1953-8-5,59
1953,8,6,26,26,0,1953-8-6,26
1953,8,7,9,9,0,1953-8-7,9
1953,8,8,39,39,0,1953-8-8,39
1953,8,9,188,188,0,1953-8-9,188
1953,8,10,290,290,0,1953-8-10,290
1953,8,11,844,668,176,1953-8-11,492
1953,8,12,1091,968,123,1953-8-12,845
1953,8,13,899,805,94,1953-8-13,711
1953,8,14,729,645,84,1953-8-14,561
1953,8,15,693,648,45,1953-8-15,603
1953,8,16,654,618,36,1953-8-16,582
1953,8,17,522,509,13,1953-8-17,496
1953,8,18,380,372,8,1953-8-18,364
1953,8,19,361,347,14,1953-8-19,333
1953,8,20,309,298,11,1953-8-20,287
1953,8,21,323,313,10,1953-8-21,303
1953,8,22,288,248,40,1953-8-22,208
1953,8,23,308,293,15,1953-8-23,278
1953,8,24,0,0,0,1953-8-24,0
1953,8,25,0,0,0,1953-8-25,0
1953,8,26,0,0,0,1953-8-26,0
1953,8,27,0,0,0,1953-8-27,0
1953,8,28,0,0,0,1953-8-28,0
1953,8,29,0,0,0,1953-8-29,0
1953,8,30,0,0,0,1953-8-30,0
1953,8,31,0,0,0,1953-8-31,0
1953,9,1,0,0,0,1953-9-1,0
1953,9,2,0,0,0,1953-9-2,0
1953,9,3,0,0,0,1953-9-3,0
1953,9,4,0,0,0,1953-9-4,0
1953,9,5,9,9,0,1953-9-5,9
1953,9,6,99,85,14,1953-9-6,71
1953,9,7,252,246,6,1953-9-7,240
1953,9,8,265,237,28,1953-9-8,209
1953,9,9,247,247,0,1953-9-9,247
1953,9,10,243,243,0,1953-9-10,243
1953,9,11,230,230,0,1953-9-11,230
1953,9,12,223,223,0,1953-9-12,223
1953,9,13,220,190,30,1953-9-13,160
1953,9,14,257,166,91,1953-9-14,75
1953,9,15,344,248,96,1953-9-15,152
1953,9,16,347,249,98,1953-9-16,151
1953,9,17,351,233,118,1953-9-17,115
1953,9,18,348,242,106,1953-9-18,136
1953,9,19,275,232,43,1953-9-19,189
1953,9,20,92,76,16,1953-9-20,60
1953,9,21,126,108,18,1953-9-21,90
1953,9,22,66,66,0,1953-9-22,66
1953,9,23,61,61,0,1953-9-23,61
1953,9,24,46,46,0,1953-9-24,46
1953,9,25,61,61,0,1953-9-25,61
1953,9,26,53,53,0,1953-9-26,53
1953,9,27,18,18,0,1953-9-27,18
1953,9,28,0,0,0,1953-9-28,0
1953,9,29,0,0,0,1953-9-29,0
1953,9,30,0,0,0,1953-9-30,0
1953,10,1,0,0,0,1953-10-1,0
1953,10,2,0,0,0,1953-10-2,0
1953,10,3,0,0,0,1953-10-3,0
1953,10,4,35,0,35,1953-10-4,-35
1953,10,5,0,0,0,1953-10-5,0
1953,10,6,74,0,74,1953-10-6,-74
1953,10,7,96,0,96,1953-10-7,-96
1953,10,8,78,0,78,1953-10-8,-78
1953,10,9,36,0,36,1953-10-9,-36
1953,10,10,21,0,21,1953-10-10,-21
1953,10,11,23,0,23,1953-10-11,-23
1953,10,12,9,0,9,1953-10-12,-9
1953,10,13,93,0,93,1953-10-13,-93
1953,10,14,279,0,279,1953-10-14,-279
1953,10,15,274,0,274,1953-10-15,-274
1953,10,16,220,0,220,1953-10-16,-220
1953,10,17,129,0,129,1953-10-17,-129
1953,10,18,0,0,0,1953-10-18,0
1953,10,19,0,0,0,1953-10-19,0
1953,10,20,0,0,0,1953-10-20,0
1953,10,21,0,0,0,1953-10-21,0
1953,10,22,0,0,0,1953-10-22,0
1953,10,23,0,0,0,1953-10-23,0
1953,10,24,0,0,0,1953-10-24,0
1953,10,25,0,0,0,1953-10-25,0
1953,10,26,40,40,0,1953-10-26,40
1953,10,27,11,11,0,1953-10-27,11
1953,10,28,9,9,0,1953-10-28,9
1953,10,29,0,0,0,1953-10-29,0
1953,10,30,0,0,0,1953-10-30,0
1953,10,31,29,0,29,1953-10-31,-29
1953,11,1,86,0,86,1953-11-1,-86
1953,11,2,65,0,65,1953-11-2,-65
1953,11,3,49,0,49,1953-11-3,-49
1953,11,4,23,0,23,1953-11-4,-23
1953,11,5,0,0,0,1953-11-5,0
1953,11,6,0,0,0,1953-11-6,0
1953,11,7,0,0,0,1953-11-7,0
1953,11,8,0,0,0,1953-11-8,0
1953,11,9,0,0,0,1953-11-9,0
1953,11,10,0,0,0,1953-11-10,0
1953,11,11,0,0,0,1953-11-11,0
1953,11,12,0,0,0,1953-11-12,0
1953,11,13,0,0,0,1953-11-13,0
1953,11,14,0,0,0,1953-11-14,0
1953,11,15,0,0,0,1953-11-15,0
1953,11,16,0,0,0,1953-11-16,0
1953,11,17,0,0,0,1953-11-17,0
1953,11,18,0,0,0,1953-11-18,0
1953,11,19,0,0,0,1953-11-19,0
1953,11,20,35,35,0,1953-11-20,35
1953,11,21,8,8,0,1953-11-21,8
1953,11,22,0,0,0,1953-11-22,0
1953,11,23,0,0,0,1953-11-23,0
1953,11,24,0,0,0,1953-11-24,0
1953,11,25,0,0,0,1953-11-25,0
1953,11,26,4,0,4,1953-11-26,-4
1953,11,27,3,0,3,1953-11-27,-3
1953,11,28,0,0,0,1953-11-28,0
1953,11,29,0,0,0,1953-11-29,0
1953,11,30,0,0,0,1953-11-30,0
1953,12,1,0,0,0,1953-12-1,0
1953,12,2,0,0,0,1953-12-2,0
1953,12,3,0,0,0,1953-12-3,0
1953,12,4,0,0,0,1953-12-4,0
1953,12,5,0,0,0,1953-12-5,0
1953,12,6,0,0,0,1953-12-6,0
1953,12,7,63,63,0,1953-12-7,63
1953,12,8,9,9,0,1953-12-8,9
1953,12,9,0,0,0,1953-12-9,0
1953,12,10,0,0,0,1953-12-10,0
1953,12,11,0,0,0,1953-12-11,0
1953,12,12,0,0,0,1953-12-12,0
1953,12,13,0,0,0,1953-12-13,0
1953,12,14,0,0,0,1953-12-14,0
1953,12,15,0,0,0,1953-12-15,0
1953,12,16,0,0,0,1953-12-16,0
1953,12,17,0,0,0,1953-12-17,0
1953,12,18,0,0,0,1953-12-18,0
1953,12,19,0,0,0,1953-12-19,0
1953,12,20,0,0,0,1953-12-20,0
1953,12,21,0,0,0,1953-12-21,0
1953,12,22,0,0,0,1953-12-22,0
1953,12,23,0,0,0,1953-12-23,0
1953,12,24,0,0,0,1953-12-24,0
1953,12,25,20,0,20,1953-12-25,-20
1953,12,26,5,0,5,1953-12-26,-5
1953,12,27,5,0,5,1953-12-27,-5
1953,12,28,26,0,26,1953-12-28,-26
1953,12,29,44,0,44,1953-12-29,-44
1953,12,30,10,0,10,1953-12-30,-10
1953,12,31,4,0,4,1953-12-31,-4
1954,1,1,0,0,0,1954-1-1,0
1954,1,2,0,0,0,1954-1-2,0
1954,1,3,0,0,0,1954-1-3,0
1954,1,4,0,0,0,1954-1-4,0
1954,1,5,0,0,0,1954-1-5,0
1954,1,6,0,0,0,1954-1-6,0
1954,1,7,0,0,0,1954-1-7,0
1954,1,8,0,0,0,1954-1-8,0
1954,1,9,0,0,0,1954-1-9,0
1954,1,10,0,0,0,1954-1-10,0
1954,1,11,6,0,6,1954-1-11,-6
1954,1,12,0,0,0,1954-1-12,0
1954,1,13,0,0,0,1954-1-13,0
1954,1,14,0,0,0,1954-1-14,0
1954,1,15,0,0,0,1954-1-15,0
1954,1,16,0,0,0,1954-1-16,0
1954,1,17,0,0,0,1954-1-17,0
1954,1,18,4,0,4,1954-1-18,-4
1954,1,19,0,0,0,1954-1-19,0
1954,1,20,0,0,0,1954-1-20,0
1954,1,21,0,0,0,1954-1-21,0
1954,1,22,0,0,0,1954-1-22,0
1954,1,23,0,0,0,1954-1-23,0
1954,1,24,12,12,0,1954-1-24,12
1954,1,25,0,0,0,1954-1-25,0
1954,1,26,0,0,0,1954-1-26,0
1954,1,27,0,0,0,1954-1-27,0
1954,1,28,0,0,0,1954-1-28,0
1954,1,29,0,0,0,1954-1-29,0
1954,1,30,0,0,0,1954-1-30,0
1954,1,31,0,0,0,1954-1-31,0
1954,2,1,0,0,0,1954-2-1,0
1954,2,2,0,0,0,1954-2-2,0
1954,2,3,0,0,0,1954-2-3,0
1954,2,4,0,0,0,1954-2-4,0
1954,2,5,0,0,0,1954-2-5,0
1954,2,6,0,0,0,1954-2-6,0
1954,2,7,0,0,0,1954-2-7,0
1954,2,8,0,0,0,1954-2-8,0
1954,2,9,26,26,0,1954-2-9,26
1954,2,10,8,8,0,1954-2-10,8
1954,2,11,5,5,0,1954-2-11,5
1954,2,12,0,0,0,1954-2-12,0
1954,2,13,0,0,0,1954-2-13,0
1954,2,14,0,0,0,1954-2-14,0
1954,2,15,0,0,0,1954-2-15,0
1954,2,16,0,0,0,1954-2-16,0
1954,2,17,0,0,0,1954-2-17,0
1954,2,18,0,0,0,1954-2-18,0
1954,2,19,0,0,0,1954-2-19,0
1954,2,20,0,0,0,1954-2-20,0
1954,2,21,0,0,0,1954-2-21,0
1954,2,22,0,0,0,1954-2-22,0
1954,2,23,0,0,0,1954-2-23,0
1954,2,24,0,0,0,1954-2-24,0
1954,2,25,0,0,0,1954-2-25,0
1954,2,26,0,0,0,1954-2-26,0
1954,2,27,0,0,0,1954-2-27,0
1954,2,28,0,0,0,1954-2-28,0
1954,3,1,15,0,15,1954-3-1,-15
1954,3,2,161,0,161,1954-3-2,-161
1954,3,3,155,0,155,1954-3-3,-155
1954,3,4,88,0,88,1954-3-4,-88
1954,3,5,0,0,0,1954-3-5,0
1954,3,6,0,0,0,1954-3-6,0
1954,3,7,0,0,0,1954-3-7,0
1954,3,8,0,0,0,1954-3-8,0
1954,3,9,0,0,0,1954-3-9,0
1954,3,10,0,0,0,1954-3-10,0
1954,3,11,0,0,0,1954-3-11,0
1954,3,12,36,0,36,1954-3-12,-36
1954,3,13,299,0,299,1954-3-13,-299
1954,3,14,507,0,507,1954-3-14,-507
1954,3,15,627,0,627,1954-3-15,-627
1954,3,16,712,0,712,1954-3-16,-712
1954,3,17,594,9,585,1954-3-17,-576
1954,3,18,467,3,464,1954-3-18,-461
1954,3,19,427,8,419,1954-3-19,-411
1954,3,20,311,0,311,1954-3-20,-311
1954,3,21,296,0,296,1954-3-21,-296
1954,3,22,175,0,175,1954-3-22,-175
1954,3,23,10,0,10,1954-3-23,-10
1954,3,24,0,0,0,1954-3-24,0
1954,3,25,0,0,0,1954-3-25,0
1954,3,26,0,0,0,1954-3-26,0
1954,3,27,0,0,0,1954-3-27,0
1954,3,28,0,0,0,1954-3-28,0
1954,3,29,0,0,0,1954-3-29,0
1954,3,30,0,0,0,1954-3-30,0
1954,3,31,0,0,0,1954-3-31,0
1954,4,1,0,0,0,1954-4-1,0
1954,4,2,0,0,0,1954-4-2,0
1954,4,3,0,0,0,1954-4-3,0
1954,4,4,0,0,0,1954-4-4,0
1954,4,5,0,0,0,1954-4-5,0
1954,4,6,14,0,14,1954-4-6,-14
1954,4,7,25,0,25,1954-4-7,-25
1954,4,8,17,0,17,1954-4-8,-17
1954,4,9,7,0,7,1954-4-9,-7
1954,4,10,0,0,0,1954-4-10,0
1954,4,11,0,0,0,1954-4-11,0
1954,4,12,0,0,0,1954-4-12,0
1954,4,13,0,0,0,1954-4-13,0
1954,4,14,0,0,0,1954-4-14,0
1954,4,15,6,0,6,1954-4-15,-6
1954,4,16,16,0,16,1954-4-16,-16
1954,4,17,0,0,0,1954-4-17,0
1954,4,18,0,0,0,1954-4-18,0
1954,4,19,0,0,0,1954-4-19,0
1954,4,20,10,10,0,1954-4-20,10
1954,4,21,0,0,0,1954-4-21,0
1954,4,22,0,0,0,1954-4-22,0
1954,4,23,0,0,0,1954-4-23,0
1954,4,24,0,0,0,1954-4-24,0
1954,4,25,0,0,0,1954-4-25,0
1954,4,26,0,0,0,1954-4-26,0
1954,4,27,0,0,0,1954-4-27,0
1954,4,28,0,0,0,1954-4-28,0
1954,4,29,0,0,0,1954-4-29,0
1954,4,30,0,0,0,1954-4-30,0
1954,5,1,0,0,0,1954-5-1,0
1954,5,2,0,0,0,1954-5-2,0
1954,5,3,0,0,0,1954-5-3,0
1954,5,4,0,0,0,1954-5-4,0
1954,5,5,0,0,0,1954-5-5,0
1954,5,6,0,0,0,1954-5-6,0
1954,5,7,0,0,0,1954-5-7,0
1954,5,8,0,0,0,1954-5-8,0
1954,5,9,14,14,0,1954-5-9,14
1954,5,10,0,0,0,1954-5-10,0
1954,5,11,0,0,0,1954-5-11,0
1954,5,12,0,0,0,1954-5-12,0
1954,5,13,0,0,0,1954-5-13,0
1954,5,14,11,11,0,1954-5-14,11
1954,5,15,0,0,0,1954-5-15,0
1954,5,16,0,0,0,1954-5-16,0
1954,5,17,0,0,0,1954-5-17,0
1954,5,18,0,0,0,1954-5-18,0
1954,5,19,0,0,0,1954-5-19,0
1954,5,20,0,0,0,1954-5-20,0
1954,5,21,0,0,0,1954-5-21,0
1954,5,22,0,0,0,1954-5-22,0
1954,5,23,0,0,0,1954-5-23,0
1954,5,24,0,0,0,1954-5-24,0
1954,5,25,0,0,0,1954-5-25,0
1954,5,26,0,0,0,1954-5-26,0
1954,5,27,0,0,0,1954-5-27,0
1954,5,28,0,0,0,1954-5-28,0
1954,5,29,0,0,0,1954-5-29,0
1954,5,30,0,0,0,1954-5-30,0
1954,5,31,0,0,0,1954-5-31,0
1954,6,1,13,13,0,1954-6-1,13
1954,6,2,14,14,0,1954-6-2,14
1954,6,3,7,7,0,1954-6-3,7
1954,6,4,15,15,0,1954-6-4,15
1954,6,5,0,0,0,1954-6-5,0
1954,6,6,0,0,0,1954-6-6,0
1954,6,7,0,0,0,1954-6-7,0
1954,6,8,0,0,0,1954-6-8,0
1954,6,9,0,0,0,1954-6-9,0
1954,6,10,0,0,0,1954-6-10,0
1954,6,11,0,0,0,1954-6-11,0
1954,6,12,0,0,0,1954-6-12,0
1954,6,13,0,0,0,1954-6-13,0
1954,6,14,0,0,0,1954-6-14,0
1954,6,15,0,0,0,1954-6-15,0
1954,6,16,0,0,0,1954-6-16,0
1954,6,17,0,0,0,1954-6-17,0
1954,6,18,0,0,0,1954-6-18,0
1954,6,19,0,0,0,1954-6-19,0
1954,6,20,0,0,0,1954-6-20,0
1954,6,21,0,0,0,1954-6-21,0
1954,6,22,6,6,0,1954-6-22,6
1954,6,23,0,0,0,1954-6-23,0
1954,6,24,0,0,0,1954-6-24,0
1954,6,25,0,0,0,1954-6-25,0
1954,6,26,0,0,0,1954-6-26,0
1954,6,27,0,0,0,1954-6-27,0
1954,6,28,0,0,0,1954-6-28,0
1954,6,29,0,0,0,1954-6-29,0
1954,6,30,0,0,0,1954-6-30,0
1954,7,1,0,0,0,1954-7-1,0
1954,7,2,0,0,0,1954-7-2,0
1954,7,3,28,0,28,1954-7-3,-28
1954,7,4,0,0,0,1954-7-4,0
1954,7,5,0,0,0,1954-7-5,0
1954,7,6,0,0,0,1954-7-6,0
1954,7,7,0,0,0,1954-7-7,0
1954,7,8,8,8,0,1954-7-8,8
1954,7,9,7,7,0,1954-7-9,7
1954,7,10,0,0,0,1954-7-10,0
1954,7,11,0,0,0,1954-7-11,0
1954,7,12,8,8,0,1954-7-12,8
1954,7,13,24,24,0,1954-7-13,24
1954,7,14,25,25,0,1954-7-14,25
1954,7,15,35,35,0,1954-7-15,35
1954,7,16,40,40,0,1954-7-16,40
1954,7,17,18,18,0,1954-7-17,18
1954,7,18,0,0,0,1954-7-18,0
1954,7,19,0,0,0,1954-7-19,0
1954,7,20,0,0,0,1954-7-20,0
1954,7,21,0,0,0,1954-7-21,0
1954,7,22,0,0,0,1954-7-22,0
1954,7,23,0,0,0,1954-7-23,0
1954,7,24,0,0,0,1954-7-24,0
1954,7,25,64,64,0,1954-7-25,64
1954,7,26,28,28,0,1954-7-26,28
1954,7,27,11,11,0,1954-7-27,11
1954,7,28,8,8,0,1954-7-28,8
1954,7,29,13,13,0,1954-7-29,13
1954,7,30,10,10,0,1954-7-30,10
1954,7,31,0,0,0,1954-7-31,0
1954,8,1,127,127,0,1954-8-1,127
1954,8,2,136,136,0,1954-8-2,136
1954,8,3,107,107,0,1954-8-3,107
1954,8,4,83,83,0,1954-8-4,83
1954,8,5,66,66,0,1954-8-5,66
1954,8,6,110,110,0,1954-8-6,110
1954,8,7,72,72,0,1954-8-7,72
1954,8,8,26,26,0,1954-8-8,26
1954,8,9,99,34,65,1954-8-9,-31
1954,8,10,128,0,128,1954-8-10,-128
1954,8,11,120,0,120,1954-8-11,-120
1954,8,12,119,0,119,1954-8-12,-119
1954,8,13,31,0,31,1954-8-13,-31
1954,8,14,6,0,6,1954-8-14,-6
1954,8,15,0,0,0,1954-8-15,0
1954,8,16,0,0,0,1954-8-16,0
1954,8,17,0,0,0,1954-8-17,0
1954,8,18,0,0,0,1954-8-18,0
1954,8,19,0,0,0,1954-8-19,0
1954,8,20,0,0,0,1954-8-20,0
1954,8,21,23,0,23,1954-8-21,-23
1954,8,22,98,0,98,1954-8-22,-98
1954,8,23,187,0,187,1954-8-23,-187
1954,8,24,162,0,162,1954-8-24,-162
1954,8,25,73,0,73,1954-8-25,-73
1954,8,26,16,0,16,1954-8-26,-16
1954,8,27,8,0,8,1954-8-27,-8
1954,8,28,0,0,0,1954-8-28,0
1954,8,29,0,0,0,1954-8-29,0
1954,8,30,0,0,0,1954-8-30,0
1954,8,31,0,0,0,1954-8-31,0
1954,9,1,0,0,0,1954-9-1,0
1954,9,2,0,0,0,1954-9-2,0
1954,9,3,0,0,0,1954-9-3,0
1954,9,4,29,8,21,1954-9-4,-13
1954,9,5,2,0,2,1954-9-5,-2
1954,9,6,4,0,4,1954-9-6,-4
1954,9,7,0,0,0,1954-9-7,0
1954,9,8,0,0,0,1954-9-8,0
1954,9,9,0,0,0,1954-9-9,0
1954,9,10,0,0,0,1954-9-10,0
1954,9,11,0,0,0,1954-9-11,0
1954,9,12,0,0,0,1954-9-12,0
1954,9,13,5,0,5,1954-9-13,-5
1954,9,14,9,0,9,1954-9-14,-9
1954,9,15,4,4,0,1954-9-15,4
1954,9,16,7,7,0,1954-9-16,7
1954,9,17,2,2,0,1954-9-17,2
1954,9,18,0,0,0,1954-9-18,0
1954,9,19,0,0,0,1954-9-19,0
1954,9,20,0,0,0,1954-9-20,0
1954,9,21,0,0,0,1954-9-21,0
1954,9,22,0,0,0,1954-9-22,0
1954,9,23,0,0,0,1954-9-23,0
1954,9,24,0,0,0,1954-9-24,0
1954,9,25,5,0,5,1954-9-25,-5
1954,9,26,0,0,0,1954-9-26,0
1954,9,27,0,0,0,1954-9-27,0
1954,9,28,0,0,0,1954-9-28,0
1954,9,29,0,0,0,1954-9-29,0
1954,9,30,0,0,0,1954-9-30,0
1954,10,1,0,0,0,1954-10-1,0
1954,10,2,34,34,0,1954-10-2,34
1954,10,3,39,28,11,1954-10-3,17
1954,10,4,16,16,0,1954-10-4,16
1954,10,5,8,8,0,1954-10-5,8
1954,10,6,0,0,0,1954-10-6,0
1954,10,7,0,0,0,1954-10-7,0
1954,10,8,0,0,0,1954-10-8,0
1954,10,9,0,0,0,1954-10-9,0
1954,10,10,0,0,0,1954-10-10,0
1954,10,11,0,0,0,1954-10-11,0
1954,10,12,34,29,5,1954-10-12,24
1954,10,13,24,0,24,1954-10-13,-24
1954,10,14,46,22,24,1954-10-14,-2
1954,10,15,60,37,23,1954-10-15,14
1954,10,16,66,39,27,1954-10-16,12
1954,10,17,18,7,11,1954-10-17,-4
1954,10,18,34,34,0,1954-10-18,34
1954,10,19,17,17,0,1954-10-19,17
1954,10,20,15,15,0,1954-10-20,15
1954,10,21,10,10,0,1954-10-21,10
1954,10,22,15,15,0,1954-10-22,15
1954,10,23,12,12,0,1954-10-23,12
1954,10,24,12,12,0,1954-10-24,12
1954,10,25,15,15,0,1954-10-25,15
1954,10,26,12,12,0,1954-10-26,12
1954,10,27,0,0,0,1954-10-27,0
1954,10,28,0,0,0,1954-10-28,0
1954,10,29,0,0,0,1954-10-29,0
1954,10,30,0,0,0,1954-10-30,0
1954,10,31,0,0,0,1954-10-31,0
1954,11,1,0,0,0,1954-11-1,0
1954,11,2,0,0,0,1954-11-2,0
1954,11,3,0,0,0,1954-11-3,0
1954,11,4,0,0,0,1954-11-4,0
1954,11,5,5,5,0,1954-11-5,5
1954,11,6,30,30,0,1954-11-6,30
1954,11,7,0,0,0,1954-11-7,0
1954,11,8,25,25,0,1954-11-8,25
1954,11,9,71,38,33,1954-11-9,5
1954,11,10,292,38,254,1954-11-10,-216
1954,11,11,354,14,340,1954-11-11,-326
1954,11,12,324,24,300,1954-11-12,-276
1954,11,13,260,22,238,1954-11-13,-216
1954,11,14,171,23,148,1954-11-14,-125
1954,11,15,176,5,171,1954-11-15,-166
1954,11,16,0,0,0,1954-11-16,0
1954,11,17,13,0,13,1954-11-17,-13
1954,11,18,3,0,3,1954-11-18,-3
1954,11,19,10,0,10,1954-11-19,-10
1954,11,20,0,0,0,1954-11-20,0
1954,11,21,0,0,0,1954-11-21,0
1954,11,22,0,0,0,1954-11-22,0
1954,11,23,0,0,0,1954-11-23,0
1954,11,24,0,0,0,1954-11-24,0
1954,11,25,0,0,0,1954-11-25,0
1954,11,26,0,0,0,1954-11-26,0
1954,11,27,0,0,0,1954-11-27,0
1954,11,28,0,0,0,1954-11-28,0
1954,11,29,0,0,0,1954-11-29,0
1954,11,30,0,0,0,1954-11-30,0
1954,12,1,8,0,8,1954-12-1,-8
1954,12,2,0,0,0,1954-12-2,0
1954,12,3,0,0,0,1954-12-3,0
1954,12,4,0,0,0,1954-12-4,0
1954,12,5,0,0,0,1954-12-5,0
1954,12,6,0,0,0,1954-12-6,0
1954,12,7,0,0,0,1954-12-7,0
1954,12,8,0,0,0,1954-12-8,0
1954,12,9,0,0,0,1954-12-9,0
1954,12,10,0,0,0,1954-12-10,0
1954,12,11,0,0,0,1954-12-11,0
1954,12,12,0,0,0,1954-12-12,0
1954,12,13,0,0,0,1954-12-13,0
1954,12,14,0,0,0,1954-12-14,0
1954,12,15,182,182,0,1954-12-15,182
1954,12,16,341,341,0,1954-12-16,341
1954,12,17,323,323,0,1954-12-17,323
1954,12,18,411,411,0,1954-12-18,411
1954,12,19,395,395,0,1954-12-19,395
1954,12,20,379,379,0,1954-12-20,379
1954,12,21,318,318,0,1954-12-21,318
1954,12,22,11,11,0,1954-12-22,11
1954,12,23,79,79,0,1954-12-23,79
1954,12,24,57,57,0,1954-12-24,57
1954,12,25,17,17,0,1954-12-25,17
1954,12,26,17,17,0,1954-12-26,17
1954,12,27,0,0,0,1954-12-27,0
1954,12,28,0,0,0,1954-12-28,0
1954,12,29,34,0,34,1954-12-29,-34
1954,12,30,282,0,282,1954-12-30,-282
1954,12,31,437,0,437,1954-12-31,-437
1955,1,1,398,0,398,1955-1-1,-398
1955,1,2,307,0,307,1955-1-2,-307
1955,1,3,297,0,297,1955-1-3,-297
1955,1,4,264,43,221,1955-1-4,-178
1955,1,5,422,370,52,1955-1-5,318
1955,1,6,691,620,71,1955-1-6,549
1955,1,7,1532,1466,66,1955-1-7,1400
1955,1,8,1591,1569,22,1955-1-8,1547
1955,1,9,1358,1337,21,1955-1-9,1316
1955,1,10,1213,1213,0,1955-1-10,1213
1955,1,11,1173,1173,0,1955-1-11,1173
1955,1,12,973,973,0,1955-1-12,973
1955,1,13,966,966,0,1955-1-13,966
1955,1,14,674,674,0,1955-1-14,674
1955,1,15,569,569,0,1955-1-15,569
1955,1,16,526,526,0,1955-1-16,526
1955,1,17,617,617,0,1955-1-17,617
1955,1,18,386,386,0,1955-1-18,386
1955,1,19,426,426,0,1955-1-19,426
1955,1,20,34,0,34,1955-1-20,-34
1955,1,21,26,0,26,1955-1-21,-26
1955,1,22,24,0,24,1955-1-22,-24
1955,1,23,16,5,11,1955-1-23,-6
1955,1,24,156,142,14,1955-1-24,128
1955,1,25,211,211,0,1955-1-25,211
1955,1,26,303,122,181,1955-1-26,-59
1955,1,27,292,98,194,1955-1-27,-96
1955,1,28,228,31,197,1955-1-28,-166
1955,1,29,204,6,198,1955-1-29,-192
1955,1,30,443,129,314,1955-1-30,-185
1955,1,31,448,140,308,1955-1-31,-168
1955,2,1,364,75,289,1955-2-1,-214
1955,2,2,383,90,293,1955-2-2,-203
1955,2,3,438,126,312,1955-2-3,-186
1955,2,4,626,344,282,1955-2-4,62
1955,2,5,758,486,272,1955-2-5,214
1955,2,6,404,154,250,1955-2-6,-96
1955,2,7,391,177,214,1955-2-7,-37
1955,2,8,256,256,0,1955-2-8,256
1955,2,9,299,299,0,1955-2-9,299
1955,2,10,353,353,0,1955-2-10,353
1955,2,11,269,269,0,1955-2-11,269
1955,2,12,163,163,0,1955-2-12,163
1955,2,13,161,161,0,1955-2-13,161
1955,2,14,72,72,0,1955-2-14,72
1955,2,15,31,31,0,1955-2-15,31
1955,2,16,48,23,25,1955-2-16,-2
1955,2,17,6,0,6,1955-2-17,-6
1955,2,18,0,0,0,1955-2-18,0
1955,2,19,0,0,0,1955-2-19,0
1955,2,20,0,0,0,1955-2-20,0
1955,2,21,320,320,0,1955-2-21,320
1955,2,22,360,360,0,1955-2-22,360
1955,2,23,497,308,189,1955-2-23,119
1955,2,24,453,278,175,1955-2-24,103
1955,2,25,380,216,164,1955-2-25,52
1955,2,26,359,205,154,1955-2-26,51
1955,2,27,334,223,111,1955-2-27,112
1955,2,28,322,220,102,1955-2-28,118
1955,3,1,223,107,116,1955-3-1,-9
1955,3,2,192,74,118,1955-3-2,-44
1955,3,3,123,22,101,1955-3-3,-79
1955,3,4,84,0,84,1955-3-4,-84
1955,3,5,93,0,93,1955-3-5,-93
1955,3,6,75,0,75,1955-3-6,-75
1955,3,7,72,0,72,1955-3-7,-72
1955,3,8,47,47,0,1955-3-8,47
1955,3,9,10,10,0,1955-3-9,10
1955,3,10,15,15,0,1955-3-10,15
1955,3,11,0,0,0,1955-3-11,0
1955,3,12,0,0,0,1955-3-12,0
1955,3,13,0,0,0,1955-3-13,0
1955,3,14,0,0,0,1955-3-14,0
1955,3,15,0,0,0,1955-3-15,0
1955,3,16,0,0,0,1955-3-16,0
1955,3,17,0,0,0,1955-3-17,0
1955,3,18,0,0,0,1955-3-18,0
1955,3,19,0,0,0,1955-3-19,0
1955,3,20,0,0,0,1955-3-20,0
1955,3,21,0,0,0,1955-3-21,0
1955,3,22,0,0,0,1955-3-22,0
1955,3,23,0,0,0,1955-3-23,0
1955,3,24,0,0,0,1955-3-24,0
1955,3,25,0,0,0,1955-3-25,0
1955,3,26,0,0,0,1955-3-26,0
1955,3,27,0,0,0,1955-3-27,0
1955,3,28,0,0,0,1955-3-28,0
1955,3,29,51,21,30,1955-3-29,-9
1955,3,30,86,24,62,1955-3-30,-38
1955,3,31,82,0,82,1955-3-31,-82
1955,4,1,43,16,27,1955-4-1,-11
1955,4,2,24,7,17,1955-4-2,-10
1955,4,3,13,13,0,1955-4-3,13
1955,4,4,53,53,0,1955-4-4,53
1955,4,5,105,105,0,1955-4-5,105
1955,4,6,269,269,0,1955-4-6,269
1955,4,7,400,400,0,1955-4-7,400
1955,4,8,253,246,7,1955-4-8,239
1955,4,9,79,76,3,1955-4-9,73
1955,4,10,72,72,0,1955-4-10,72
1955,4,11,14,14,0,1955-4-11,14
1955,4,12,0,0,0,1955-4-12,0
1955,4,13,0,0,0,1955-4-13,0
1955,4,14,0,0,0,1955-4-14,0
1955,4,15,51,0,51,1955-4-15,-51
1955,4,16,41,0,41,1955-4-16,-41
1955,4,17,41,0,41,1955-4-17,-41
1955,4,18,7,0,7,1955-4-18,-7
1955,4,19,0,0,0,1955-4-19,0
1955,4,20,0,0,0,1955-4-20,0
1955,4,21,26,0,26,1955-4-21,-26
1955,4,22,16,0,16,1955-4-22,-16
1955,4,23,0,0,0,1955-4-23,0
1955,4,24,10,0,10,1955-4-24,-10
1955,4,25,0,0,0,1955-4-25,0
1955,4,26,0,0,0,1955-4-26,0
1955,4,27,78,78,0,1955-4-27,78
1955,4,28,226,226,0,1955-4-28,226
1955,4,29,344,344,0,1955-4-29,344
1955,4,30,239,239,0,1955-4-30,239
1955,5,1,191,191,0,1955-5-1,191
1955,5,2,166,166,0,1955-5-2,166
1955,5,3,355,161,194,1955-5-3,-33
1955,5,4,373,107,266,1955-5-4,-159
1955,5,5,333,46,287,1955-5-5,-241
1955,5,6,227,17,210,1955-5-6,-193
1955,5,7,114,16,98,1955-5-7,-82
1955,5,8,16,0,16,1955-5-8,-16
1955,5,9,0,0,0,1955-5-9,0
1955,5,10,0,0,0,1955-5-10,0
1955,5,11,20,0,20,1955-5-11,-20
1955,5,12,12,0,12,1955-5-12,-12
1955,5,13,0,0,0,1955-5-13,0
1955,5,14,0,0,0,1955-5-14,0
1955,5,15,0,0,0,1955-5-15,0
1955,5,16,79,79,0,1955-5-16,79
1955,5,17,209,209,0,1955-5-17,209
1955,5,18,273,273,0,1955-5-18,273
1955,5,19,337,337,0,1955-5-19,337
1955,5,20,459,459,0,1955-5-20,459
1955,5,21,700,680,20,1955-5-21,660
1955,5,22,804,796,8,1955-5-22,788
1955,5,23,884,884,0,1955-5-23,884
1955,5,24,665,665,0,1955-5-24,665
1955,5,25,596,591,5,1955-5-25,586
1955,5,26,779,773,6,1955-5-26,767
1955,5,27,358,358,0,1955-5-27,358
1955,5,28,547,547,0,1955-5-28,547
1955,5,29,419,410,9,1955-5-29,401
1955,5,30,282,282,0,1955-5-30,282
1955,5,31,166,151,15,1955-5-31,136
1955,6,1,106,89,17,1955-6-1,72
1955,6,2,86,81,5,1955-6-2,76
1955,6,3,45,45,0,1955-6-3,45
1955,6,4,115,115,0,1955-6-4,115
1955,6,5,196,196,0,1955-6-5,196
1955,6,6,261,261,0,1955-6-6,261
1955,6,7,152,152,0,1955-6-7,152
1955,6,8,101,101,0,1955-6-8,101
1955,6,9,72,72,0,1955-6-9,72
1955,6,10,501,71,430,1955-6-10,-359
1955,6,11,784,226,558,1955-6-11,-332
1955,6,12,769,117,652,1955-6-12,-535
1955,6,13,775,42,733,1955-6-13,-691
1955,6,14,808,46,762,1955-6-14,-716
1955,6,15,771,31,740,1955-6-15,-709
1955,6,16,1097,76,1021,1955-6-16,-945
1955,6,17,1184,45,1139,1955-6-17,-1094
1955,6,18,1085,32,1053,1955-6-18,-1021
1955,6,19,1083,20,1063,1955-6-19,-1043
1955,6,20,1248,14,1234,1955-6-20,-1220
1955,6,21,1205,47,1158,1955-6-21,-1111
1955,6,22,849,9,840,1955-6-22,-831
1955,6,23,248,0,248,1955-6-23,-248
1955,6,24,0,0,0,1955-6-24,0
1955,6,25,0,0,0,1955-6-25,0
1955,6,26,0,0,0,1955-6-26,0
1955,6,27,0,0,0,1955-6-27,0
1955,6,28,303,0,303,1955-6-28,-303
1955,6,29,314,0,314,1955-6-29,-314
1955,6,30,556,199,357,1955-6-30,-158
1955,7,1,655,326,329,1955-7-1,-3
1955,7,2,635,338,297,1955-7-2,41
1955,7,3,565,298,267,1955-7-3,31
1955,7,4,575,282,293,1955-7-4,-11
1955,7,5,575,291,284,1955-7-5,7
1955,7,6,600,376,224,1955-7-6,152
1955,7,7,462,289,173,1955-7-7,116
1955,7,8,280,176,104,1955-7-8,72
1955,7,9,198,170,28,1955-7-9,142
1955,7,10,175,154,21,1955-7-10,133
1955,7,11,213,213,0,1955-7-11,213
1955,7,12,103,88,15,1955-7-12,73
1955,7,13,123,77,46,1955-7-13,31
1955,7,14,113,60,53,1955-7-14,7
1955,7,15,43,17,26,1955-7-15,-9
1955,7,16,15,0,15,1955-7-16,-15
1955,7,17,8,0,8,1955-7-17,-8
1955,7,18,0,0,0,1955-7-18,0
1955,7,19,193,43,150,1955-7-19,-107
1955,7,20,239,49,190,1955-7-20,-141
1955,7,21,87,0,87,1955-7-21,-87
1955,7,22,142,8,134,1955-7-22,-126
1955,7,23,0,0,0,1955-7-23,0
1955,7,24,0,0,0,1955-7-24,0
1955,7,25,30,0,30,1955-7-25,-30
1955,7,26,14,14,0,1955-7-26,14
1955,7,27,86,76,10,1955-7-27,66
1955,7,28,104,100,4,1955-7-28,96
1955,7,29,104,104,0,1955-7-29,104
1955,7,30,218,218,0,1955-7-30,218
1955,7,31,153,144,9,1955-7-31,135
1955,8,1,100,72,28,1955-8-1,44
1955,8,2,89,70,19,1955-8-2,51
1955,8,3,80,42,38,1955-8-3,4
1955,8,4,45,45,0,1955-8-4,45
1955,8,5,448,41,407,1955-8-5,-366
1955,8,6,764,172,592,1955-8-6,-420
1955,8,7,935,310,625,1955-8-7,-315
1955,8,8,1144,450,694,1955-8-8,-244
1955,8,9,1450,603,847,1955-8-9,-244
1955,8,10,1594,727,867,1955-8-10,-140
1955,8,11,1541,688,853,1955-8-11,-165
1955,8,12,1402,602,800,1955-8-12,-198
1955,8,13,1243,512,731,1955-8-13,-219
1955,8,14,1109,413,696,1955-8-14,-283
1955,8,15,1037,442,595,1955-8-15,-153
1955,8,16,905,424,481,1955-8-16,-57
1955,8,17,104,14,90,1955-8-17,-76
1955,8,18,61,61,0,1955-8-18,61
1955,8,19,65,65,0,1955-8-19,65
1955,8,20,120,120,0,1955-8-20,120
1955,8,21,155,139,16,1955-8-21,123
1955,8,22,249,239,10,1955-8-22,229
1955,8,23,233,213,20,1955-8-23,193
1955,8,24,23,17,6,1955-8-24,11
1955,8,25,58,58,0,1955-8-25,58
1955,8,26,172,172,0,1955-8-26,172
1955,8,27,530,421,109,1955-8-27,312
1955,8,28,447,359,88,1955-8-28,271
1955,8,29,416,356,60,1955-8-29,296
1955,8,30,401,336,65,1955-8-30,271
1955,8,31,875,790,85,1955-8-31,705
1955,9,1,1003,758,245,1955-9-1,513
1955,9,2,974,795,179,1955-9-2,616
1955,9,3,1072,931,141,1955-9-3,790
1955,9,4,933,748,185,1955-9-4,563
1955,9,5,1121,609,512,1955-9-5,97
1955,9,6,1156,573,583,1955-9-6,-10
1955,9,7,1205,529,676,1955-9-7,-147
1955,9,8,689,490,199,1955-9-8,291
1955,9,9,518,391,127,1955-9-9,264
1955,9,10,542,446,96,1955-9-10,350
1955,9,11,365,326,39,1955-9-11,287
1955,9,12,428,408,20,1955-9-12,388
1955,9,13,456,452,4,1955-9-13,448
1955,9,14,334,328,6,1955-9-14,322
1955,9,15,243,178,65,1955-9-15,113
1955,9,16,175,97,78,1955-9-16,19
1955,9,17,167,90,77,1955-9-17,13
1955,9,18,115,57,58,1955-9-18,-1
1955,9,19,100,43,57,1955-9-19,-14
1955,9,20,134,19,115,1955-9-20,-96
1955,9,21,7,7,0,1955-9-21,7
1955,9,22,0,0,0,1955-9-22,0
1955,9,23,216,0,216,1955-9-23,-216
1955,9,24,162,10,152,1955-9-24,-142
1955,9,25,87,4,83,1955-9-25,-79
1955,9,26,75,0,75,1955-9-26,-75
1955,9,27,158,32,126,1955-9-27,-94
1955,9,28,94,27,67,1955-9-28,-40
1955,9,29,133,92,41,1955-9-29,51
1955,9,30,441,412,29,1955-9-30,383
1955,10,1,588,563,25,1955-10-1,538
1955,10,2,807,770,37,1955-10-2,733
1955,10,3,714,697,17,1955-10-3,680
1955,10,4,797,797,0,1955-10-4,797
1955,10,5,628,628,0,1955-10-5,628
1955,10,6,584,584,0,1955-10-6,584
1955,10,7,783,667,116,1955-10-7,551
1955,10,8,753,606,147,1955-10-8,459
1955,10,9,836,600,236,1955-10-9,364
1955,10,10,631,493,138,1955-10-10,355
1955,10,11,717,628,89,1955-10-11,539
1955,10,12,722,646,76,1955-10-12,570
1955,10,13,601,588,13,1955-10-13,575
1955,10,14,99,51,48,1955-10-14,3
1955,10,15,11,0,11,1955-10-15,-11
1955,10,16,0,0,0,1955-10-16,0
1955,10,17,0,0,0,1955-10-17,0
1955,10,18,0,0,0,1955-10-18,0
1955,10,19,222,222,0,1955-10-19,222
1955,10,20,302,302,0,1955-10-20,302
1955,10,21,309,309,0,1955-10-21,309
1955,10,22,508,508,0,1955-10-22,508
1955,10,23,1174,648,526,1955-10-23,122
1955,10,24,1637,709,928,1955-10-24,-219
1955,10,25,1974,785,1189,1955-10-25,-404
1955,10,26,2145,801,1344,1955-10-26,-543
1955,10,27,1925,708,1217,1955-10-27,-509
1955,10,28,2200,886,1314,1955-10-28,-428
1955,10,29,2276,837,1439,1955-10-29,-602
1955,10,30,2390,923,1467,1955-10-30,-544
1955,10,31,2228,868,1360,1955-10-31,-492
1955,11,1,2455,1134,1321,1955-11-1,-187
1955,11,2,2086,1026,1060,1955-11-2,-34
1955,11,3,2026,898,1128,1955-11-3,-230
1955,11,4,1330,752,578,1955-11-4,174
1955,11,5,847,303,544,1955-11-5,-241
1955,11,6,471,197,274,1955-11-6,-77
1955,11,7,1109,302,807,1955-11-7,-505
1955,11,8,1895,969,926,1955-11-8,43
1955,11,9,2324,1546,778,1955-11-9,768
1955,11,10,2422,1571,851,1955-11-10,720
1955,11,11,2433,1620,813,1955-11-11,807
1955,11,12,2540,1816,724,1955-11-12,1092
1955,11,13,2292,1756,536,1955-11-13,1220
1955,11,14,1996,1625,371,1955-11-14,1254
1955,11,15,1814,1590,224,1955-11-15,1366
1955,11,16,1791,1597,194,1955-11-16,1403
1955,11,17,1532,1409,123,1955-11-17,1286
1955,11,18,1130,973,157,1955-11-18,816
1955,11,19,1524,1072,452,1955-11-19,620
1955,11,20,1537,1032,505,1955-11-20,527
1955,11,21,1130,491,639,1955-11-21,-148
1955,11,22,1047,424,623,1955-11-22,-199
1955,11,23,1052,528,524,1955-11-23,4
1955,11,24,1170,514,656,1955-11-24,-142
1955,11,25,1198,514,684,1955-11-25,-170
1955,11,26,1397,641,756,1955-11-26,-115
1955,11,27,1584,874,710,1955-11-27,164
1955,11,28,1687,678,1009,1955-11-28,-331
1955,11,29,2066,760,1306,1955-11-29,-546
1955,11,30,2055,963,1092,1955-11-30,-129
1955,12,1,1882,867,1015,1955-12-1,-148
1955,12,2,1596,1073,523,1955-12-2,550
1955,12,3,1009,603,406,1955-12-3,197
1955,12,4,1359,1016,343,1955-12-4,673
1955,12,5,1352,1053,299,1955-12-5,754
1955,12,6,1302,968,334,1955-12-6,634
1955,12,7,1015,671,344,1955-12-7,327
1955,12,8,1036,794,242,1955-12-8,552
1955,12,9,948,702,246,1955-12-9,456
1955,12,10,732,390,342,1955-12-10,48
1955,12,11,790,679,111,1955-12-11,568
1955,12,12,1184,1113,71,1955-12-12,1042
1955,12,13,1378,1099,279,1955-12-13,820
1955,12,14,1453,1033,420,1955-12-14,613
1955,12,15,1217,841,376,1955-12-15,465
1955,12,16,1321,957,364,1955-12-16,593
1955,12,17,1507,976,531,1955-12-17,445
1955,12,18,1408,918,490,1955-12-18,428
1955,12,19,1425,826,599,1955-12-19,227
1955,12,20,1445,733,712,1955-12-20,21
1955,12,21,1602,711,891,1955-12-21,-180
1955,12,22,1107,206,901,1955-12-22,-695
1955,12,23,782,87,695,1955-12-23,-608
1955,12,24,671,88,583,1955-12-24,-495
1955,12,25,542,181,361,1955-12-25,-180
1955,12,26,427,138,289,1955-12-26,-151
1955,12,27,468,207,261,1955-12-27,-54
1955,12,28,707,441,266,1955-12-28,175
1955,12,29,605,293,312,1955-12-29,-19
1955,12,30,538,277,261,1955-12-30,16
1955,12,31,572,347,225,1955-12-31,122
1956,1,1,560,438,122,1956-1-1,316
1956,1,2,424,304,120,1956-1-2,184
1956,1,3,223,104,119,1956-1-3,-15
1956,1,4,313,175,138,1956-1-4,37
1956,1,5,249,96,153,1956-1-5,-57
1956,1,6,397,240,157,1956-1-6,83
1956,1,7,279,102,177,1956-1-7,-75
1956,1,8,346,134,212,1956-1-8,-78
1956,1,9,406,115,291,1956-1-9,-176
1956,1,10,340,119,221,1956-1-10,-102
1956,1,11,384,96,288,1956-1-11,-192
1956,1,12,566,143,423,1956-1-12,-280
1956,1,13,1255,649,606,1956-1-13,43
1956,1,14,1996,1442,554,1956-1-14,888
1956,1,15,2598,2136,462,1956-1-15,1674
1956,1,16,3169,2762,407,1956-1-16,2355
1956,1,17,3429,3319,110,1956-1-17,3209
1956,1,18,3784,3614,170,1956-1-18,3444
1956,1,19,3459,3406,53,1956-1-19,3353
1956,1,20,3447,3428,19,1956-1-20,3409
1956,1,21,3580,3580,0,1956-1-21,3580
1956,1,22,3301,3252,49,1956-1-22,3203
1956,1,23,3445,3053,392,1956-1-23,2661
1956,1,24,3488,3050,438,1956-1-24,2612
1956,1,25,3127,2782,345,1956-1-25,2437
1956,1,26,1674,1412,262,1956-1-26,1150
1956,1,27,719,499,220,1956-1-27,279
1956,1,28,750,560,190,1956-1-28,370
1956,1,29,654,439,215,1956-1-29,224
1956,1,30,396,228,168,1956-1-30,60
1956,1,31,346,126,220,1956-1-31,-94
1956,2,1,759,582,177,1956-2-1,405
1956,2,2,1041,920,121,1956-2-2,799
1956,2,3,1098,1010,88,1956-2-3,922
1956,2,4,564,507,57,1956-2-4,450
1956,2,5,256,235,21,1956-2-5,214
1956,2,6,472,320,152,1956-2-6,168
1956,2,7,319,223,96,1956-2-7,127
1956,2,8,273,172,101,1956-2-8,71
1956,2,9,235,141,94,1956-2-9,47
1956,2,10,490,400,90,1956-2-10,310
1956,2,11,2276,2047,229,1956-2-11,1818
1956,2,12,2696,2342,354,1956-2-12,1988
1956,2,13,3276,2721,555,1956-2-13,2166
1956,2,14,3837,2890,947,1956-2-14,1943
1956,2,15,4391,3107,1284,1956-2-15,1823
1956,2,16,5623,3939,1684,1956-2-16,2255
1956,2,17,5628,3820,1808,1956-2-17,2012
1956,2,18,6158,4141,2017,1956-2-18,2124
1956,2,19,5726,4143,1583,1956-2-19,2560
1956,2,20,6478,4804,1674,1956-2-20,3130
1956,2,21,6305,4576,1729,1956-2-21,2847
1956,2,22,6130,4591,1539,1956-2-22,3052
1956,2,23,5478,4012,1466,1956-2-23,2546
1956,2,24,4210,2716,1494,1956-2-24,1222
1956,2,25,2812,1651,1161,1956-2-25,490
1956,2,26,2050,950,1100,1956-2-26,-150
1956,2,27,1577,653,924,1956-2-27,-271
1956,2,28,1518,738,780,1956-2-28,-42
1956,2,29,1793,927,866,1956-2-29,61
1956,3,1,2112,1006,1106,1956-3-1,-100
1956,3,2,1894,627,1267,1956-3-2,-640
1956,3,3,1648,458,1190,1956-3-3,-732
1956,3,4,1828,705,1123,1956-3-4,-418
1956,3,5,1798,943,855,1956-3-5,88
1956,3,6,1997,1173,824,1956-3-6,349
1956,3,7,2082,1381,701,1956-3-7,680
1956,3,8,1929,1202,727,1956-3-8,475
1956,3,9,1791,1158,633,1956-3-9,525
1956,3,10,1488,861,627,1956-3-10,234
1956,3,11,2000,1349,651,1956-3-11,698
1956,3,12,1863,1274,589,1956-3-12,685
1956,3,13,2310,1470,840,1956-3-13,630
1956,3,14,2267,1462,805,1956-3-14,657
1956,3,15,2042,1362,680,1956-3-15,682
1956,3,16,1672,1009,663,1956-3-16,346
1956,3,17,1621,969,652,1956-3-17,317
1956,3,18,1811,1204,607,1956-3-18,597
1956,3,19,2314,1708,606,1956-3-19,1102
1956,3,20,2089,1518,571,1956-3-20,947
1956,3,21,2460,1492,968,1956-3-21,524
1956,3,22,2630,1551,1079,1956-3-22,472
1956,3,23,2480,1318,1162,1956-3-23,156
1956,3,24,1625,962,663,1956-3-24,299
1956,3,25,1538,1047,491,1956-3-25,556
1956,3,26,1503,820,683,1956-3-26,137
1956,3,27,1166,511,655,1956-3-27,-144
1956,3,28,1405,733,672,1956-3-28,61
1956,3,29,1622,1099,523,1956-3-29,576
1956,3,30,1674,1070,604,1956-3-30,466
1956,3,31,873,417,456,1956-3-31,-39
1956,4,1,488,265,223,1956-4-1,42
1956,4,2,424,355,69,1956-4-2,286
1956,4,3,316,245,71,1956-4-3,174
1956,4,4,243,166,77,1956-4-4,89
1956,4,5,306,306,0,1956-4-5,306
1956,4,6,684,684,0,1956-4-6,684
1956,4,7,1072,851,221,1956-4-7,630
1956,4,8,1369,1165,204,1956-4-8,961
1956,4,9,1655,1281,374,1956-4-9,907
1956,4,10,2617,1388,1229,1956-4-10,159
1956,4,11,2772,1421,1351,1956-4-11,70
1956,4,12,2476,1354,1122,1956-4-12,232
1956,4,13,2274,1188,1086,1956-4-13,102
1956,4,14,2254,1019,1235,1956-4-14,-216
1956,4,15,2273,856,1417,1956-4-15,-561
1956,4,16,2152,838,1314,1956-4-16,-476
1956,4,17,2399,1249,1150,1956-4-17,99
1956,4,18,2280,1210,1070,1956-4-18,140
1956,4,19,1898,1042,856,1956-4-19,186
1956,4,20,1752,909,843,1956-4-20,66
1956,4,21,1804,1051,753,1956-4-21,298
1956,4,22,1800,1403,397,1956-4-22,1006
1956,4,23,1423,1144,279,1956-4-23,865
1956,4,24,1044,949,95,1956-4-24,854
1956,4,25,805,706,99,1956-4-25,607
1956,4,26,795,713,82,1956-4-26,631
1956,4,27,933,811,122,1956-4-27,689
1956,4,28,764,621,143,1956-4-28,478
1956,4,29,282,222,60,1956-4-29,162
1956,4,30,1202,678,524,1956-4-30,154
1956,5,1,1963,1285,678,1956-5-1,607
1956,5,2,2140,1364,776,1956-5-2,588
1956,5,3,2330,1668,662,1956-5-3,1006
1956,5,4,2168,1629,539,1956-5-4,1090
1956,5,5,2043,1476,567,1956-5-5,909
1956,5,6,2334,1637,697,1956-5-6,940
1956,5,7,2358,1502,856,1956-5-7,646
1956,5,8,2333,1467,866,1956-5-8,601
1956,5,9,2038,1359,679,1956-5-9,680
1956,5,10,2492,1497,995,1956-5-10,502
1956,5,11,2895,1778,1117,1956-5-11,661
1956,5,12,3216,2102,1114,1956-5-12,988
1956,5,13,2869,1870,999,1956-5-13,871
1956,5,14,2534,1637,897,1956-5-14,740
1956,5,15,1947,1164,783,1956-5-15,381
1956,5,16,1753,834,919,1956-5-16,-85
1956,5,17,1729,917,812,1956-5-17,105
1956,5,18,1694,814,880,1956-5-18,-66
1956,5,19,1701,742,959,1956-5-19,-217
1956,5,20,1930,841,1089,1956-5-20,-248
1956,5,21,2074,1091,983,1956-5-21,108
1956,5,22,1563,725,838,1956-5-22,-113
1956,5,23,935,312,623,1956-5-23,-311
1956,5,24,1280,308,972,1956-5-24,-664
1956,5,25,1640,226,1414,1956-5-25,-1188
1956,5,26,2482,214,2268,1956-5-26,-2054
1956,5,27,2540,22,2518,1956-5-27,-2496
1956,5,28,2919,730,2189,1956-5-28,-1459
1956,5,29,3533,1474,2059,1956-5-29,-585
1956,5,30,3038,1295,1743,1956-5-30,-448
1956,5,31,2367,1296,1071,1956-5-31,225
1956,6,1,1805,1154,651,1956-6-1,503
1956,6,2,1722,1199,523,1956-6-2,676
1956,6,3,1776,1272,504,1956-6-3,768
1956,6,4,1690,1200,490,1956-6-4,710
1956,6,5,1723,1117,606,1956-6-5,511
1956,6,6,1785,975,810,1956-6-6,165
1956,6,7,1849,989,860,1956-6-7,129
1956,6,8,1412,832,580,1956-6-8,252
1956,6,9,1172,717,455,1956-6-9,262
1956,6,10,598,236,362,1956-6-10,-126
1956,6,11,737,508,229,1956-6-11,279
1956,6,12,662,464,198,1956-6-12,266
1956,6,13,664,404,260,1956-6-13,144
1956,6,14,728,430,298,1956-6-14,132
1956,6,15,1284,749,535,1956-6-15,214
1956,6,16,1930,1261,669,1956-6-16,592
1956,6,17,1670,1145,525,1956-6-17,620
1956,6,18,1810,1170,640,1956-6-18,530
1956,6,19,2129,1329,800,1956-6-19,529
1956,6,20,2577,1803,774,1956-6-20,1029
1956,6,21,2741,2130,611,1956-6-21,1519
1956,6,22,3327,2509,818,1956-6-22,1691
1956,6,23,2957,2070,887,1956-6-23,1183
1956,6,24,2397,1629,768,1956-6-24,861
1956,6,25,2372,1774,598,1956-6-25,1176
1956,6,26,1098,701,397,1956-6-26,304
1956,6,27,576,49,527,1956-6-27,-478
1956,6,28,939,371,568,1956-6-28,-197
1956,6,29,1678,953,725,1956-6-29,228
1956,6,30,2394,1268,1126,1956-6-30,142
1956,7,1,2119,1075,1044,1956-7-1,31
1956,7,2,2008,1035,973,1956-7-2,62
1956,7,3,1987,1226,761,1956-7-3,465
1956,7,4,2096,1059,1037,1956-7-4,22
1956,7,5,1694,725,969,1956-7-5,-244
1956,7,6,1548,808,740,1956-7-6,68
1956,7,7,2313,1567,746,1956-7-7,821
1956,7,8,2433,1796,637,1956-7-8,1159
1956,7,9,2237,1730,507,1956-7-9,1223
1956,7,10,2243,1772,471,1956-7-10,1301
1956,7,11,2336,1965,371,1956-7-11,1594
1956,7,12,2456,2219,237,1956-7-12,1982
1956,7,13,2103,1848,255,1956-7-13,1593
1956,7,14,1686,1340,346,1956-7-14,994
1956,7,15,1264,952,312,1956-7-15,640
1956,7,16,1183,783,400,1956-7-16,383
1956,7,17,979,659,320,1956-7-17,339
1956,7,18,702,416,286,1956-7-18,130
1956,7,19,796,478,318,1956-7-19,160
1956,7,20,931,535,396,1956-7-20,139
1956,7,21,1384,585,799,1956-7-21,-214
1956,7,22,2083,760,1323,1956-7-22,-563
1956,7,23,2725,1173,1552,1956-7-23,-379
1956,7,24,2410,897,1513,1956-7-24,-616
1956,7,25,1959,400,1559,1956-7-25,-1159
1956,7,26,1800,350,1450,1956-7-26,-1100
1956,7,27,1916,430,1486,1956-7-27,-1056
1956,7,28,1949,381,1568,1956-7-28,-1187
1956,7,29,1816,354,1462,1956-7-29,-1108
1956,7,30,1998,582,1416,1956-7-30,-834
1956,7,31,2904,1461,1443,1956-7-31,18
1956,8,1,2890,1523,1367,1956-8-1,156
1956,8,2,2665,1838,827,1956-8-2,1011
1956,8,3,2084,1702,382,1956-8-3,1320
1956,8,4,2071,1602,469,1956-8-4,1133
1956,8,5,2350,1965,385,1956-8-5,1580
1956,8,6,2426,2196,230,1956-8-6,1966
1956,8,7,2661,2480,181,1956-8-7,2299
1956,8,8,2699,2650,49,1956-8-8,2601
1956,8,9,2876,2253,623,1956-8-9,1630
1956,8,10,2769,1967,802,1956-8-10,1165
1956,8,11,2672,1805,867,1956-8-11,938
1956,8,12,2094,1221,873,1956-8-12,348
1956,8,13,2285,1081,1204,1956-8-13,-123
1956,8,14,2556,1296,1260,1956-8-14,36
1956,8,15,2351,1121,1230,1956-8-15,-109
1956,8,16,2386,1298,1088,1956-8-16,210
1956,8,17,2577,1225,1352,1956-8-17,-127
1956,8,18,2514,909,1605,1956-8-18,-696
1956,8,19,3009,929,2080,1956-8-19,-1151
1956,8,20,3539,909,2630,1956-8-20,-1721
1956,8,21,4039,1088,2951,1956-8-21,-1863
1956,8,22,3733,1027,2706,1956-8-22,-1679
1956,8,23,4152,1336,2816,1956-8-23,-1480
1956,8,24,4569,1674,2895,1956-8-24,-1221
1956,8,25,3854,1888,1966,1956-8-25,-78
1956,8,26,3618,2224,1394,1956-8-26,830
1956,8,27,4128,2548,1580,1956-8-27,968
1956,8,28,3908,2786,1122,1956-8-28,1664
1956,8,29,4007,2788,1219,1956-8-29,1569
1956,8,30,3447,2569,878,1956-8-30,1691
1956,8,31,2573,1801,772,1956-8-31,1029
1956,9,1,2079,1533,546,1956-9-1,987
1956,9,2,1983,1610,373,1956-9-2,1237
1956,9,3,1853,1583,270,1956-9-3,1313
1956,9,4,1973,1788,185,1956-9-4,1603
1956,9,5,2854,1611,1243,1956-9-5,368
1956,9,6,3969,1287,2682,1956-9-6,-1395
1956,9,7,3556,834,2722,1956-9-7,-1888
1956,9,8,3264,562,2702,1956-9-8,-2140
1956,9,9,3196,123,3073,1956-9-9,-2950
1956,9,10,3182,49,3133,1956-9-10,-3084
1956,9,11,3879,243,3636,1956-9-11,-3393
1956,9,12,4265,337,3928,1956-9-12,-3591
1956,9,13,4139,481,3658,1956-9-13,-3177
1956,9,14,4520,1099,3421,1956-9-14,-2322
1956,9,15,3885,934,2951,1956-9-15,-2017
1956,9,16,3473,698,2775,1956-9-16,-2077
1956,9,17,2948,1165,1783,1956-9-17,-618
1956,9,18,2192,1180,1012,1956-9-18,168
1956,9,19,2086,1135,951,1956-9-19,184
1956,9,20,2092,1239,853,1956-9-20,386
1956,9,21,1646,1021,625,1956-9-21,396
1956,9,22,1401,858,543,1956-9-22,315
1956,9,23,1545,730,815,1956-9-23,-85
1956,9,24,1568,619,949,1956-9-24,-330
1956,9,25,1941,907,1034,1956-9-25,-127
1956,9,26,2109,890,1219,1956-9-26,-329
1956,9,27,1959,862,1097,1956-9-27,-235
1956,9,28,1492,636,856,1956-9-28,-220
1956,9,29,1347,548,799,1956-9-29,-251
1956,9,30,1556,692,864,1956-9-30,-172
1956,10,1,2315,1152,1163,1956-10-1,-11
1956,10,2,3138,1895,1243,1956-10-2,652
1956,10,3,3731,2152,1579,1956-10-3,573
1956,10,4,3680,1690,1990,1956-10-4,-300
1956,10,5,3277,1740,1537,1956-10-5,203
1956,10,6,2695,1948,747,1956-10-6,1201
1956,10,7,2529,1900,629,1956-10-7,1271
1956,10,8,2872,1935,937,1956-10-8,998
1956,10,9,3023,1691,1332,1956-10-9,359
1956,10,10,3506,1942,1564,1956-10-10,378
1956,10,11,3427,2132,1295,1956-10-11,837
1956,10,12,3537,2240,1297,1956-10-12,943
1956,10,13,2723,1331,1392,1956-10-13,-61
1956,10,14,2001,638,1363,1956-10-14,-725
1956,10,15,1156,480,676,1956-10-15,-196
1956,10,16,1022,488,534,1956-10-16,-46
1956,10,17,1041,479,562,1956-10-17,-83
1956,10,18,1351,956,395,1956-10-18,561
1956,10,19,1437,754,683,1956-10-19,71
1956,10,20,1575,687,888,1956-10-20,-201
1956,10,21,1646,884,762,1956-10-21,122
1956,10,22,1735,899,836,1956-10-22,63
1956,10,23,2056,681,1375,1956-10-23,-694
1956,10,24,2196,682,1514,1956-10-24,-832
1956,10,25,1929,519,1410,1956-10-25,-891
1956,10,26,1631,303,1328,1956-10-26,-1025
1956,10,27,1657,252,1405,1956-10-27,-1153
1956,10,28,2437,727,1710,1956-10-28,-983
1956,10,29,2772,815,1957,1956-10-29,-1142
1956,10,30,2913,825,2088,1956-10-30,-1263
1956,10,31,2939,917,2022,1956-10-31,-1105
1956,11,1,3044,745,2299,1956-11-1,-1554
1956,11,2,2837,885,1952,1956-11-2,-1067
1956,11,3,3169,1240,1929,1956-11-3,-689
1956,11,4,3581,1669,1912,1956-11-4,-243
1956,11,5,5491,1774,3717,1956-11-5,-1943
1956,11,6,5554,1701,3853,1956-11-6,-2152
1956,11,7,6344,2256,4088,1956-11-7,-1832
1956,11,8,6305,2464,3841,1956-11-8,-1377
1956,11,9,5364,1934,3430,1956-11-9,-1496
1956,11,10,4840,1544,3296,1956-11-10,-1752
1956,11,11,4344,1154,3190,1956-11-11,-2036
1956,11,12,4500,1018,3482,1956-11-12,-2464
1956,11,13,3719,937,2782,1956-11-13,-1845
1956,11,14,4137,910,3227,1956-11-14,-2317
1956,11,15,5231,1127,4104,1956-11-15,-2977
1956,11,16,4844,1111,3733,1956-11-16,-2622
1956,11,17,4993,856,4137,1956-11-17,-3281
1956,11,18,4933,829,4104,1956-11-18,-3275
1956,11,19,4363,598,3765,1956-11-19,-3167
1956,11,20,4066,461,3605,1956-11-20,-3144
1956,11,21,3962,405,3557,1956-11-21,-3152
1956,11,22,3333,509,2824,1956-11-22,-2315
1956,11,23,2194,464,1730,1956-11-23,-1266
1956,11,24,1781,355,1426,1956-11-24,-1071
1956,11,25,2139,348,1791,1956-11-25,-1443
1956,11,26,2161,480,1681,1956-11-26,-1201
1956,11,27,1753,514,1239,1956-11-27,-725
1956,11,28,1873,544,1329,1956-11-28,-785
1956,11,29,1963,793,1170,1956-11-29,-377
1956,11,30,1882,1214,668,1956-11-30,546
1956,12,1,1489,1150,339,1956-12-1,811
1956,12,2,1745,1210,535,1956-12-2,675
1956,12,3,2265,965,1300,1956-12-3,-335
1956,12,4,3143,937,2206,1956-12-4,-1269
1956,12,5,3597,939,2658,1956-12-5,-1719
1956,12,6,3812,1059,2753,1956-12-6,-1694
1956,12,7,3457,968,2489,1956-12-7,-1521
1956,12,8,2920,692,2228,1956-12-8,-1536
1956,12,9,3288,683,2605,1956-12-9,-1922
1956,12,10,3223,586,2637,1956-12-10,-2051
1956,12,11,3859,797,3062,1956-12-11,-2265
1956,12,12,3840,763,3077,1956-12-12,-2314
1956,12,13,3466,346,3120,1956-12-13,-2774
1956,12,14,3217,318,2899,1956-12-14,-2581
1956,12,15,4035,1171,2864,1956-12-15,-1693
1956,12,16,3757,1491,2266,1956-12-16,-775
1956,12,17,3300,1634,1666,1956-12-17,-32
1956,12,18,3572,1775,1797,1956-12-18,-22
1956,12,19,3228,1881,1347,1956-12-19,534
1956,12,20,3044,1887,1157,1956-12-20,730
1956,12,21,3954,2666,1288,1956-12-21,1378
1956,12,22,4026,2716,1310,1956-12-22,1406
1956,12,23,4369,3006,1363,1956-12-23,1643
1956,12,24,3943,2758,1185,1956-12-24,1573
1956,12,25,3812,2308,1504,1956-12-25,804
1956,12,26,4150,1994,2156,1956-12-26,-162
1956,12,27,4134,1751,2383,1956-12-27,-632
1956,12,28,3749,1986,1763,1956-12-28,223
1956,12,29,3275,2155,1120,1956-12-29,1035
1956,12,30,2822,2021,801,1956-12-30,1220
1956,12,31,3207,2118,1089,1956-12-31,1029
1957,1,1,2492,2000,492,1957-1-1,1508
1957,1,2,3060,2395,665,1957-1-2,1730
1957,1,3,4484,2674,1810,1957-1-3,864
1957,1,4,4424,2729,1695,1957-1-4,1034
1957,1,5,3862,2156,1706,1957-1-5,450
1957,1,6,4460,2608,1852,1957-1-6,756
1957,1,7,3607,2116,1491,1957-1-7,625
1957,1,8,3247,1763,1484,1957-1-8,279
1957,1,9,1911,679,1232,1957-1-9,-553
1957,1,10,1185,30,1155,1957-1-10,-1125
1957,1,11,1460,321,1139,1957-1-11,-818
1957,1,12,1618,263,1355,1957-1-12,-1092
1957,1,13,1401,225,1176,1957-1-13,-951
1957,1,14,1107,213,894,1957-1-14,-681
1957,1,15,847,209,638,1957-1-15,-429
1957,1,16,1317,672,645,1957-1-16,27
1957,1,17,1644,883,761,1957-1-17,122
1957,1,18,2266,1159,1107,1957-1-18,52
1957,1,19,2440,1110,1330,1957-1-19,-220
1957,1,20,2425,1051,1374,1957-1-20,-323
1957,1,21,2437,1172,1265,1957-1-21,-93
1957,1,22,2438,1340,1098,1957-1-22,242
1957,1,23,2840,1473,1367,1957-1-23,106
1957,1,24,2636,1485,1151,1957-1-24,334
1957,1,25,2898,1989,909,1957-1-25,1080
1957,1,26,3170,2424,746,1957-1-26,1678
1957,1,27,2354,1912,442,1957-1-27,1470
1957,1,28,1073,736,337,1957-1-28,399
1957,1,29,1247,848,399,1957-1-29,449
1957,1,30,964,546,418,1957-1-30,128
1957,1,31,858,435,423,1957-1-31,12
1957,2,1,730,370,360,1957-2-1,10
1957,2,2,785,380,405,1957-2-2,-25
1957,2,3,708,200,508,1957-2-3,-308
1957,2,4,1143,193,950,1957-2-4,-757
1957,2,5,1389,158,1231,1957-2-5,-1073
1957,2,6,1676,180,1496,1957-2-6,-1316
1957,2,7,1752,235,1517,1957-2-7,-1282
1957,2,8,1920,267,1653,1957-2-8,-1386
1957,2,9,1736,183,1553,1957-2-9,-1370
1957,2,10,1466,109,1357,1957-2-10,-1248
1957,2,11,1206,65,1141,1957-2-11,-1076
1957,2,12,1354,188,1166,1957-2-12,-978
1957,2,13,1311,211,1100,1957-2-13,-889
1957,2,14,1524,317,1207,1957-2-14,-890
1957,2,15,1460,344,1116,1957-2-15,-772
1957,2,16,1479,258,1221,1957-2-16,-963
1957,2,17,1027,164,863,1957-2-17,-699
1957,2,18,1466,132,1334,1957-2-18,-1202
1957,2,19,1237,133,1104,1957-2-19,-971
1957,2,20,1006,155,851,1957-2-20,-696
1957,2,21,1138,353,785,1957-2-21,-432
1957,2,22,1415,795,620,1957-2-22,175
1957,2,23,1805,1108,697,1957-2-23,411
1957,2,24,2090,1414,676,1957-2-24,738
1957,2,25,2136,1336,800,1957-2-25,536
1957,2,26,1864,1319,545,1957-2-26,774
1957,2,27,1985,1335,650,1957-2-27,685
1957,2,28,1920,1369,551,1957-2-28,818
1957,3,1,2200,1517,683,1957-3-1,834
1957,3,2,2621,1865,756,1957-3-2,1109
1957,3,3,1890,1285,605,1957-3-3,680
1957,3,4,1652,1049,603,1957-3-4,446
1957,3,5,1347,892,455,1957-3-5,437
1957,3,6,984,369,615,1957-3-6,-246
1957,3,7,1392,204,1188,1957-3-7,-984
1957,3,8,1190,208,982,1957-3-8,-774
1957,3,9,1350,124,1226,1957-3-9,-1102
1957,3,10,1429,103,1326,1957-3-10,-1223
1957,3,11,1445,115,1330,1957-3-11,-1215
1957,3,12,1801,300,1501,1957-3-12,-1201
1957,3,13,1590,324,1266,1957-3-13,-942
1957,3,14,1144,210,934,1957-3-14,-724
1957,3,15,1271,211,1060,1957-3-15,-849
1957,3,16,1817,508,1309,1957-3-16,-801
1957,3,17,1922,445,1477,1957-3-17,-1032
1957,3,18,1827,324,1503,1957-3-18,-1179
1957,3,19,1540,226,1314,1957-3-19,-1088
1957,3,20,2398,181,2217,1957-3-20,-2036
1957,3,21,2647,261,2386,1957-3-21,-2125
1957,3,22,2666,574,2092,1957-3-22,-1518
1957,3,23,2671,846,1825,1957-3-23,-979
1957,3,24,2081,602,1479,1957-3-24,-877
1957,3,25,1942,488,1454,1957-3-25,-966
1957,3,26,1794,459,1335,1957-3-26,-876
1957,3,27,1769,414,1355,1957-3-27,-941
1957,3,28,1817,691,1126,1957-3-28,-435
1957,3,29,1920,923,997,1957-3-29,-74
1957,3,30,2056,983,1073,1957-3-30,-90
1957,3,31,2067,1158,909,1957-3-31,249
1957,4,1,2056,720,1336,1957-4-1,-616
1957,4,2,1751,560,1191,1957-4-2,-631
1957,4,3,1687,561,1126,1957-4-3,-565
1957,4,4,2129,537,1592,1957-4-4,-1055
1957,4,5,1284,401,883,1957-4-5,-482
1957,4,6,1364,407,957,1957-4-6,-550
1957,4,7,1371,237,1134,1957-4-7,-897
1957,4,8,2087,724,1363,1957-4-8,-639
1957,4,9,2671,1410,1261,1957-4-9,149
1957,4,10,2493,1251,1242,1957-4-10,9
1957,4,11,2181,1160,1021,1957-4-11,139
1957,4,12,1644,707,937,1957-4-12,-230
1957,4,13,1219,342,877,1957-4-13,-535
1957,4,14,1299,174,1125,1957-4-14,-951
1957,4,15,1475,308,1167,1957-4-15,-859
1957,4,16,2177,324,1853,1957-4-16,-1529
1957,4,17,3406,1357,2049,1957-4-17,-692
1957,4,18,3138,1185,1953,1957-4-18,-768
1957,4,19,2059,964,1095,1957-4-19,-131
1957,4,20,2238,927,1311,1957-4-20,-384
1957,4,21,2016,711,1305,1957-4-21,-594
1957,4,22,2068,599,1469,1957-4-22,-870
1957,4,23,2091,402,1689,1957-4-23,-1287
1957,4,24,2929,297,2632,1957-4-24,-2335
1957,4,25,2812,294,2518,1957-4-25,-2224
1957,4,26,2498,334,2164,1957-4-26,-1830
1957,4,27,2485,230,2255,1957-4-27,-2025
1957,4,28,2093,233,1860,1957-4-28,-1627
1957,4,29,1807,231,1576,1957-4-29,-1345
1957,4,30,1393,155,1238,1957-4-30,-1083
1957,5,1,1086,270,816,1957-5-1,-546
1957,5,2,1262,489,773,1957-5-2,-284
1957,5,3,1279,322,957,1957-5-3,-635
1957,5,4,1131,187,944,1957-5-4,-757
1957,5,5,1934,400,1534,1957-5-5,-1134
1957,5,6,2559,1174,1385,1957-5-6,-211
1957,5,7,2672,1516,1156,1957-5-7,360
1957,5,8,3225,1651,1574,1957-5-8,77
1957,5,9,2936,1732,1204,1957-5-9,528
1957,5,10,3184,2019,1165,1957-5-10,854
1957,5,11,3331,1705,1626,1957-5-11,79
1957,5,12,3984,1908,2076,1957-5-12,-168
1957,5,13,4323,2009,2314,1957-5-13,-305
1957,5,14,3997,1671,2326,1957-5-14,-655
1957,5,15,3912,1840,2072,1957-5-15,-232
1957,5,16,3944,1716,2228,1957-5-16,-512
1957,5,17,2550,981,1569,1957-5-17,-588
1957,5,18,2496,731,1765,1957-5-18,-1034
1957,5,19,1764,727,1037,1957-5-19,-310
1957,5,20,1961,937,1024,1957-5-20,-87
1957,5,21,2501,1337,1164,1957-5-21,173
1957,5,22,2206,989,1217,1957-5-22,-228
1957,5,23,2337,948,1389,1957-5-23,-441
1957,5,24,2452,1021,1431,1957-5-24,-410
1957,5,25,2219,1194,1025,1957-5-25,169
1957,5,26,2253,870,1383,1957-5-26,-513
1957,5,27,2003,739,1264,1957-5-27,-525
1957,5,28,1946,672,1274,1957-5-28,-602
1957,5,29,2386,665,1721,1957-5-29,-1056
1957,5,30,2871,1079,1792,1957-5-30,-713
1957,5,31,2926,1282,1644,1957-5-31,-362
1957,6,1,2964,952,2012,1957-6-1,-1060
1957,6,2,3755,933,2822,1957-6-2,-1889
1957,6,3,3250,393,2857,1957-6-3,-2464
1957,6,4,2854,397,2457,1957-6-4,-2060
1957,6,5,2628,560,2068,1957-6-5,-1508
1957,6,6,2723,936,1787,1957-6-6,-851
1957,6,7,2268,926,1342,1957-6-7,-416
1957,6,8,3144,2009,1135,1957-6-8,874
1957,6,9,3536,2471,1065,1957-6-9,1406
1957,6,10,3326,1761,1565,1957-6-10,196
1957,6,11,2883,1589,1294,1957-6-11,295
1957,6,12,3141,1777,1364,1957-6-12,413
1957,6,13,3289,1644,1645,1957-6-13,-1
1957,6,14,2284,1281,1003,1957-6-14,278
1957,6,15,2983,1592,1391,1957-6-15,201
1957,6,16,5567,3637,1930,1957-6-16,1707
1957,6,17,5275,3351,1924,1957-6-17,1427
1957,6,18,5520,3249,2271,1957-6-18,978
1957,6,19,6709,3021,3688,1957-6-19,-667
1957,6,20,6860,2923,3937,1957-6-20,-1014
1957,6,21,6309,2217,4092,1957-6-21,-1875
1957,6,22,6842,2305,4537,1957-6-22,-2232
1957,6,23,6158,1882,4276,1957-6-23,-2394
1957,6,24,6750,2315,4435,1957-6-24,-2120
1957,6,25,5744,2069,3675,1957-6-25,-1606
1957,6,26,6236,1926,4310,1957-6-26,-2384
1957,6,27,5316,1892,3424,1957-6-27,-1532
1957,6,28,4779,1594,3185,1957-6-28,-1591
1957,6,29,6749,1271,5478,1957-6-29,-4207
1957,6,30,6232,1091,5141,1957-6-30,-4050
1957,7,1,5116,1563,3553,1957-7-1,-1990
1957,7,2,4403,1610,2793,1957-7-2,-1183
1957,7,3,3983,1466,2517,1957-7-3,-1051
1957,7,4,4797,1630,3167,1957-7-4,-1537
1957,7,5,4212,1303,2909,1957-7-5,-1606
1957,7,6,3569,1028,2541,1957-7-6,-1513
1957,7,7,3427,923,2504,1957-7-7,-1581
1957,7,8,2670,702,1968,1957-7-8,-1266
1957,7,9,2010,731,1279,1957-7-9,-548
1957,7,10,1824,674,1150,1957-7-10,-476
1957,7,11,1725,342,1383,1957-7-11,-1041
1957,7,12,1134,118,1016,1957-7-12,-898
1957,7,13,1486,365,1121,1957-7-13,-756
1957,7,14,2088,932,1156,1957-7-14,-224
1957,7,15,2442,1242,1200,1957-7-15,42
1957,7,16,3344,1766,1578,1957-7-16,188
1957,7,17,3050,1328,1722,1957-7-17,-394
1957,7,18,3100,1299,1801,1957-7-18,-502
1957,7,19,3087,1453,1634,1957-7-19,-181
1957,7,20,4095,2574,1521,1957-7-20,1053
1957,7,21,3847,2786,1061,1957-7-21,1725
1957,7,22,3641,2577,1064,1957-7-22,1513
1957,7,23,3798,2252,1546,1957-7-23,706
1957,7,24,3635,2377,1258,1957-7-24,1119
1957,7,25,3606,2680,926,1957-7-25,1754
1957,7,26,2808,1851,957,1957-7-26,894
1957,7,27,2872,1434,1438,1957-7-27,-4
1957,7,28,3070,1413,1657,1957-7-28,-244
1957,7,29,2968,1622,1346,1957-7-29,276
1957,7,30,2910,1594,1316,1957-7-30,278
1957,7,31,2942,1507,1435,1957-7-31,72
1957,8,1,2957,1600,1357,1957-8-1,243
1957,8,2,2281,840,1441,1957-8-2,-601
1957,8,3,2730,928,1802,1957-8-3,-874
1957,8,4,2713,1007,1706,1957-8-4,-699
1957,8,5,2463,833,1630,1957-8-5,-797
1957,8,6,2432,793,1639,1957-8-6,-846
1957,8,7,2322,909,1413,1957-8-7,-504
1957,8,8,2391,1367,1024,1957-8-8,343
1957,8,9,1398,1109,289,1957-8-9,820
1957,8,10,1133,880,253,1957-8-10,627
1957,8,11,1013,829,184,1957-8-11,645
1957,8,12,1078,913,165,1957-8-12,748
1957,8,13,1290,748,542,1957-8-13,206
1957,8,14,1347,861,486,1957-8-14,375
1957,8,15,1248,732,516,1957-8-15,216
1957,8,16,1961,1204,757,1957-8-16,447
1957,8,17,2968,1748,1220,1957-8-17,528
1957,8,18,2017,1460,557,1957-8-18,903
1957,8,19,1953,1492,461,1957-8-19,1031
1957,8,20,1813,1340,473,1957-8-20,867
1957,8,21,1499,1126,373,1957-8-21,753
1957,8,22,1566,917,649,1957-8-22,268
1957,8,23,1641,1027,614,1957-8-23,413
1957,8,24,1441,889,552,1957-8-24,337
1957,8,25,3417,2162,1255,1957-8-25,907
1957,8,26,3875,2576,1299,1957-8-26,1277
1957,8,27,3857,2500,1357,1957-8-27,1143
1957,8,28,3933,2380,1553,1957-8-28,827
1957,8,29,4246,2678,1568,1957-8-29,1110
1957,8,30,3946,2615,1331,1957-8-30,1284
1957,8,31,4125,2516,1609,1957-8-31,907
1957,9,1,4606,3199,1407,1957-9-1,1792
1957,9,2,4266,3383,883,1957-9-2,2500
1957,9,3,3957,2980,977,1957-9-3,2003
1957,9,4,3924,2991,933,1957-9-4,2058
1957,9,5,4872,3905,967,1957-9-5,2938
1957,9,6,4358,3405,953,1957-9-6,2452
1957,9,7,2588,1865,723,1957-9-7,1142
1957,9,8,2969,1379,1590,1957-9-8,-211
1957,9,9,3604,1228,2376,1957-9-9,-1148
1957,9,10,4279,1086,3193,1957-9-10,-2107
1957,9,11,5056,1022,4034,1957-9-11,-3012
1957,9,12,5162,1090,4072,1957-9-12,-2982
1957,9,13,3970,1293,2677,1957-9-13,-1384
1957,9,14,5241,2907,2334,1957-9-14,573
1957,9,15,5214,3442,1772,1957-9-15,1670
1957,9,16,5682,3815,1867,1957-9-16,1948
1957,9,17,4244,3226,1018,1957-9-17,2208
1957,9,18,4392,3778,614,1957-9-18,3164
1957,9,19,4613,3607,1006,1957-9-19,2601
1957,9,20,4869,4079,790,1957-9-20,3289
1957,9,21,5541,5173,368,1957-9-21,4805
1957,9,22,5471,4909,562,1957-9-22,4347
1957,9,23,6314,5607,707,1957-9-23,4900
1957,9,24,6769,5697,1072,1957-9-24,4625
1957,9,25,5537,5018,519,1957-9-25,4499
1957,9,26,3747,3336,411,1957-9-26,2925
1957,9,27,3788,3366,422,1957-9-27,2944
1957,9,28,3610,2683,927,1957-9-28,1756
1957,9,29,3960,2868,1092,1957-9-29,1776
1957,9,30,4018,2344,1674,1957-9-30,670
1957,10,1,4052,2489,1563,1957-10-1,926
1957,10,2,4297,2480,1817,1957-10-2,663
1957,10,3,4543,2399,2144,1957-10-3,255
1957,10,4,3654,1531,2123,1957-10-4,-592
1957,10,5,3751,1674,2077,1957-10-5,-403
1957,10,6,3637,1680,1957,1957-10-6,-277
1957,10,7,3808,1768,2040,1957-10-7,-272
1957,10,8,4195,2403,1792,1957-10-8,611
1957,10,9,3805,2213,1592,1957-10-9,621
1957,10,10,4086,2347,1739,1957-10-10,608
1957,10,11,4589,2553,2036,1957-10-11,517
1957,10,12,5884,2517,3367,1957-10-12,-850
1957,10,13,6257,2450,3807,1957-10-13,-1357
1957,10,14,5200,1296,3904,1957-10-14,-2608
1957,10,15,4616,1065,3551,1957-10-15,-2486
1957,10,16,5118,1001,4117,1957-10-16,-3116
1957,10,17,4552,827,3725,1957-10-17,-2898
1957,10,18,3953,434,3519,1957-10-18,-3085
1957,10,19,3921,811,3110,1957-10-19,-2299
1957,10,20,5039,1139,3900,1957-10-20,-2761
1957,10,21,4658,1222,3436,1957-10-21,-2214
1957,10,22,4544,1385,3159,1957-10-22,-1774
1957,10,23,4968,2058,2910,1957-10-23,-852
1957,10,24,4105,2136,1969,1957-10-24,167
1957,10,25,2155,1144,1011,1957-10-25,133
1957,10,26,3573,1379,2194,1957-10-26,-815
1957,10,27,4362,1793,2569,1957-10-27,-776
1957,10,28,4711,2021,2690,1957-10-28,-669
1957,10,29,6024,3152,2872,1957-10-29,280
1957,10,30,5314,2925,2389,1957-10-30,536
1957,10,31,5313,2204,3109,1957-10-31,-905
1957,11,1,5517,2758,2759,1957-11-1,-1
1957,11,2,4924,2576,2348,1957-11-2,228
1957,11,3,3458,1554,1904,1957-11-3,-350
1957,11,4,3668,1835,1833,1957-11-4,2
1957,11,5,3091,1661,1430,1957-11-5,231
1957,11,6,3633,2271,1362,1957-11-6,909
1957,11,7,2225,1388,837,1957-11-7,551
1957,11,8,2029,1126,903,1957-11-8,223
1957,11,9,2096,1044,1052,1957-11-9,-8
1957,11,10,2203,993,1210,1957-11-10,-217
1957,11,11,2706,976,1730,1957-11-11,-754
1957,11,12,2248,742,1506,1957-11-12,-764
1957,11,13,1758,817,941,1957-11-13,-124
1957,11,14,2136,1172,964,1957-11-14,208
1957,11,15,2030,1372,658,1957-11-15,714
1957,11,16,2132,1559,573,1957-11-16,986
1957,11,17,2519,1989,530,1957-11-17,1459
1957,11,18,3065,2491,574,1957-11-18,1917
1957,11,19,2457,1941,516,1957-11-19,1425
1957,11,20,2702,1687,1015,1957-11-20,672
1957,11,21,2913,1418,1495,1957-11-21,-77
1957,11,22,3903,1870,2033,1957-11-22,-163
1957,11,23,4639,2241,2398,1957-11-23,-157
1957,11,24,3161,1427,1734,1957-11-24,-307
1957,11,25,2733,1085,1648,1957-11-25,-563
1957,11,26,2393,574,1819,1957-11-26,-1245
1957,11,27,3071,282,2789,1957-11-27,-2507
1957,11,28,3768,325,3443,1957-11-28,-3118
1957,11,29,3908,317,3591,1957-11-29,-3274
1957,11,30,3262,351,2911,1957-11-30,-2560
1957,12,1,3944,535,3409,1957-12-1,-2874
1957,12,2,3469,542,2927,1957-12-2,-2385
1957,12,3,3215,763,2452,1957-12-3,-1689
1957,12,4,4334,1352,2982,1957-12-4,-1630
1957,12,5,3794,1306,2488,1957-12-5,-1182
1957,12,6,3617,1392,2225,1957-12-6,-833
1957,12,7,2744,805,1939,1957-12-7,-1134
1957,12,8,2383,811,1572,1957-12-8,-761
1957,12,9,1779,711,1068,1957-12-9,-357
1957,12,10,1195,715,480,1957-12-10,235
1957,12,11,1162,728,434,1957-12-11,294
1957,12,12,1090,725,365,1957-12-12,360
1957,12,13,2086,801,1285,1957-12-13,-484
1957,12,14,2751,1383,1368,1957-12-14,15
1957,12,15,3025,1745,1280,1957-12-15,465
1957,12,16,3452,1972,1480,1957-12-16,492
1957,12,17,3180,1883,1297,1957-12-17,586
1957,12,18,4537,2866,1671,1957-12-18,1195
1957,12,19,6146,4235,1911,1957-12-19,2324
1957,12,20,6037,4115,1922,1957-12-20,2193
1957,12,21,7128,4513,2615,1957-12-21,1898
1957,12,22,7669,4742,2927,1957-12-22,1815
1957,12,23,7288,4452,2836,1957-12-23,1616
1957,12,24,7476,4295,3181,1957-12-24,1114
1957,12,25,7190,3954,3236,1957-12-25,718
1957,12,26,7380,4209,3171,1957-12-26,1038
1957,12,27,6427,3851,2576,1957-12-27,1275
1957,12,28,5464,3739,1725,1957-12-28,2014
1957,12,29,4561,3148,1413,1957-12-29,1735
1957,12,30,4301,2909,1392,1957-12-30,1517
1957,12,31,3549,2185,1364,1957-12-31,821
1958,1,1,3106,1692,1414,1958-1-1,278
1958,1,2,3329,1941,1388,1958-1-2,553
1958,1,3,2908,1736,1172,1958-1-3,564
1958,1,4,3028,1589,1439,1958-1-4,150
1958,1,5,3559,1522,2037,1958-1-5,-515
1958,1,6,2954,1599,1355,1958-1-6,244
1958,1,7,2297,1040,1257,1958-1-7,-217
1958,1,8,2543,971,1572,1958-1-8,-601
1958,1,9,2752,983,1769,1958-1-9,-786
1958,1,10,3234,1181,2053,1958-1-10,-872
1958,1,11,3453,1583,1870,1958-1-11,-287
1958,1,12,4095,2200,1895,1958-1-12,305
1958,1,13,4295,2464,1831,1958-1-13,633
1958,1,14,5395,2965,2430,1958-1-14,535
1958,1,15,3969,2242,1727,1958-1-15,515
1958,1,16,4728,2656,2072,1958-1-16,584
1958,1,17,4252,2435,1817,1958-1-17,618
1958,1,18,3291,2390,901,1958-1-18,1489
1958,1,19,3564,2567,997,1958-1-19,1570
1958,1,20,3094,2500,594,1958-1-20,1906
1958,1,21,2759,2086,673,1958-1-21,1413
1958,1,22,2875,2140,735,1958-1-22,1405
1958,1,23,2477,1615,862,1958-1-23,753
1958,1,24,2068,953,1115,1958-1-24,-162
1958,1,25,2118,723,1395,1958-1-25,-672
1958,1,26,2804,1310,1494,1958-1-26,-184
1958,1,27,2039,840,1199,1958-1-27,-359
1958,1,28,1808,652,1156,1958-1-28,-504
1958,1,29,1511,557,954,1958-1-29,-397
1958,1,30,1092,501,591,1958-1-30,-90
1958,1,31,1426,690,736,1958-1-31,-46
1958,2,1,1456,414,1042,1958-2-1,-628
1958,2,2,2265,409,1856,1958-2-2,-1447
1958,2,3,2456,450,2006,1958-2-3,-1556
1958,2,4,2822,408,2414,1958-2-4,-2006
1958,2,5,3076,662,2414,1958-2-5,-1752
1958,2,6,3078,708,2370,1958-2-6,-1662
1958,2,7,3455,935,2520,1958-2-7,-1585
1958,2,8,3330,935,2395,1958-2-8,-1460
1958,2,9,3341,820,2521,1958-2-9,-1701
1958,2,10,3057,728,2329,1958-2-10,-1601
1958,2,11,3033,1408,1625,1958-2-11,-217
1958,2,12,3348,2152,1196,1958-2-12,956
1958,2,13,3035,2084,951,1958-2-13,1133
1958,2,14,3156,2117,1039,1958-2-14,1078
1958,2,15,2396,2176,220,1958-2-15,1956
1958,2,16,2559,1849,710,1958-2-16,1139
1958,2,17,2562,1631,931,1958-2-17,700
1958,2,18,2782,1792,990,1958-2-18,802
1958,2,19,2227,1298,929,1958-2-19,369
1958,2,20,1316,367,949,1958-2-20,-582
1958,2,21,1256,212,1044,1958-2-21,-832
1958,2,22,1811,442,1369,1958-2-22,-927
1958,2,23,2138,514,1624,1958-2-23,-1110
1958,2,24,2255,432,1823,1958-2-24,-1391
1958,2,25,2696,343,2353,1958-2-25,-2010
1958,2,26,2706,431,2275,1958-2-26,-1844
1958,2,27,1925,327,1598,1958-2-27,-1271
1958,2,28,1768,291,1477,1958-2-28,-1186
1958,3,1,2973,140,2833,1958-3-1,-2693
1958,3,2,3026,150,2876,1958-3-2,-2726
1958,3,3,3255,382,2873,1958-3-3,-2491
1958,3,4,3293,590,2703,1958-3-4,-2113
1958,3,5,3873,984,2889,1958-3-5,-1905
1958,3,6,4704,1548,3156,1958-3-6,-1608
1958,3,7,5591,1724,3867,1958-3-7,-2143
1958,3,8,4028,2032,1996,1958-3-8,36
1958,3,9,3856,2600,1256,1958-3-9,1344
1958,3,10,3200,2321,879,1958-3-10,1442
1958,3,11,3345,2533,812,1958-3-11,1721
1958,3,12,3544,2827,717,1958-3-12,2110
1958,3,13,2961,2529,432,1958-3-13,2097
1958,3,14,3053,2862,191,1958-3-14,2671
1958,3,15,2801,2694,107,1958-3-15,2587
1958,3,16,2818,2604,214,1958-3-16,2390
1958,3,17,3289,3087,202,1958-3-17,2885
1958,3,18,3704,3546,158,1958-3-18,3388
1958,3,19,3049,2880,169,1958-3-19,2711
1958,3,20,3266,3126,140,1958-3-20,2986
1958,3,21,3896,3763,133,1958-3-21,3630
1958,3,22,4311,3311,1000,1958-3-22,2311
1958,3,23,5494,3086,2408,1958-3-23,678
1958,3,24,6005,2553,3452,1958-3-24,-899
1958,3,25,5913,2419,3494,1958-3-25,-1075
1958,3,26,6250,2139,4111,1958-3-26,-1972
1958,3,27,6218,1764,4454,1958-3-27,-2690
1958,3,28,6809,1696,5113,1958-3-28,-3417
1958,3,29,7241,2151,5090,1958-3-29,-2939
1958,3,30,7753,2399,5354,1958-3-30,-2955
1958,3,31,8046,2547,5499,1958-3-31,-2952
1958,4,1,7155,2202,4953,1958-4-1,-2751
1958,4,2,5939,1948,3991,1958-4-2,-2043
1958,4,3,5710,2430,3280,1958-4-3,-850
1958,4,4,5936,2903,3033,1958-4-4,-130
1958,4,5,5629,3537,2092,1958-4-5,1445
1958,4,6,5438,4128,1310,1958-4-6,2818
1958,4,7,4464,3364,1100,1958-4-7,2264
1958,4,8,4081,3080,1001,1958-4-8,2079
1958,4,9,3625,3180,445,1958-4-9,2735
1958,4,10,3441,2750,691,1958-4-10,2059
1958,4,11,2183,1935,248,1958-4-11,1687
1958,4,12,1515,1331,184,1958-4-12,1147
1958,4,13,1481,1360,121,1958-4-13,1239
1958,4,14,1060,728,332,1958-4-14,396
1958,4,15,1546,787,759,1958-4-15,28
1958,4,16,1657,434,1223,1958-4-16,-789
1958,4,17,1966,578,1388,1958-4-17,-810
1958,4,18,2268,779,1489,1958-4-18,-710
1958,4,19,2487,947,1540,1958-4-19,-593
1958,4,20,2857,1345,1512,1958-4-20,-167
1958,4,21,3287,1786,1501,1958-4-21,285
1958,4,22,3474,1596,1878,1958-4-22,-282
1958,4,23,3448,1267,2181,1958-4-23,-914
1958,4,24,2680,922,1758,1958-4-24,-836
1958,4,25,3544,1792,1752,1958-4-25,40
1958,4,26,3796,2179,1617,1958-4-26,562
1958,4,27,3327,2220,1107,1958-4-27,1113
1958,4,28,4487,2362,2125,1958-4-28,237
1958,4,29,5052,2323,2729,1958-4-29,-406
1958,4,30,4565,1798,2767,1958-4-30,-969
1958,5,1,5450,2866,2584,1958-5-1,282
1958,5,2,4736,2758,1978,1958-5-2,780
1958,5,3,5073,2794,2279,1958-5-3,515
1958,5,4,4887,2807,2080,1958-5-4,727
1958,5,5,4703,2627,2076,1958-5-5,551
1958,5,6,3224,2202,1022,1958-5-6,1180
1958,5,7,3539,2578,961,1958-5-7,1617
1958,5,8,2946,1651,1295,1958-5-8,356
1958,5,9,2229,1284,945,1958-5-9,339
1958,5,10,2566,1250,1316,1958-5-10,-66
1958,5,11,2450,1431,1019,1958-5-11,412
1958,5,12,2385,1250,1135,1958-5-12,115
1958,5,13,2328,996,1332,1958-5-13,-336
1958,5,14,1667,424,1243,1958-5-14,-819
1958,5,15,1564,311,1253,1958-5-15,-942
1958,5,16,1645,440,1205,1958-5-16,-765
1958,5,17,1833,819,1014,1958-5-17,-195
1958,5,18,2176,955,1221,1958-5-18,-266
1958,5,19,2414,1363,1051,1958-5-19,312
1958,5,20,2439,1348,1091,1958-5-20,257
1958,5,21,2557,1556,1001,1958-5-21,555
1958,5,22,2019,1289,730,1958-5-22,559
1958,5,23,2398,1252,1146,1958-5-23,106
1958,5,24,2671,1103,1568,1958-5-24,-465
1958,5,25,2214,916,1298,1958-5-25,-382
1958,5,26,1832,693,1139,1958-5-26,-446
1958,5,27,1982,943,1039,1958-5-27,-96
1958,5,28,1917,976,941,1958-5-28,35
1958,5,29,1693,968,725,1958-5-29,243
1958,5,30,2355,1475,880,1958-5-30,595
1958,5,31,2050,1409,641,1958-5-31,768
1958,6,1,2221,1557,664,1958-6-1,893
1958,6,2,1983,1447,536,1958-6-2,911
1958,6,3,2406,1780,626,1958-6-3,1154
1958,6,4,4452,3491,961,1958-6-4,2530
1958,6,5,4870,4035,835,1958-6-5,3200
1958,6,6,4360,3862,498,1958-6-6,3364
1958,6,7,3929,3609,320,1958-6-7,3289
1958,6,8,4340,3979,361,1958-6-8,3618
1958,6,9,3801,3366,435,1958-6-9,2931
1958,6,10,3608,3199,409,1958-6-10,2790
1958,6,11,2962,2648,314,1958-6-11,2334
1958,6,12,2464,1986,478,1958-6-12,1508
1958,6,13,2742,2175,567,1958-6-13,1608
1958,6,14,2426,1868,558,1958-6-14,1310
1958,6,15,2002,1580,422,1958-6-15,1158
1958,6,16,1348,1047,301,1958-6-16,746
1958,6,17,1498,1203,295,1958-6-17,908
1958,6,18,1339,1019,320,1958-6-18,699
1958,6,19,1668,1409,259,1958-6-19,1150
1958,6,20,1713,1239,474,1958-6-20,765
1958,6,21,1769,1250,519,1958-6-21,731
1958,6,22,1821,1169,652,1958-6-22,517
1958,6,23,2277,1224,1053,1958-6-23,171
1958,6,24,2622,1130,1492,1958-6-24,-362
1958,6,25,2558,1125,1433,1958-6-25,-308
1958,6,26,2565,1199,1366,1958-6-26,-167
1958,6,27,2031,931,1100,1958-6-27,-169
1958,6,28,2052,1004,1048,1958-6-28,-44
1958,6,29,2210,1203,1007,1958-6-29,196
1958,6,30,1972,1108,864,1958-6-30,244
1958,7,1,2246,1150,1096,1958-7-1,54
1958,7,2,2909,1475,1434,1958-7-2,41
1958,7,3,3180,1698,1482,1958-7-3,216
1958,7,4,3430,2070,1360,1958-7-4,710
1958,7,5,3741,2889,852,1958-7-5,2037
1958,7,6,3088,2278,810,1958-7-6,1468
1958,7,7,3130,2036,1094,1958-7-7,942
1958,7,8,3036,1728,1308,1958-7-8,420
1958,7,9,2995,1712,1283,1958-7-9,429
1958,7,10,3242,1480,1762,1958-7-10,-282
1958,7,11,3042,1001,2041,1958-7-11,-1040
1958,7,12,2689,619,2070,1958-7-12,-1451
1958,7,13,2195,520,1675,1958-7-13,-1155
1958,7,14,1855,1048,807,1958-7-14,241
1958,7,15,2129,1401,728,1958-7-15,673
1958,7,16,2270,1521,749,1958-7-16,772
1958,7,17,2524,1821,703,1958-7-17,1118
1958,7,18,2451,1714,737,1958-7-18,977
1958,7,19,3677,1756,1921,1958-7-19,-165
1958,7,20,3413,1810,1603,1958-7-20,207
1958,7,21,4155,1792,2363,1958-7-21,-571
1958,7,22,3488,1379,2109,1958-7-22,-730
1958,7,23,3213,1255,1958,1958-7-23,-703
1958,7,24,3417,1216,2201,1958-7-24,-985
1958,7,25,3201,1237,1964,1958-7-25,-727
1958,7,26,3127,1110,2017,1958-7-26,-907
1958,7,27,3971,1293,2678,1958-7-27,-1385
1958,7,28,4274,1299,2975,1958-7-28,-1676
1958,7,29,4676,1127,3549,1958-7-29,-2422
1958,7,30,5121,1678,3443,1958-7-30,-1765
1958,7,31,6378,2357,4021,1958-7-31,-1664
1958,8,1,4171,2813,1358,1958-8-1,1455
1958,8,2,3399,2405,994,1958-8-2,1411
1958,8,3,3064,2178,886,1958-8-3,1292
1958,8,4,2008,1336,672,1958-8-4,664
1958,8,5,2277,1516,761,1958-8-5,755
1958,8,6,3212,1796,1416,1958-8-6,380
1958,8,7,3134,1718,1416,1958-8-7,302
1958,8,8,3460,1858,1602,1958-8-8,256
1958,8,9,3910,1978,1932,1958-8-9,46
1958,8,10,3709,1471,2238,1958-8-10,-767
1958,8,11,3294,965,2329,1958-8-11,-1364
1958,8,12,2910,643,2267,1958-8-12,-1624
1958,8,13,2807,576,2231,1958-8-13,-1655
1958,8,14,2751,430,2321,1958-8-14,-1891
1958,8,15,2979,587,2392,1958-8-15,-1805
1958,8,16,3817,1251,2566,1958-8-16,-1315
1958,8,17,2937,1144,1793,1958-8-17,-649
1958,8,18,2901,1350,1551,1958-8-18,-201
1958,8,19,2034,1429,605,1958-8-19,824
1958,8,20,2067,1535,532,1958-8-20,1003
1958,8,21,2544,1902,642,1958-8-21,1260
1958,8,22,2440,1729,711,1958-8-22,1018
1958,8,23,2502,1644,858,1958-8-23,786
1958,8,24,2430,1502,928,1958-8-24,574
1958,8,25,2613,1642,971,1958-8-25,671
1958,8,26,2773,1791,982,1958-8-26,809
1958,8,27,3322,2167,1155,1958-8-27,1012
1958,8,28,2408,1369,1039,1958-8-28,330
1958,8,29,2480,887,1593,1958-8-29,-706
1958,8,30,2841,932,1909,1958-8-30,-977
1958,8,31,2679,990,1689,1958-8-31,-699
1958,9,1,2903,1055,1848,1958-9-1,-793
1958,9,2,4023,1577,2446,1958-9-2,-869
1958,9,3,4564,1876,2688,1958-9-3,-812
1958,9,4,4026,1686,2340,1958-9-4,-654
1958,9,5,3764,1599,2165,1958-9-5,-566
1958,9,6,2399,1130,1269,1958-9-6,-139
1958,9,7,2154,1111,1043,1958-9-7,68
1958,9,8,2118,1007,1111,1958-9-8,-104
1958,9,9,2059,1045,1014,1958-9-9,31
1958,9,10,2607,933,1674,1958-9-10,-741
1958,9,11,3527,1047,2480,1958-9-11,-1433
1958,9,12,4298,1240,3058,1958-9-12,-1818
1958,9,13,5050,1067,3983,1958-9-13,-2916
1958,9,14,4773,813,3960,1958-9-14,-3147
1958,9,15,3627,472,3155,1958-9-15,-2683
1958,9,16,4016,617,3399,1958-9-16,-2782
1958,9,17,3930,685,3245,1958-9-17,-2560
1958,9,18,3592,711,2881,1958-9-18,-2170
1958,9,19,2809,588,2221,1958-9-19,-1633
1958,9,20,2801,555,2246,1958-9-20,-1691
1958,9,21,3128,634,2494,1958-9-21,-1860
1958,9,22,3982,830,3152,1958-9-22,-2322
1958,9,23,3589,586,3003,1958-9-23,-2417
1958,9,24,3305,636,2669,1958-9-24,-2033
1958,9,25,3750,788,2962,1958-9-25,-2174
1958,9,26,2943,1062,1881,1958-9-26,-819
1958,9,27,2619,819,1800,1958-9-27,-981
1958,9,28,2763,978,1785,1958-9-28,-807
1958,9,29,2403,797,1606,1958-9-29,-809
1958,9,30,2696,982,1714,1958-9-30,-732
1958,10,1,2795,947,1848,1958-10-1,-901
1958,10,2,2698,1070,1628,1958-10-2,-558
1958,10,3,2403,1302,1101,1958-10-3,201
1958,10,4,2760,1631,1129,1958-10-4,502
1958,10,5,2077,1424,653,1958-10-5,771
1958,10,6,1171,942,229,1958-10-6,713
1958,10,7,1247,1032,215,1958-10-7,817
1958,10,8,758,615,143,1958-10-8,472
1958,10,9,774,681,93,1958-10-9,588
1958,10,10,764,568,196,1958-10-10,372
1958,10,11,2499,866,1633,1958-10-11,-767
1958,10,12,2451,754,1697,1958-10-12,-943
1958,10,13,2443,738,1705,1958-10-13,-967
1958,10,14,2457,501,1956,1958-10-14,-1455
1958,10,15,2769,358,2411,1958-10-15,-2053
1958,10,16,3192,449,2743,1958-10-16,-2294
1958,10,17,4580,854,3726,1958-10-17,-2872
1958,10,18,4692,967,3725,1958-10-18,-2758
1958,10,19,4459,943,3516,1958-10-19,-2573
1958,10,20,4171,900,3271,1958-10-20,-2371
1958,10,21,3744,846,2898,1958-10-21,-2052
1958,10,22,3353,744,2609,1958-10-22,-1865
1958,10,23,3260,671,2589,1958-10-23,-1918
1958,10,24,2333,378,1955,1958-10-24,-1577
1958,10,25,2236,314,1922,1958-10-25,-1608
1958,10,26,1666,223,1443,1958-10-26,-1220
1958,10,27,2101,186,1915,1958-10-27,-1729
1958,10,28,2964,1203,1761,1958-10-28,-558
1958,10,29,2612,1390,1222,1958-10-29,168
1958,10,30,2442,1481,961,1958-10-30,520
1958,10,31,2638,1306,1332,1958-10-31,-26
1958,11,1,2745,1262,1483,1958-11-1,-221
1958,11,2,2905,1164,1741,1958-11-2,-577
1958,11,3,2358,868,1490,1958-11-3,-622
1958,11,4,3126,902,2224,1958-11-4,-1322
1958,11,5,2615,790,1825,1958-11-5,-1035
1958,11,6,2303,838,1465,1958-11-6,-627
1958,11,7,1944,888,1056,1958-11-7,-168
1958,11,8,2079,996,1083,1958-11-8,-87
1958,11,9,1095,364,731,1958-11-9,-367
1958,11,10,503,241,262,1958-11-10,-21
1958,11,11,569,331,238,1958-11-11,93
1958,11,12,420,104,316,1958-11-12,-212
1958,11,13,290,50,240,1958-11-13,-190
1958,11,14,255,37,218,1958-11-14,-181
1958,11,15,322,180,142,1958-11-15,38
1958,11,16,413,208,205,1958-11-16,3
1958,11,17,326,288,38,1958-11-17,250
1958,11,18,860,286,574,1958-11-18,-288
1958,11,19,981,456,525,1958-11-19,-69
1958,11,20,1063,439,624,1958-11-20,-185
1958,11,21,1024,343,681,1958-11-21,-338
1958,11,22,1446,307,1139,1958-11-22,-832
1958,11,23,1674,321,1353,1958-11-23,-1032
1958,11,24,2351,457,1894,1958-11-24,-1437
1958,11,25,3077,869,2208,1958-11-25,-1339
1958,11,26,3290,962,2328,1958-11-26,-1366
1958,11,27,4021,1503,2518,1958-11-27,-1015
1958,11,28,3889,1494,2395,1958-11-28,-901
1958,11,29,3640,1409,2231,1958-11-29,-822
1958,11,30,4753,2217,2536,1958-11-30,-319
1958,12,1,4345,2133,2212,1958-12-1,-79
1958,12,2,3880,1355,2525,1958-12-2,-1170
1958,12,3,3515,1267,2248,1958-12-3,-981
1958,12,4,3395,1384,2011,1958-12-4,-627
1958,12,5,4650,1929,2721,1958-12-5,-792
1958,12,6,5027,1758,3269,1958-12-6,-1511
1958,12,7,4533,1798,2735,1958-12-7,-937
1958,12,8,4521,1355,3166,1958-12-8,-1811
1958,12,9,5172,1658,3514,1958-12-9,-1856
1958,12,10,4203,819,3384,1958-12-10,-2565
1958,12,11,4121,848,3273,1958-12-11,-2425
1958,12,12,4293,903,3390,1958-12-12,-2487
1958,12,13,3306,920,2386,1958-12-13,-1466
1958,12,14,3654,1143,2511,1958-12-14,-1368
1958,12,15,2557,840,1717,1958-12-15,-877
1958,12,16,2661,829,1832,1958-12-16,-1003
1958,12,17,2745,1092,1653,1958-12-17,-561
1958,12,18,1749,1076,673,1958-12-18,403
1958,12,19,1466,984,482,1958-12-19,502
1958,12,20,1254,765,489,1958-12-20,276
1958,12,21,2056,679,1377,1958-12-21,-698
1958,12,22,3083,1119,1964,1958-12-22,-845
1958,12,23,3350,1325,2025,1958-12-23,-700
1958,12,24,3070,1404,1666,1958-12-24,-262
1958,12,25,2532,1252,1280,1958-12-25,-28
1958,12,26,3389,1822,1567,1958-12-26,255
1958,12,27,2875,1622,1253,1958-12-27,369
1958,12,28,2554,1423,1131,1958-12-28,292
1958,12,29,2360,1247,1113,1958-12-29,134
1958,12,30,1763,833,930,1958-12-30,-97
1958,12,31,2107,818,1289,1958-12-31,-471
1959,1,1,3926,2202,1724,1959-1-1,478
1959,1,2,4640,2454,2186,1959-1-2,268
1959,1,3,5534,3003,2531,1959-1-3,472
1959,1,4,5125,2973,2152,1959-1-4,821
1959,1,5,6129,4306,1823,1959-1-5,2483
1959,1,6,5725,3957,1768,1959-1-6,2189
1959,1,7,5862,4485,1377,1959-1-7,3108
1959,1,8,5657,4577,1080,1959-1-8,3497
1959,1,9,5438,4367,1071,1959-1-9,3296
1959,1,10,4632,3747,885,1959-1-10,2862
1959,1,11,4683,3854,829,1959-1-11,3025
1959,1,12,4768,3892,876,1959-1-12,3016
1959,1,13,3692,3321,371,1959-1-13,2950
1959,1,14,2724,2659,65,1959-1-14,2594
1959,1,15,3343,3266,77,1959-1-15,3189
1959,1,16,3634,3349,285,1959-1-16,3064
1959,1,17,3890,3307,583,1959-1-17,2724
1959,1,18,3385,2972,413,1959-1-18,2559
1959,1,19,4541,4160,381,1959-1-19,3779
1959,1,20,6556,6058,498,1959-1-20,5560
1959,1,21,6872,6629,243,1959-1-21,6386
1959,1,22,6654,6416,238,1959-1-22,6178
1959,1,23,6873,6663,210,1959-1-23,6453
1959,1,24,6788,6703,85,1959-1-24,6618
1959,1,25,6568,6527,41,1959-1-25,6486
1959,1,26,5816,5588,228,1959-1-26,5360
1959,1,27,5835,5495,340,1959-1-27,5155
1959,1,28,4422,4045,377,1959-1-28,3668
1959,1,29,3450,2999,451,1959-1-29,2548
1959,1,30,2757,2296,461,1959-1-30,1835
1959,1,31,2042,1750,292,1959-1-31,1458
1959,2,1,1481,1176,305,1959-2-1,871
1959,2,2,1282,1081,201,1959-2-2,880
1959,2,3,1219,1124,95,1959-2-3,1029
1959,2,4,1674,1587,87,1959-2-4,1500
1959,2,5,1292,1263,29,1959-2-5,1234
1959,2,6,1045,1016,29,1959-2-6,987
1959,2,7,1404,1385,19,1959-2-7,1366
1959,2,8,1076,1076,0,1959-2-8,1076
1959,2,9,1164,1164,0,1959-2-9,1164
1959,2,10,1442,1442,0,1959-2-10,1442
1959,2,11,1623,1623,0,1959-2-11,1623
1959,2,12,1659,1656,3,1959-2-12,1653
1959,2,13,1883,1883,0,1959-2-13,1883
1959,2,14,1942,1942,0,1959-2-14,1942
1959,2,15,2836,2836,0,1959-2-15,2836
1959,2,16,3459,3459,0,1959-2-16,3459
1959,2,17,3373,3290,83,1959-2-17,3207
1959,2,18,4009,3862,147,1959-2-18,3715
1959,2,19,3720,3647,73,1959-2-19,3574
1959,2,20,3722,3643,79,1959-2-20,3564
1959,2,21,3614,3582,32,1959-2-21,3550
1959,2,22,3664,3524,140,1959-2-22,3384
1959,2,23,3485,3306,179,1959-2-23,3127
1959,2,24,3362,3148,214,1959-2-24,2934
1959,2,25,3667,3389,278,1959-2-25,3111
1959,2,26,3482,2964,518,1959-2-26,2446
1959,2,27,2329,1937,392,1959-2-27,1545
1959,2,28,2579,2033,546,1959-2-28,1487
1959,3,1,1870,1568,302,1959-3-1,1266
1959,3,2,2012,1647,365,1959-3-2,1282
1959,3,3,2404,1711,693,1959-3-3,1018
1959,3,4,2180,1346,834,1959-3-4,512
1959,3,5,1004,302,702,1959-3-5,-400
1959,3,6,1461,539,922,1959-3-6,-383
1959,3,7,1461,647,814,1959-3-7,-167
1959,3,8,1837,1032,805,1959-3-8,227
1959,3,9,2278,1230,1048,1959-3-9,182
1959,3,10,2041,1009,1032,1959-3-10,-23
1959,3,11,2032,1113,919,1959-3-11,194
1959,3,12,2914,2217,697,1959-3-12,1520
1959,3,13,3310,2674,636,1959-3-13,2038
1959,3,14,3480,3206,274,1959-3-14,2932
1959,3,15,4859,4660,199,1959-3-15,4461
1959,3,16,4818,4562,256,1959-3-16,4306
1959,3,17,4829,4628,201,1959-3-17,4427
1959,3,18,5299,5183,116,1959-3-18,5067
1959,3,19,5275,5234,41,1959-3-19,5193
1959,3,20,5881,5744,137,1959-3-20,5607
1959,3,21,6198,5957,241,1959-3-21,5716
1959,3,22,6571,6347,224,1959-3-22,6123
1959,3,23,6078,5888,190,1959-3-23,5698
1959,3,24,4473,4139,334,1959-3-24,3805
1959,3,25,4066,3454,612,1959-3-25,2842
1959,3,26,4480,3740,740,1959-3-26,3000
1959,3,27,4777,3940,837,1959-3-27,3103
1959,3,28,4501,3710,791,1959-3-28,2919
1959,3,29,4540,3796,744,1959-3-29,3052
1959,3,30,4548,3941,607,1959-3-30,3334
1959,3,31,4470,3932,538,1959-3-31,3394
1959,4,1,4326,3889,437,1959-4-1,3452
1959,4,2,4155,3744,411,1959-4-2,3333
1959,4,3,3423,3330,93,1959-4-3,3237
1959,4,4,2896,2870,26,1959-4-4,2844
1959,4,5,3046,3035,11,1959-4-5,3024
1959,4,6,1665,1542,123,1959-4-6,1419
1959,4,7,1638,1210,428,1959-4-7,782
1959,4,8,2967,1983,984,1959-4-8,999
1959,4,9,4116,2990,1126,1959-4-9,1864
1959,4,10,3962,2938,1024,1959-4-10,1914
1959,4,11,3692,2764,928,1959-4-11,1836
1959,4,12,3125,2233,892,1959-4-12,1341
1959,4,13,3137,2252,885,1959-4-13,1367
1959,4,14,2817,1863,954,1959-4-14,909
1959,4,15,2655,1674,981,1959-4-15,693
1959,4,16,1878,940,938,1959-4-16,2
1959,4,17,1629,914,715,1959-4-17,199
1959,4,18,1619,1123,496,1959-4-18,627
1959,4,19,1818,1454,364,1959-4-19,1090
1959,4,20,2132,1860,272,1959-4-20,1588
1959,4,21,1851,1802,49,1959-4-21,1753
1959,4,22,2240,2240,0,1959-4-22,2240
1959,4,23,2628,2476,152,1959-4-23,2324
1959,4,24,2242,1968,274,1959-4-24,1694
1959,4,25,2861,2660,201,1959-4-25,2459
1959,4,26,3069,2859,210,1959-4-26,2649
1959,4,27,2358,2131,227,1959-4-27,1904
1959,4,28,2490,1937,553,1959-4-28,1384
1959,4,29,2798,1852,946,1959-4-29,906
1959,4,30,1798,1350,448,1959-4-30,902
1959,5,1,1555,1146,409,1959-5-1,737
1959,5,2,1156,871,285,1959-5-2,586
1959,5,3,1243,965,278,1959-5-3,687
1959,5,4,1177,930,247,1959-5-4,683
1959,5,5,1573,813,760,1959-5-5,53
1959,5,6,1946,1012,934,1959-5-6,78
1959,5,7,2454,1600,854,1959-5-7,746
1959,5,8,3205,2518,687,1959-5-8,1831
1959,5,9,4901,3853,1048,1959-5-9,2805
1959,5,10,5079,3960,1119,1959-5-10,2841
1959,5,11,5678,4593,1085,1959-5-11,3508
1959,5,12,4975,4139,836,1959-5-12,3303
1959,5,13,4579,3825,754,1959-5-13,3071
1959,5,14,4372,3380,992,1959-5-14,2388
1959,5,15,3814,2777,1037,1959-5-15,1740
1959,5,16,3150,2686,464,1959-5-16,2222
1959,5,17,2676,2423,253,1959-5-17,2170
1959,5,18,2492,2213,279,1959-5-18,1934
1959,5,19,2166,1885,281,1959-5-19,1604
1959,5,20,1478,1385,93,1959-5-20,1292
1959,5,21,1924,1549,375,1959-5-21,1174
1959,5,22,2669,1895,774,1959-5-22,1121
1959,5,23,2053,1214,839,1959-5-23,375
1959,5,24,2603,1656,947,1959-5-24,709
1959,5,25,2943,1831,1112,1959-5-25,719
1959,5,26,2679,1730,949,1959-5-26,781
1959,5,27,3142,1903,1239,1959-5-27,664
1959,5,28,2062,860,1202,1959-5-28,-342
1959,5,29,2143,687,1456,1959-5-29,-769
1959,5,30,2294,858,1436,1959-5-30,-578
1959,5,31,2848,949,1899,1959-5-31,-950
1959,6,1,3341,1172,2169,1959-6-1,-997
1959,6,2,2468,840,1628,1959-6-2,-788
1959,6,3,2469,871,1598,1959-6-3,-727
1959,6,4,2225,877,1348,1959-6-4,-471
1959,6,5,2336,718,1618,1959-6-5,-900
1959,6,6,2816,959,1857,1959-6-6,-898
1959,6,7,2712,830,1882,1959-6-7,-1052
1959,6,8,3152,1104,2048,1959-6-8,-944
1959,6,9,3242,1013,2229,1959-6-9,-1216
1959,6,10,3502,1414,2088,1959-6-10,-674
1959,6,11,3014,2131,883,1959-6-11,1248
1959,6,12,2964,2254,710,1959-6-12,1544
1959,6,13,2995,2267,728,1959-6-13,1539
1959,6,14,2830,2048,782,1959-6-14,1266
1959,6,15,2574,1912,662,1959-6-15,1250
1959,6,16,2833,2569,264,1959-6-16,2305
1959,6,17,3894,3731,163,1959-6-17,3568
1959,6,18,3863,3689,174,1959-6-18,3515
1959,6,19,3666,3459,207,1959-6-19,3252
1959,6,20,3118,3074,44,1959-6-20,3030
1959,6,21,3281,3218,63,1959-6-21,3155
1959,6,22,3720,3523,197,1959-6-22,3326
1959,6,23,3632,3157,475,1959-6-23,2682
1959,6,24,3516,3067,449,1959-6-24,2618
1959,6,25,3621,3088,533,1959-6-25,2555
1959,6,26,3518,2986,532,1959-6-26,2454
1959,6,27,3822,3307,515,1959-6-27,2792
1959,6,28,3162,2888,274,1959-6-28,2614
1959,6,29,2143,1853,290,1959-6-29,1563
1959,6,30,1999,1608,391,1959-6-30,1217
1959,7,1,2002,1441,561,1959-7-1,880
1959,7,2,1692,1217,475,1959-7-2,742
1959,7,3,1437,1125,312,1959-7-3,813
1959,7,4,1351,1237,114,1959-7-4,1123
1959,7,5,1722,1601,121,1959-7-5,1480
1959,7,6,1764,1670,94,1959-7-6,1576
1959,7,7,2083,2009,74,1959-7-7,1935
1959,7,8,3189,3108,81,1959-7-8,3027
1959,7,9,3384,3344,40,1959-7-9,3304
1959,7,10,2988,2988,0,1959-7-10,2988
1959,7,11,2022,1790,232,1959-7-11,1558
1959,7,12,2981,2358,623,1959-7-12,1735
1959,7,13,3950,3181,769,1959-7-13,2412
1959,7,14,3556,2935,621,1959-7-14,2314
1959,7,15,3632,3131,501,1959-7-15,2630
1959,7,16,4015,3588,427,1959-7-16,3161
1959,7,17,3872,3575,297,1959-7-17,3278
1959,7,18,3701,3701,0,1959-7-18,3701
1959,7,19,3264,3208,56,1959-7-19,3152
1959,7,20,2969,2917,52,1959-7-20,2865
1959,7,21,1780,1764,16,1959-7-21,1748
1959,7,22,1404,1321,83,1959-7-22,1238
1959,7,23,1503,1384,119,1959-7-23,1265
1959,7,24,1664,1557,107,1959-7-24,1450
1959,7,25,2399,2270,129,1959-7-25,2141
1959,7,26,3203,3073,130,1959-7-26,2943
1959,7,27,3259,2828,431,1959-7-27,2397
1959,7,28,3258,2711,547,1959-7-28,2164
1959,7,29,3031,2567,464,1959-7-29,2103
1959,7,30,3235,2723,512,1959-7-30,2211
1959,7,31,2919,2891,28,1959-7-31,2863
1959,8,1,2873,2839,34,1959-8-1,2805
1959,8,2,3242,3023,219,1959-8-2,2804
1959,8,3,3595,2937,658,1959-8-3,2279
1959,8,4,3536,3010,526,1959-8-4,2484
1959,8,5,3537,3009,528,1959-8-5,2481
1959,8,6,3889,3255,634,1959-8-6,2621
1959,8,7,2354,1772,582,1959-8-7,1190
1959,8,8,2083,1550,533,1959-8-8,1017
1959,8,9,2252,1777,475,1959-8-9,1302
1959,8,10,2287,1916,371,1959-8-10,1545
1959,8,11,2675,2265,410,1959-8-11,1855
1959,8,12,2583,2222,361,1959-8-12,1861
1959,8,13,2024,1700,324,1959-8-13,1376
1959,8,14,2328,2036,292,1959-8-14,1744
1959,8,15,2256,2031,225,1959-8-15,1806
1959,8,16,2635,2411,224,1959-8-16,2187
1959,8,17,2748,2573,175,1959-8-17,2398
1959,8,18,3165,3021,144,1959-8-18,2877
1959,8,19,3840,3727,113,1959-8-19,3614
1959,8,20,3756,3623,133,1959-8-20,3490
1959,8,21,4115,3994,121,1959-8-21,3873
1959,8,22,4048,3602,446,1959-8-22,3156
1959,8,23,3774,3256,518,1959-8-23,2738
1959,8,24,3581,3041,540,1959-8-24,2501
1959,8,25,3537,2653,884,1959-8-25,1769
1959,8,26,3927,2155,1772,1959-8-26,383
1959,8,27,3904,2318,1586,1959-8-27,732
1959,8,28,5459,3417,2042,1959-8-28,1375
1959,8,29,6222,3962,2260,1959-8-29,1702
1959,8,30,6719,3746,2973,1959-8-30,773
1959,8,31,6669,3541,3128,1959-8-31,413
1959,9,1,6475,3670,2805,1959-9-1,865
1959,9,2,6414,3745,2669,1959-9-2,1076
1959,9,3,5399,2834,2565,1959-9-3,269
1959,9,4,3708,2412,1296,1959-9-4,1116
1959,9,5,3185,2354,831,1959-9-5,1523
1959,9,6,3256,2268,988,1959-9-6,1280
1959,9,7,2592,1904,688,1959-9-7,1216
1959,9,8,2603,1843,760,1959-9-8,1083
1959,9,9,2843,2050,793,1959-9-9,1257
1959,9,10,2758,2085,673,1959-9-10,1412
1959,9,11,2706,2046,660,1959-9-11,1386
1959,9,12,2796,1912,884,1959-9-12,1028
1959,9,13,2648,1733,915,1959-9-13,818
1959,9,14,2975,2059,916,1959-9-14,1143
1959,9,15,2922,1786,1136,1959-9-15,650
1959,9,16,2531,1640,891,1959-9-16,749
1959,9,17,1565,1133,432,1959-9-17,701
1959,9,18,1183,585,598,1959-9-18,-13
1959,9,19,1272,473,799,1959-9-19,-326
1959,9,20,1445,435,1010,1959-9-20,-575
1959,9,21,1449,427,1022,1959-9-21,-595
1959,9,22,1185,401,784,1959-9-22,-383
1959,9,23,1245,489,756,1959-9-23,-267
1959,9,24,1662,637,1025,1959-9-24,-388
1959,9,25,1343,588,755,1959-9-25,-167
1959,9,26,1181,578,603,1959-9-26,-25
1959,9,27,923,408,515,1959-9-27,-107
1959,9,28,748,275,473,1959-9-28,-198
1959,9,29,701,198,503,1959-9-29,-305
1959,9,30,741,171,570,1959-9-30,-399
1959,10,1,275,92,183,1959-10-1,-91
1959,10,2,479,216,263,1959-10-2,-47
1959,10,3,603,226,377,1959-10-3,-151
1959,10,4,908,382,526,1959-10-4,-144
1959,10,5,1166,374,792,1959-10-5,-418
1959,10,6,1551,642,909,1959-10-6,-267
1959,10,7,1421,804,617,1959-10-7,187
1959,10,8,1115,635,480,1959-10-8,155
1959,10,9,956,539,417,1959-10-9,122
1959,10,10,1098,725,373,1959-10-10,352
1959,10,11,1098,820,278,1959-10-11,542
1959,10,12,1291,873,418,1959-10-12,455
1959,10,13,1412,956,456,1959-10-13,500
1959,10,14,1487,1006,481,1959-10-14,525
1959,10,15,1094,695,399,1959-10-15,296
1959,10,16,1860,1383,477,1959-10-16,906
1959,10,17,1927,1604,323,1959-10-17,1281
1959,10,18,1653,852,801,1959-10-18,51
1959,10,19,1664,1406,258,1959-10-19,1148
1959,10,20,1834,1038,796,1959-10-20,242
1959,10,21,1817,1104,713,1959-10-21,391
1959,10,22,2215,1360,855,1959-10-22,505
1959,10,23,2360,1418,942,1959-10-23,476
1959,10,24,2211,1234,977,1959-10-24,257
1959,10,25,2393,1372,1021,1959-10-25,351
1959,10,26,2415,1485,930,1959-10-26,555
1959,10,27,1777,1289,488,1959-10-27,801
1959,10,28,1436,1139,297,1959-10-28,842
1959,10,29,1292,1147,145,1959-10-29,1002
1959,10,30,1204,1022,182,1959-10-30,840
1959,10,31,1405,1180,225,1959-10-31,955
1959,11,1,960,858,102,1959-11-1,756
1959,11,2,1208,1170,38,1959-11-2,1132
1959,11,3,1362,1362,0,1959-11-3,1362
1959,11,4,1620,1620,0,1959-11-4,1620
1959,11,5,807,784,23,1959-11-5,761
1959,11,6,1385,919,466,1959-11-6,453
1959,11,7,1829,831,998,1959-11-7,-167
1959,11,8,2737,1150,1587,1959-11-8,-437
1959,11,9,2961,1154,1807,1959-11-9,-653
1959,11,10,2626,868,1758,1959-11-10,-890
1959,11,11,2675,793,1882,1959-11-11,-1089
1959,11,12,2963,875,2088,1959-11-12,-1213
1959,11,13,3161,1132,2029,1959-11-13,-897
1959,11,14,2482,858,1624,1959-11-14,-766
1959,11,15,2810,1029,1781,1959-11-15,-752
1959,11,16,2572,892,1680,1959-11-16,-788
1959,11,17,1289,781,508,1959-11-17,273
1959,11,18,1045,819,226,1959-11-18,593
1959,11,19,1382,1162,220,1959-11-19,942
1959,11,20,1764,1764,0,1959-11-20,1764
1959,11,21,1290,1290,0,1959-11-21,1290
1959,11,22,1515,1488,27,1959-11-22,1461
1959,11,23,2279,2121,158,1959-11-23,1963
1959,11,24,2145,2022,123,1959-11-24,1899
1959,11,25,3362,3149,213,1959-11-25,2936
1959,11,26,4690,4411,279,1959-11-26,4132
1959,11,27,4082,3867,215,1959-11-27,3652
1959,11,28,4034,3827,207,1959-11-28,3620
1959,11,29,4138,3927,211,1959-11-29,3716
1959,11,30,4411,4208,203,1959-11-30,4005
1959,12,1,3623,3623,0,1959-12-1,3623
1959,12,2,3154,3091,63,1959-12-2,3028
1959,12,3,3676,3587,89,1959-12-3,3498
1959,12,4,3163,3075,88,1959-12-4,2987
1959,12,5,3088,2961,127,1959-12-5,2834
1959,12,6,3267,3222,45,1959-12-6,3177
1959,12,7,2408,2342,66,1959-12-7,2276
1959,12,8,2497,2395,102,1959-12-8,2293
1959,12,9,2878,2807,71,1959-12-9,2736
1959,12,10,2192,2153,39,1959-12-10,2114
1959,12,11,2330,1967,363,1959-12-11,1604
1959,12,12,2631,2214,417,1959-12-12,1797
1959,12,13,1898,1568,330,1959-12-13,1238
1959,12,14,1743,1407,336,1959-12-14,1071
1959,12,15,2115,1536,579,1959-12-15,957
1959,12,16,1883,1262,621,1959-12-16,641
1959,12,17,2171,1325,846,1959-12-17,479
1959,12,18,2241,1394,847,1959-12-18,547
1959,12,19,2329,1420,909,1959-12-19,511
1959,12,20,3081,2242,839,1959-12-20,1403
1959,12,21,2676,2070,606,1959-12-21,1464
1959,12,22,1776,1367,409,1959-12-22,958
1959,12,23,1457,1181,276,1959-12-23,905
1959,12,24,1261,1122,139,1959-12-24,983
1959,12,25,1435,1305,130,1959-12-25,1175
1959,12,26,1682,1545,137,1959-12-26,1408
1959,12,27,1798,1660,138,1959-12-27,1522
1959,12,28,1831,1811,20,1959-12-28,1791
1959,12,29,2079,1977,102,1959-12-29,1875
1959,12,30,1980,1640,340,1959-12-30,1300
1959,12,31,2402,1806,596,1959-12-31,1210
1960,1,1,1636,1123,513,1960-1-1,610
1960,1,2,1154,589,565,1960-1-2,24
1960,1,3,1464,414,1050,1960-1-3,-636
1960,1,4,2644,455,2189,1960-1-4,-1734
1960,1,5,3834,1098,2736,1960-1-5,-1638
1960,1,6,3981,1451,2530,1960-1-6,-1079
1960,1,7,4121,1798,2323,1960-1-7,-525
1960,1,8,4043,1630,2413,1960-1-8,-783
1960,1,9,3087,954,2133,1960-1-9,-1179
1960,1,10,2789,851,1938,1960-1-10,-1087
1960,1,11,2898,805,2093,1960-1-11,-1288
1960,1,12,2360,748,1612,1960-1-12,-864
1960,1,13,2177,931,1246,1960-1-13,-315
1960,1,14,1880,874,1006,1960-1-14,-132
1960,1,15,1888,1242,646,1960-1-15,596
1960,1,16,1970,1347,623,1960-1-16,724
1960,1,17,2054,1831,223,1960-1-17,1608
1960,1,18,1268,1210,58,1960-1-18,1152
1960,1,19,1173,1151,22,1960-1-19,1129
1960,1,20,1140,952,188,1960-1-20,764
1960,1,21,1098,865,233,1960-1-21,632
1960,1,22,1119,996,123,1960-1-22,873
1960,1,23,2426,2322,104,1960-1-23,2218
1960,1,24,3386,3283,103,1960-1-24,3180
1960,1,25,4249,3453,796,1960-1-25,2657
1960,1,26,3900,3262,638,1960-1-26,2624
1960,1,27,3998,3394,604,1960-1-27,2790
1960,1,28,3460,2926,534,1960-1-28,2392
1960,1,29,2865,2410,455,1960-1-29,1955
1960,1,30,2442,1834,608,1960-1-30,1226
1960,1,31,2116,1477,639,1960-1-31,838
1960,2,1,2640,1529,1111,1960-2-1,418
1960,2,2,2694,1571,1123,1960-2-2,448
1960,2,3,2522,1410,1112,1960-2-3,298
1960,2,4,2046,1081,965,1960-2-4,116
1960,2,5,2338,1251,1087,1960-2-5,164
1960,2,6,2686,1639,1047,1960-2-6,592
1960,2,7,2332,1479,853,1960-2-7,626
1960,2,8,2544,1693,851,1960-2-8,842
1960,2,9,3124,2070,1054,1960-2-9,1016
1960,2,10,3094,2044,1050,1960-2-10,994
1960,2,11,2671,1795,876,1960-2-11,919
1960,2,12,2604,1590,1014,1960-2-12,576
1960,2,13,2043,1925,118,1960-2-13,1807
1960,2,14,2281,2134,147,1960-2-14,1987
1960,2,15,2145,2096,49,1960-2-15,2047
1960,2,16,1880,1880,0,1960-2-16,1880
1960,2,17,1625,1625,0,1960-2-17,1625
1960,2,18,1409,1169,240,1960-2-18,929
1960,2,19,890,644,246,1960-2-19,398
1960,2,20,1232,1006,226,1960-2-20,780
1960,2,21,1046,825,221,1960-2-21,604
1960,2,22,1044,823,221,1960-2-22,602
1960,2,23,939,709,230,1960-2-23,479
1960,2,24,606,418,188,1960-2-24,230
1960,2,25,712,492,220,1960-2-25,272
1960,2,26,897,452,445,1960-2-26,7
1960,2,27,849,293,556,1960-2-27,-263
1960,2,28,696,268,428,1960-2-28,-160
1960,2,29,762,358,404,1960-2-29,-46
1960,3,1,664,291,373,1960-3-1,-82
1960,3,2,616,321,295,1960-3-2,26
1960,3,3,501,242,259,1960-3-3,-17
1960,3,4,885,637,248,1960-3-4,389
1960,3,5,643,264,379,1960-3-5,-115
1960,3,6,691,208,483,1960-3-6,-275
1960,3,7,854,373,481,1960-3-7,-108
1960,3,8,985,400,585,1960-3-8,-185
1960,3,9,1001,512,489,1960-3-9,23
1960,3,10,895,435,460,1960-3-10,-25
1960,3,11,437,225,212,1960-3-11,13
1960,3,12,375,216,159,1960-3-12,57
1960,3,13,615,160,455,1960-3-13,-295
1960,3,14,664,155,509,1960-3-14,-354
1960,3,15,1187,294,893,1960-3-15,-599
1960,3,16,953,244,709,1960-3-16,-465
1960,3,17,793,329,464,1960-3-17,-135
1960,3,18,811,307,504,1960-3-18,-197
1960,3,19,953,481,472,1960-3-19,9
1960,3,20,1122,906,216,1960-3-20,690
1960,3,21,1337,1157,180,1960-3-21,977
1960,3,22,1379,1230,149,1960-3-22,1081
1960,3,23,1512,1246,266,1960-3-23,980
1960,3,24,1571,1213,358,1960-3-24,855
1960,3,25,1436,931,505,1960-3-25,426
1960,3,26,1657,1067,590,1960-3-26,477
1960,3,27,1924,1272,652,1960-3-27,620
1960,3,28,2088,1371,717,1960-3-28,654
1960,3,29,3231,2236,995,1960-3-29,1241
1960,3,30,2540,1751,789,1960-3-30,962
1960,3,31,2624,1871,753,1960-3-31,1118
1960,4,1,3180,2024,1156,1960-4-1,868
1960,4,2,2858,2241,617,1960-4-2,1624
1960,4,3,2612,1977,635,1960-4-3,1342
1960,4,4,2936,2042,894,1960-4-4,1148
1960,4,5,2651,1783,868,1960-4-5,915
1960,4,6,3020,2026,994,1960-4-6,1032
1960,4,7,1191,258,933,1960-4-7,-675
1960,4,8,1187,261,926,1960-4-8,-665
1960,4,9,993,312,681,1960-4-9,-369
1960,4,10,1662,377,1285,1960-4-10,-908
1960,4,11,1518,285,1233,1960-4-11,-948
1960,4,12,1644,569,1075,1960-4-12,-506
1960,4,13,1963,908,1055,1960-4-13,-147
1960,4,14,1876,970,906,1960-4-14,64
1960,4,15,2113,1054,1059,1960-4-15,-5
1960,4,16,2097,1026,1071,1960-4-16,-45
1960,4,17,1629,830,799,1960-4-17,31
1960,4,18,1551,938,613,1960-4-18,325
1960,4,19,1682,1066,616,1960-4-19,450
1960,4,20,1186,771,415,1960-4-20,356
1960,4,21,1681,1150,531,1960-4-21,619
1960,4,22,1602,1099,503,1960-4-22,596
1960,4,23,1567,1226,341,1960-4-23,885
1960,4,24,1732,1465,267,1960-4-24,1198
1960,4,25,1629,1332,297,1960-4-25,1035
1960,4,26,1457,1065,392,1960-4-26,673
1960,4,27,1030,727,303,1960-4-27,424
1960,4,28,962,529,433,1960-4-28,96
1960,4,29,1264,828,436,1960-4-29,392
1960,4,30,1122,874,248,1960-4-30,626
1960,5,1,1735,995,740,1960-5-1,255
1960,5,2,2108,1544,564,1960-5-2,980
1960,5,3,2437,1806,631,1960-5-3,1175
1960,5,4,1587,892,695,1960-5-4,197
1960,5,5,1290,678,612,1960-5-5,66
1960,5,6,1247,688,559,1960-5-6,129
1960,5,7,1762,978,784,1960-5-7,194
1960,5,8,1964,1139,825,1960-5-8,314
1960,5,9,2127,1356,771,1960-5-9,585
1960,5,10,2158,1460,698,1960-5-10,762
1960,5,11,2923,2237,686,1960-5-11,1551
1960,5,12,3039,2444,595,1960-5-12,1849
1960,5,13,3793,2636,1157,1960-5-13,1479
1960,5,14,2392,1023,1369,1960-5-14,-346
1960,5,15,1603,345,1258,1960-5-15,-913
1960,5,16,1842,492,1350,1960-5-16,-858
1960,5,17,1744,435,1309,1960-5-17,-874
1960,5,18,1787,369,1418,1960-5-18,-1049
1960,5,19,1720,381,1339,1960-5-19,-958
1960,5,20,1708,295,1413,1960-5-20,-1118
1960,5,21,1685,275,1410,1960-5-21,-1135
1960,5,22,2152,421,1731,1960-5-22,-1310
1960,5,23,2066,430,1636,1960-5-23,-1206
1960,5,24,2678,961,1717,1960-5-24,-756
1960,5,25,2606,988,1618,1960-5-25,-630
1960,5,26,1706,1247,459,1960-5-26,788
1960,5,27,2258,1860,398,1960-5-27,1462
1960,5,28,2085,1361,724,1960-5-28,637
1960,5,29,2301,1371,930,1960-5-29,441
1960,5,30,2280,1472,808,1960-5-30,664
1960,5,31,1662,970,692,1960-5-31,278
1960,6,1,1337,677,660,1960-6-1,17
1960,6,2,944,458,486,1960-6-2,-28
1960,6,3,1106,585,521,1960-6-3,64
1960,6,4,1399,889,510,1960-6-4,379
1960,6,5,1374,938,436,1960-6-5,502
1960,6,6,1450,1032,418,1960-6-6,614
1960,6,7,1994,1513,481,1960-6-7,1032
1960,6,8,1881,1479,402,1960-6-8,1077
1960,6,9,1929,1199,730,1960-6-9,469
1960,6,10,1774,1058,716,1960-6-10,342
1960,6,11,1780,909,871,1960-6-11,38
1960,6,12,1167,530,637,1960-6-12,-107
1960,6,13,1002,498,504,1960-6-13,-6
1960,6,14,1385,815,570,1960-6-14,245
1960,6,15,1401,933,468,1960-6-15,465
1960,6,16,1068,682,386,1960-6-16,296
1960,6,17,639,387,252,1960-6-17,135
1960,6,18,630,430,200,1960-6-18,230
1960,6,19,882,630,252,1960-6-19,378
1960,6,20,1065,630,435,1960-6-20,195
1960,6,21,717,505,212,1960-6-21,293
1960,6,22,549,477,72,1960-6-22,405
1960,6,23,761,633,128,1960-6-23,505
1960,6,24,1102,773,329,1960-6-24,444
1960,6,25,1406,1100,306,1960-6-25,794
1960,6,26,2000,1759,241,1960-6-26,1518
1960,6,27,1991,1657,334,1960-6-27,1323
1960,6,28,2355,1957,398,1960-6-28,1559
1960,6,29,2617,2185,432,1960-6-29,1753
1960,6,30,2728,2359,369,1960-6-30,1990
1960,7,1,3377,3003,374,1960-7-1,2629
1960,7,2,3395,2905,490,1960-7-2,2415
1960,7,3,3753,3189,564,1960-7-3,2625
1960,7,4,4137,3460,677,1960-7-4,2783
1960,7,5,3414,2790,624,1960-7-5,2166
1960,7,6,3315,2761,554,1960-7-6,2207
1960,7,7,2916,2868,48,1960-7-7,2820
1960,7,8,2706,2616,90,1960-7-8,2526
1960,7,9,1794,1677,117,1960-7-9,1560
1960,7,10,1126,1109,17,1960-7-10,1092
1960,7,11,1112,1093,19,1960-7-11,1074
1960,7,12,1132,999,133,1960-7-12,866
1960,7,13,990,904,86,1960-7-13,818
1960,7,14,1043,966,77,1960-7-14,889
1960,7,15,1055,959,96,1960-7-15,863
1960,7,16,1667,1573,94,1960-7-16,1479
1960,7,17,1637,1576,61,1960-7-17,1515
1960,7,18,1699,1600,99,1960-7-18,1501
1960,7,19,1396,1279,117,1960-7-19,1162
1960,7,20,1834,1686,148,1960-7-20,1538
1960,7,21,1678,1291,387,1960-7-21,904
1960,7,22,1422,1121,301,1960-7-22,820
1960,7,23,1167,939,228,1960-7-23,711
1960,7,24,1652,1422,230,1960-7-24,1192
1960,7,25,1483,1273,210,1960-7-25,1063
1960,7,26,1204,1026,178,1960-7-26,848
1960,7,27,1175,990,185,1960-7-27,805
1960,7,28,1297,1089,208,1960-7-28,881
1960,7,29,1007,872,135,1960-7-29,737
1960,7,30,1025,895,130,1960-7-30,765
1960,7,31,967,807,160,1960-7-31,647
1960,8,1,738,606,132,1960-8-1,474
1960,8,2,754,602,152,1960-8-2,450
1960,8,3,499,499,0,1960-8-3,499
1960,8,4,379,379,0,1960-8-4,379
1960,8,5,305,301,4,1960-8-5,297
1960,8,6,306,295,11,1960-8-6,284
1960,8,7,1518,1512,6,1960-8-7,1506
1960,8,8,1388,1388,0,1960-8-8,1388
1960,8,9,1240,1157,83,1960-8-9,1074
1960,8,10,2335,1634,701,1960-8-10,933
1960,8,11,3048,2039,1009,1960-8-11,1030
1960,8,12,3853,2065,1788,1960-8-12,277
1960,8,13,4154,2337,1817,1960-8-13,520
1960,8,14,4515,2653,1862,1960-8-14,791
1960,8,15,5381,3213,2168,1960-8-15,1045
1960,8,16,4200,2582,1618,1960-8-16,964
1960,8,17,3376,1900,1476,1960-8-17,424
1960,8,18,3720,1797,1923,1960-8-18,-126
1960,8,19,3524,1459,2065,1960-8-19,-606
1960,8,20,2902,1039,1863,1960-8-20,-824
1960,8,21,2267,860,1407,1960-8-21,-547
1960,8,22,1942,756,1186,1960-8-22,-430
1960,8,23,1574,729,845,1960-8-23,-116
1960,8,24,1207,771,436,1960-8-24,335
1960,8,25,1814,1012,802,1960-8-25,210
1960,8,26,1368,509,859,1960-8-26,-350
1960,8,27,1404,475,929,1960-8-27,-454
1960,8,28,1300,389,911,1960-8-28,-522
1960,8,29,917,277,640,1960-8-29,-363
1960,8,30,467,281,186,1960-8-30,95
1960,8,31,658,329,329,1960-8-31,0
1960,9,1,885,432,453,1960-9-1,-21
1960,9,2,891,472,419,1960-9-2,53
1960,9,3,1198,805,393,1960-9-3,412
1960,9,4,1187,1137,50,1960-9-4,1087
1960,9,5,1305,943,362,1960-9-5,581
1960,9,6,1112,803,309,1960-9-6,494
1960,9,7,956,511,445,1960-9-7,66
1960,9,8,1031,497,534,1960-9-8,-37
1960,9,9,1389,775,614,1960-9-9,161
1960,9,10,1581,872,709,1960-9-10,163
1960,9,11,1176,569,607,1960-9-11,-38
1960,9,12,1158,548,610,1960-9-12,-62
1960,9,13,1505,439,1066,1960-9-13,-627
1960,9,14,1201,424,777,1960-9-14,-353
1960,9,15,1286,223,1063,1960-9-15,-840
1960,9,16,1247,148,1099,1960-9-16,-951
1960,9,17,1311,263,1048,1960-9-17,-785
1960,9,18,1871,657,1214,1960-9-18,-557
1960,9,19,2464,1032,1432,1960-9-19,-400
1960,9,20,2765,1080,1685,1960-9-20,-605
1960,9,21,2645,935,1710,1960-9-21,-775
1960,9,22,2354,854,1500,1960-9-22,-646
1960,9,23,2366,1005,1361,1960-9-23,-356
1960,9,24,1938,786,1152,1960-9-24,-366
1960,9,25,1710,587,1123,1960-9-25,-536
1960,9,26,1462,457,1005,1960-9-26,-548
1960,9,27,1428,373,1055,1960-9-27,-682
1960,9,28,660,343,317,1960-9-28,26
1960,9,29,538,152,386,1960-9-29,-234
1960,9,30,556,90,466,1960-9-30,-376
1960,10,1,97,0,97,1960-10-1,-97
1960,10,2,489,0,489,1960-10-2,-489
1960,10,3,319,0,319,1960-10-3,-319
1960,10,4,343,27,316,1960-10-4,-289
1960,10,5,742,430,312,1960-10-5,118
1960,10,6,687,373,314,1960-10-6,59
1960,10,7,777,385,392,1960-10-7,-7
1960,10,8,850,377,473,1960-10-8,-96
1960,10,9,948,441,507,1960-10-9,-66
1960,10,10,1201,592,609,1960-10-10,-17
1960,10,11,1062,461,601,1960-10-11,-140
1960,10,12,1200,578,622,1960-10-12,-44
1960,10,13,1095,600,495,1960-10-13,105
1960,10,14,1631,841,790,1960-10-14,51
1960,10,15,2010,1310,700,1960-10-15,610
1960,10,16,2071,1464,607,1960-10-16,857
1960,10,17,2289,1712,577,1960-10-17,1135
1960,10,18,1710,1246,464,1960-10-18,782
1960,10,19,1582,1144,438,1960-10-19,706
1960,10,20,1666,1252,414,1960-10-20,838
1960,10,21,1765,1346,419,1960-10-21,927
1960,10,22,1246,1062,184,1960-10-22,878
1960,10,23,1231,1081,150,1960-10-23,931
1960,10,24,1239,1067,172,1960-10-24,895
1960,10,25,1775,1639,136,1960-10-25,1503
1960,10,26,1873,1650,223,1960-10-26,1427
1960,10,27,1536,1536,0,1960-10-27,1536
1960,10,28,708,708,0,1960-10-28,708
1960,10,29,819,731,88,1960-10-29,643
1960,10,30,683,494,189,1960-10-30,305
1960,10,31,583,418,165,1960-10-31,253
1960,11,1,467,359,108,1960-11-1,251
1960,11,2,420,372,48,1960-11-2,324
1960,11,3,356,331,25,1960-11-3,306
1960,11,4,292,274,18,1960-11-4,256
1960,11,5,305,264,41,1960-11-5,223
1960,11,6,1615,1331,284,1960-11-6,1047
1960,11,7,1677,1290,387,1960-11-7,903
1960,11,8,2420,1652,768,1960-11-8,884
1960,11,9,2192,1694,498,1960-11-9,1196
1960,11,10,2223,1672,551,1960-11-10,1121
1960,11,11,2772,2171,601,1960-11-11,1570
1960,11,12,3143,2761,382,1960-11-12,2379
1960,11,13,3156,2851,305,1960-11-13,2546
1960,11,14,3328,2984,344,1960-11-14,2640
1960,11,15,3173,2927,246,1960-11-15,2681
1960,11,16,2938,2697,241,1960-11-16,2456
1960,11,17,2479,2312,167,1960-11-17,2145
1960,11,18,2138,2138,0,1960-11-18,2138
1960,11,19,1053,1034,19,1960-11-19,1015
1960,11,20,1183,1153,30,1960-11-20,1123
1960,11,21,1569,1543,26,1960-11-21,1517
1960,11,22,1352,1293,59,1960-11-22,1234
1960,11,23,719,701,18,1960-11-23,683
1960,11,24,451,440,11,1960-11-24,429
1960,11,25,326,226,100,1960-11-25,126
1960,11,26,428,274,154,1960-11-26,120
1960,11,27,395,320,75,1960-11-27,245
1960,11,28,700,225,475,1960-11-28,-250
1960,11,29,551,195,356,1960-11-29,-161
1960,11,30,463,168,295,1960-11-30,-127
1960,12,1,854,550,304,1960-12-1,246
1960,12,2,815,475,340,1960-12-2,135
1960,12,3,986,412,574,1960-12-3,-162
1960,12,4,1325,755,570,1960-12-4,185
1960,12,5,1424,838,586,1960-12-5,252
1960,12,6,1033,400,633,1960-12-6,-233
1960,12,7,1337,396,941,1960-12-7,-545
1960,12,8,1236,303,933,1960-12-8,-630
1960,12,9,1258,258,1000,1960-12-9,-742
1960,12,10,920,327,593,1960-12-10,-266
1960,12,11,725,238,487,1960-12-11,-249
1960,12,12,706,169,537,1960-12-12,-368
1960,12,13,609,106,503,1960-12-13,-397
1960,12,14,598,225,373,1960-12-14,-148
1960,12,15,645,251,394,1960-12-15,-143
1960,12,16,823,267,556,1960-12-16,-289
1960,12,17,708,184,524,1960-12-17,-340
1960,12,18,610,136,474,1960-12-18,-338
1960,12,19,438,125,313,1960-12-19,-188
1960,12,20,449,96,353,1960-12-20,-257
1960,12,21,649,434,215,1960-12-21,219
1960,12,22,432,302,130,1960-12-22,172
1960,12,23,353,288,65,1960-12-23,223
1960,12,24,317,199,118,1960-12-24,81
1960,12,25,358,250,108,1960-12-25,142
1960,12,26,1043,965,78,1960-12-26,887
1960,12,27,1288,1160,128,1960-12-27,1032
1960,12,28,1330,1257,73,1960-12-28,1184
1960,12,29,1215,1116,99,1960-12-29,1017
1960,12,30,1720,1616,104,1960-12-30,1512
1960,12,31,1901,1775,126,1960-12-31,1649
1961,1,1,2020,1901,119,1961-1-1,1782
1961,1,2,1927,1850,77,1961-1-2,1773
1961,1,3,2312,2219,93,1961-1-3,2126
1961,1,4,1771,1748,23,1961-1-4,1725
1961,1,5,2016,2005,11,1961-1-5,1994
1961,1,6,1437,1400,37,1961-1-6,1363
1961,1,7,896,855,41,1961-1-7,814
1961,1,8,655,501,154,1961-1-8,347
1961,1,9,657,522,135,1961-1-9,387
1961,1,10,703,522,181,1961-1-10,341
1961,1,11,612,469,143,1961-1-11,326
1961,1,12,422,320,102,1961-1-12,218
1961,1,13,110,0,110,1961-1-13,-110
1961,1,14,80,0,80,1961-1-14,-80
1961,1,15,111,0,111,1961-1-15,-111
1961,1,16,204,0,204,1961-1-16,-204
1961,1,17,344,0,344,1961-1-17,-344
1961,1,18,424,0,424,1961-1-18,-424
1961,1,19,420,0,420,1961-1-19,-420
1961,1,20,238,0,238,1961-1-20,-238
1961,1,21,321,143,178,1961-1-21,-35
1961,1,22,304,150,154,1961-1-22,-4
1961,1,23,193,110,83,1961-1-23,27
1961,1,24,98,86,12,1961-1-24,74
1961,1,25,463,463,0,1961-1-25,463
1961,1,26,473,401,72,1961-1-26,329
1961,1,27,471,403,68,1961-1-27,335
1961,1,28,884,827,57,1961-1-28,770
1961,1,29,1300,1213,87,1961-1-29,1126
1961,1,30,1147,1126,21,1961-1-30,1105
1961,1,31,941,911,30,1961-1-31,881
1961,2,1,698,602,96,1961-2-1,506
1961,2,2,618,420,198,1961-2-2,222
1961,2,3,973,791,182,1961-2-3,609
1961,2,4,855,698,157,1961-2-4,541
1961,2,5,763,651,112,1961-2-5,539
1961,2,6,504,392,112,1961-2-6,280
1961,2,7,445,307,138,1961-2-7,169
1961,2,8,468,296,172,1961-2-8,124
1961,2,9,603,458,145,1961-2-9,313
1961,2,10,437,270,167,1961-2-10,103
1961,2,11,342,264,78,1961-2-11,186
1961,2,12,275,250,25,1961-2-12,225
1961,2,13,330,324,6,1961-2-13,318
1961,2,14,262,249,13,1961-2-14,236
1961,2,15,222,194,28,1961-2-15,166
1961,2,16,89,74,15,1961-2-16,59
1961,2,17,142,68,74,1961-2-17,-6
1961,2,18,72,32,40,1961-2-18,-8
1961,2,19,72,9,63,1961-2-19,-54
1961,2,20,70,7,63,1961-2-20,-56
1961,2,21,222,117,105,1961-2-21,12
1961,2,22,311,162,149,1961-2-22,13
1961,2,23,289,136,153,1961-2-23,-17
1961,2,24,256,103,153,1961-2-24,-50
1961,2,25,156,111,45,1961-2-25,66
1961,2,26,188,104,84,1961-2-26,20
1961,2,27,174,99,75,1961-2-27,24
1961,2,28,177,139,38,1961-2-28,101
1961,3,1,124,99,25,1961-3-1,74
1961,3,2,170,133,37,1961-3-2,96
1961,3,3,225,118,107,1961-3-3,11
1961,3,4,177,123,54,1961-3-4,69
1961,3,5,165,121,44,1961-3-5,77
1961,3,6,75,38,37,1961-3-6,1
1961,3,7,100,70,30,1961-3-7,40
1961,3,8,379,101,278,1961-3-8,-177
1961,3,9,255,26,229,1961-3-9,-203
1961,3,10,294,28,266,1961-3-10,-238
1961,3,11,187,7,180,1961-3-11,-173
1961,3,12,159,0,159,1961-3-12,-159
1961,3,13,141,0,141,1961-3-13,-141
1961,3,14,352,185,167,1961-3-14,18
1961,3,15,367,211,156,1961-3-15,55
1961,3,16,259,86,173,1961-3-16,-87
1961,3,17,281,100,181,1961-3-17,-81
1961,3,18,257,94,163,1961-3-18,-69
1961,3,19,245,68,177,1961-3-19,-109
1961,3,20,568,465,103,1961-3-20,362
1961,3,21,751,751,0,1961-3-21,751
1961,3,22,756,756,0,1961-3-22,756
1961,3,23,841,841,0,1961-3-23,841
1961,3,24,824,824,0,1961-3-24,824
1961,3,25,1019,880,139,1961-3-25,741
1961,3,26,1381,995,386,1961-3-26,609
1961,3,27,1001,599,402,1961-3-27,197
1961,3,28,1099,481,618,1961-3-28,-137
1961,3,29,1244,508,736,1961-3-29,-228
1961,3,30,1095,455,640,1961-3-30,-185
1961,3,31,1099,502,597,1961-3-31,-95
1961,4,1,1091,394,697,1961-4-1,-303
1961,4,2,433,13,420,1961-4-2,-407
1961,4,3,507,0,507,1961-4-3,-507
1961,4,4,565,38,527,1961-4-4,-489
1961,4,5,713,101,612,1961-4-5,-511
1961,4,6,834,258,576,1961-4-6,-318
1961,4,7,723,327,396,1961-4-7,-69
1961,4,8,811,359,452,1961-4-8,-93
1961,4,9,447,333,114,1961-4-9,219
1961,4,10,416,303,113,1961-4-10,190
1961,4,11,630,528,102,1961-4-11,426
1961,4,12,492,388,104,1961-4-12,284
1961,4,13,350,234,116,1961-4-13,118
1961,4,14,363,280,83,1961-4-14,197
1961,4,15,419,323,96,1961-4-15,227
1961,4,16,744,669,75,1961-4-16,594
1961,4,17,685,575,110,1961-4-17,465
1961,4,18,655,568,87,1961-4-18,481
1961,4,19,513,472,41,1961-4-19,431
1961,4,20,509,473,36,1961-4-20,437
1961,4,21,445,403,42,1961-4-21,361
1961,4,22,351,331,20,1961-4-22,311
1961,4,23,309,289,20,1961-4-23,269
1961,4,24,819,228,591,1961-4-24,-363
1961,4,25,1007,217,790,1961-4-25,-573
1961,4,26,850,211,639,1961-4-26,-428
1961,4,27,1094,428,666,1961-4-27,-238
1961,4,28,913,365,548,1961-4-28,-183
1961,4,29,765,269,496,1961-4-29,-227
1961,4,30,690,397,293,1961-4-30,104
1961,5,1,920,623,297,1961-5-1,326
1961,5,2,741,583,158,1961-5-2,425
1961,5,3,906,835,71,1961-5-3,764
1961,5,4,508,480,28,1961-5-4,452
1961,5,5,592,526,66,1961-5-5,460
1961,5,6,658,648,10,1961-5-6,638
1961,5,7,396,396,0,1961-5-7,396
1961,5,8,301,301,0,1961-5-8,301
1961,5,9,258,258,0,1961-5-9,258
1961,5,10,315,315,0,1961-5-10,315
1961,5,11,371,371,0,1961-5-11,371
1961,5,12,388,388,0,1961-5-12,388
1961,5,13,463,463,0,1961-5-13,463
1961,5,14,424,404,20,1961-5-14,384
1961,5,15,310,301,9,1961-5-15,292
1961,5,16,285,280,5,1961-5-16,275
1961,5,17,281,281,0,1961-5-17,281
1961,5,18,354,300,54,1961-5-18,246
1961,5,19,370,332,38,1961-5-19,294
1961,5,20,644,601,43,1961-5-20,558
1961,5,21,726,712,14,1961-5-21,698
1961,5,22,779,762,17,1961-5-22,745
1961,5,23,763,763,0,1961-5-23,763
1961,5,24,607,607,0,1961-5-24,607
1961,5,25,537,526,11,1961-5-25,515
1961,5,26,301,301,0,1961-5-26,301
1961,5,27,234,234,0,1961-5-27,234
1961,5,28,213,205,8,1961-5-28,197
1961,5,29,215,205,10,1961-5-29,195
1961,5,30,238,157,81,1961-5-30,76
1961,5,31,158,128,30,1961-5-31,98
1961,6,1,142,94,48,1961-6-1,46
1961,6,2,263,50,213,1961-6-2,-163
1961,6,3,363,119,244,1961-6-3,-125
1961,6,4,519,215,304,1961-6-4,-89
1961,6,5,422,195,227,1961-6-5,-32
1961,6,6,315,131,184,1961-6-6,-53
1961,6,7,239,35,204,1961-6-7,-169
1961,6,8,194,41,153,1961-6-8,-112
1961,6,9,949,796,153,1961-6-9,643
1961,6,10,1586,1428,158,1961-6-10,1270
1961,6,11,1403,1187,216,1961-6-11,971
1961,6,12,1448,851,597,1961-6-12,254
1961,6,13,1436,716,720,1961-6-13,-4
1961,6,14,1361,713,648,1961-6-14,65
1961,6,15,1524,621,903,1961-6-15,-282
1961,6,16,1658,637,1021,1961-6-16,-384
1961,6,17,1704,587,1117,1961-6-17,-530
1961,6,18,1647,709,938,1961-6-18,-229
1961,6,19,1478,673,805,1961-6-19,-132
1961,6,20,1445,740,705,1961-6-20,35
1961,6,21,1479,995,484,1961-6-21,511
1961,6,22,1282,979,303,1961-6-22,676
1961,6,23,1447,1224,223,1961-6-23,1001
1961,6,24,1435,1220,215,1961-6-24,1005
1961,6,25,1014,842,172,1961-6-25,670
1961,6,26,540,306,234,1961-6-26,72
1961,6,27,260,129,131,1961-6-27,-2
1961,6,28,180,104,76,1961-6-28,28
1961,6,29,302,242,60,1961-6-29,182
1961,6,30,822,777,45,1961-6-30,732
1961,7,1,1167,1147,20,1961-7-1,1127
1961,7,2,1367,1355,12,1961-7-2,1343
1961,7,3,1753,1753,0,1961-7-3,1753
1961,7,4,1562,1562,0,1961-7-4,1562
1961,7,5,509,509,0,1961-7-5,509
1961,7,6,704,704,0,1961-7-6,704
1961,7,7,876,876,0,1961-7-7,876
1961,7,8,788,788,0,1961-7-8,788
1961,7,9,934,609,325,1961-7-9,284
1961,7,10,2082,921,1161,1961-7-10,-240
1961,7,11,2398,1003,1395,1961-7-11,-392
1961,7,12,2011,764,1247,1961-7-12,-483
1961,7,13,1761,515,1246,1961-7-13,-731
1961,7,14,1797,494,1303,1961-7-14,-809
1961,7,15,1845,413,1432,1961-7-15,-1019
1961,7,16,1575,357,1218,1961-7-16,-861
1961,7,17,1283,345,938,1961-7-17,-593
1961,7,18,1153,367,786,1961-7-18,-419
1961,7,19,1804,800,1004,1961-7-19,-204
1961,7,20,1446,1005,441,1961-7-20,564
1961,7,21,982,907,75,1961-7-21,832
1961,7,22,695,666,29,1961-7-22,637
1961,7,23,734,694,40,1961-7-23,654
1961,7,24,790,760,30,1961-7-24,730
1961,7,25,596,572,24,1961-7-25,548
1961,7,26,855,835,20,1961-7-26,815
1961,7,27,816,816,0,1961-7-27,816
1961,7,28,410,410,0,1961-7-28,410
1961,7,29,446,446,0,1961-7-29,446
1961,7,30,477,477,0,1961-7-30,477
1961,7,31,204,185,19,1961-7-31,166
1961,8,1,107,100,7,1961-8-1,93
1961,8,2,75,75,0,1961-8-2,75
1961,8,3,54,29,25,1961-8-3,4
1961,8,4,60,24,36,1961-8-4,-12
1961,8,5,30,0,30,1961-8-5,-30
1961,8,6,7,7,0,1961-8-6,7
1961,8,7,82,82,0,1961-8-7,82
1961,8,8,442,409,33,1961-8-8,376
1961,8,9,526,495,31,1961-8-9,464
1961,8,10,866,798,68,1961-8-10,730
1961,8,11,1049,878,171,1961-8-11,707
1961,8,12,761,647,114,1961-8-12,533
1961,8,13,776,683,93,1961-8-13,590
1961,8,14,757,648,109,1961-8-14,539
1961,8,15,815,733,82,1961-8-15,651
1961,8,16,760,679,81,1961-8-16,598
1961,8,17,719,645,74,1961-8-17,571
1961,8,18,521,505,16,1961-8-18,489
1961,8,19,359,348,11,1961-8-19,337
1961,8,20,364,292,72,1961-8-20,220
1961,8,21,302,275,27,1961-8-21,248
1961,8,22,246,228,18,1961-8-22,210
1961,8,23,60,36,24,1961-8-23,12
1961,8,24,176,150,26,1961-8-24,124
1961,8,25,284,257,27,1961-8-25,230
1961,8,26,293,281,12,1961-8-26,269
1961,8,27,460,441,19,1961-8-27,422
1961,8,28,533,533,0,1961-8-28,533
1961,8,29,1191,1191,0,1961-8-29,1191
1961,8,30,1200,1189,11,1961-8-30,1178
1961,8,31,1576,1576,0,1961-8-31,1576
1961,9,1,1514,1514,0,1961-9-1,1514
1961,9,2,1445,1445,0,1961-9-2,1445
1961,9,3,1336,1336,0,1961-9-3,1336
1961,9,4,1084,1084,0,1961-9-4,1084
1961,9,5,1007,1007,0,1961-9-5,1007
1961,9,6,868,868,0,1961-9-6,868
1961,9,7,782,782,0,1961-9-7,782
1961,9,8,594,594,0,1961-9-8,594
1961,9,9,1451,875,576,1961-9-9,299
1961,9,10,1687,812,875,1961-9-10,-63
1961,9,11,1447,724,723,1961-9-11,1
1961,9,12,1333,668,665,1961-9-12,3
1961,9,13,1282,635,647,1961-9-13,-12
1961,9,14,1341,792,549,1961-9-14,243
1961,9,15,1148,727,421,1961-9-15,306
1961,9,16,1485,974,511,1961-9-16,463
1961,9,17,1250,835,415,1961-9-17,420
1961,9,18,957,682,275,1961-9-18,407
1961,9,19,709,609,100,1961-9-19,509
1961,9,20,671,574,97,1961-9-20,477
1961,9,21,516,516,0,1961-9-21,516
1961,9,22,393,388,5,1961-9-22,383
1961,9,23,325,325,0,1961-9-23,325
1961,9,24,612,612,0,1961-9-24,612
1961,9,25,625,625,0,1961-9-25,625
1961,9,26,868,868,0,1961-9-26,868
1961,9,27,649,649,0,1961-9-27,649
1961,9,28,681,681,0,1961-9-28,681
1961,9,29,437,437,0,1961-9-29,437
1961,9,30,395,395,0,1961-9-30,395
1961,10,1,366,366,0,1961-10-1,366
1961,10,2,170,170,0,1961-10-2,170
1961,10,3,285,243,42,1961-10-3,201
1961,10,4,166,122,44,1961-10-4,78
1961,10,5,286,229,57,1961-10-5,172
1961,10,6,273,190,83,1961-10-6,107
1961,10,7,288,208,80,1961-10-7,128
1961,10,8,313,229,84,1961-10-8,145
1961,10,9,504,504,0,1961-10-9,504
1961,10,10,753,753,0,1961-10-10,753
1961,10,11,736,736,0,1961-10-11,736
1961,10,12,663,519,144,1961-10-12,375
1961,10,13,772,544,228,1961-10-13,316
1961,10,14,604,443,161,1961-10-14,282
1961,10,15,584,410,174,1961-10-15,236
1961,10,16,643,448,195,1961-10-16,253
1961,10,17,482,378,104,1961-10-17,274
1961,10,18,367,361,6,1961-10-18,355
1961,10,19,457,404,53,1961-10-19,351
1961,10,20,419,384,35,1961-10-20,349
1961,10,21,455,449,6,1961-10-21,443
1961,10,22,385,374,11,1961-10-22,363
1961,10,23,11,8,3,1961-10-23,5
1961,10,24,33,8,25,1961-10-24,-17
1961,10,25,31,18,13,1961-10-25,5
1961,10,26,41,41,0,1961-10-26,41
1961,10,27,16,16,0,1961-10-27,16
1961,10,28,32,32,0,1961-10-28,32
1961,10,29,17,17,0,1961-10-29,17
1961,10,30,24,24,0,1961-10-30,24
1961,10,31,23,23,0,1961-10-31,23
1961,11,1,0,0,0,1961-11-1,0
1961,11,2,0,0,0,1961-11-2,0
1961,11,3,0,0,0,1961-11-3,0
1961,11,4,16,16,0,1961-11-4,16
1961,11,5,58,58,0,1961-11-5,58
1961,11,6,162,162,0,1961-11-6,162
1961,11,7,465,386,79,1961-11-7,307
1961,11,8,911,765,146,1961-11-8,619
1961,11,9,1095,971,124,1961-11-9,847
1961,11,10,496,392,104,1961-11-10,288
1961,11,11,734,657,77,1961-11-11,580
1961,11,12,539,483,56,1961-11-12,427
1961,11,13,493,475,18,1961-11-13,457
1961,11,14,496,496,0,1961-11-14,496
1961,11,15,341,341,0,1961-11-15,341
1961,11,16,204,204,0,1961-11-16,204
1961,11,17,151,151,0,1961-11-17,151
1961,11,18,130,130,0,1961-11-18,130
1961,11,19,124,124,0,1961-11-19,124
1961,11,20,68,68,0,1961-11-20,68
1961,11,21,214,214,0,1961-11-21,214
1961,11,22,514,514,0,1961-11-22,514
1961,11,23,64,64,0,1961-11-23,64
1961,11,24,129,129,0,1961-11-24,129
1961,11,25,272,272,0,1961-11-25,272
1961,11,26,296,296,0,1961-11-26,296
1961,11,27,385,297,88,1961-11-27,209
1961,11,28,310,255,55,1961-11-28,200
1961,11,29,380,242,138,1961-11-29,104
1961,11,30,396,345,51,1961-11-30,294
1961,12,1,327,310,17,1961-12-1,293
1961,12,2,343,326,17,1961-12-2,309
1961,12,3,548,537,11,1961-12-3,526
1961,12,4,543,540,3,1961-12-4,537
1961,12,5,437,437,0,1961-12-5,437
1961,12,6,351,351,0,1961-12-6,351
1961,12,7,390,385,5,1961-12-7,380
1961,12,8,401,396,5,1961-12-8,391
1961,12,9,522,485,37,1961-12-9,448
1961,12,10,280,280,0,1961-12-10,280
1961,12,11,0,0,0,1961-12-11,0
1961,12,12,0,0,0,1961-12-12,0
1961,12,13,0,0,0,1961-12-13,0
1961,12,14,19,0,19,1961-12-14,-19
1961,12,15,6,0,6,1961-12-15,-6
1961,12,16,0,0,0,1961-12-16,0
1961,12,17,33,33,0,1961-12-17,33
1961,12,18,19,19,0,1961-12-18,19
1961,12,19,11,11,0,1961-12-19,11
1961,12,20,292,0,292,1961-12-20,-292
1961,12,21,763,0,763,1961-12-21,-763
1961,12,22,633,20,613,1961-12-22,-593
1961,12,23,618,104,514,1961-12-23,-410
1961,12,24,939,439,500,1961-12-24,-61
1961,12,25,800,417,383,1961-12-25,34
1961,12,26,943,609,334,1961-12-26,275
1961,12,27,1006,702,304,1961-12-27,398
1961,12,28,777,516,261,1961-12-28,255
1961,12,29,560,288,272,1961-12-29,16
1961,12,30,486,246,240,1961-12-30,6
1961,12,31,302,138,164,1961-12-31,-26
1962,1,1,360,191,169,1962-1-1,22
1962,1,2,226,226,0,1962-1-2,226
1962,1,3,239,239,0,1962-1-3,239
1962,1,4,91,91,0,1962-1-4,91
1962,1,5,44,44,0,1962-1-5,44
1962,1,6,26,26,0,1962-1-6,26
1962,1,7,19,19,0,1962-1-7,19
1962,1,8,12,12,0,1962-1-8,12
1962,1,9,0,0,0,1962-1-9,0
1962,1,10,17,17,0,1962-1-10,17
1962,1,11,0,0,0,1962-1-11,0
1962,1,12,7,7,0,1962-1-12,7
1962,1,13,44,44,0,1962-1-13,44
1962,1,14,224,224,0,1962-1-14,224
1962,1,15,250,250,0,1962-1-15,250
1962,1,16,330,330,0,1962-1-16,330
1962,1,17,21,21,0,1962-1-17,21
1962,1,18,326,326,0,1962-1-18,326
1962,1,19,639,639,0,1962-1-19,639
1962,1,20,1071,1071,0,1962-1-20,1071
1962,1,21,1275,1275,0,1962-1-21,1275
1962,1,22,1275,1275,0,1962-1-22,1275
1962,1,23,1393,1393,0,1962-1-23,1393
1962,1,24,1562,1562,0,1962-1-24,1562
1962,1,25,1611,1608,3,1962-1-25,1605
1962,1,26,1483,1465,18,1962-1-26,1447
1962,1,27,1398,1355,43,1962-1-27,1312
1962,1,28,1145,1121,24,1962-1-28,1097
1962,1,29,1514,1504,10,1962-1-29,1494
1962,1,30,850,849,1,1962-1-30,848
1962,1,31,956,956,0,1962-1-31,956
1962,2,1,1337,1337,0,1962-2-1,1337
1962,2,2,1265,1265,0,1962-2-2,1265
1962,2,3,1348,1348,0,1962-2-3,1348
1962,2,4,1114,1114,0,1962-2-4,1114
1962,2,5,420,420,0,1962-2-5,420
1962,2,6,124,107,17,1962-2-6,90
1962,2,7,66,66,0,1962-2-7,66
1962,2,8,112,112,0,1962-2-8,112
1962,2,9,138,138,0,1962-2-9,138
1962,2,10,115,115,0,1962-2-10,115
1962,2,11,161,161,0,1962-2-11,161
1962,2,12,6,6,0,1962-2-12,6
1962,2,13,4,4,0,1962-2-13,4
1962,2,14,338,338,0,1962-2-14,338
1962,2,15,264,264,0,1962-2-15,264
1962,2,16,272,272,0,1962-2-16,272
1962,2,17,233,220,13,1962-2-17,207
1962,2,18,217,193,24,1962-2-18,169
1962,2,19,387,176,211,1962-2-19,-35
1962,2,20,1379,841,538,1962-2-20,303
1962,2,21,1628,715,913,1962-2-21,-198
1962,2,22,1713,671,1042,1962-2-22,-371
1962,2,23,1962,727,1235,1962-2-23,-508
1962,2,24,1915,697,1218,1962-2-24,-521
1962,2,25,1709,551,1158,1962-2-25,-607
1962,2,26,1446,464,982,1962-2-26,-518
1962,2,27,1747,606,1141,1962-2-27,-535
1962,2,28,1732,576,1156,1962-2-28,-580
1962,3,1,1671,609,1062,1962-3-1,-453
1962,3,2,1621,583,1038,1962-3-2,-455
1962,3,3,1581,453,1128,1962-3-3,-675
1962,3,4,498,457,41,1962-3-4,416
1962,3,5,69,69,0,1962-3-5,69
1962,3,6,115,115,0,1962-3-6,115
1962,3,7,88,88,0,1962-3-7,88
1962,3,8,51,51,0,1962-3-8,51
1962,3,9,50,50,0,1962-3-9,50
1962,3,10,8,8,0,1962-3-10,8
1962,3,11,0,0,0,1962-3-11,0
1962,3,12,0,0,0,1962-3-12,0
1962,3,13,377,377,0,1962-3-13,377
1962,3,14,214,214,0,1962-3-14,214
1962,3,15,147,147,0,1962-3-15,147
1962,3,16,90,90,0,1962-3-16,90
1962,3,17,65,65,0,1962-3-17,65
1962,3,18,174,42,132,1962-3-18,-90
1962,3,19,2004,1895,109,1962-3-19,1786
1962,3,20,1572,1496,76,1962-3-20,1420
1962,3,21,1551,1513,38,1962-3-21,1475
1962,3,22,1510,1490,20,1962-3-22,1470
1962,3,23,1307,1280,27,1962-3-23,1253
1962,3,24,1109,1071,38,1962-3-24,1033
1962,3,25,1073,1066,7,1962-3-25,1059
1962,3,26,922,913,9,1962-3-26,904
1962,3,27,934,923,11,1962-3-27,912
1962,3,28,981,981,0,1962-3-28,981
1962,3,29,651,637,14,1962-3-29,623
1962,3,30,731,697,34,1962-3-30,663
1962,3,31,319,290,29,1962-3-31,261
1962,4,1,113,87,26,1962-4-1,61
1962,4,2,192,169,23,1962-4-2,146
1962,4,3,204,140,64,1962-4-3,76
1962,4,4,215,124,91,1962-4-4,33
1962,4,5,109,72,37,1962-4-5,35
1962,4,6,94,54,40,1962-4-6,14
1962,4,7,103,65,38,1962-4-7,27
1962,4,8,157,128,29,1962-4-8,99
1962,4,9,211,204,7,1962-4-9,197
1962,4,10,157,157,0,1962-4-10,157
1962,4,11,291,8,283,1962-4-11,-275
1962,4,12,603,336,267,1962-4-12,69
1962,4,13,844,697,147,1962-4-13,550
1962,4,14,973,902,71,1962-4-14,831
1962,4,15,1124,1056,68,1962-4-15,988
1962,4,16,1051,1028,23,1962-4-16,1005
1962,4,17,1115,1092,23,1962-4-17,1069
1962,4,18,884,884,0,1962-4-18,884
1962,4,19,864,864,0,1962-4-19,864
1962,4,20,715,708,7,1962-4-20,701
1962,4,21,676,636,40,1962-4-21,596
1962,4,22,682,592,90,1962-4-22,502
1962,4,23,564,477,87,1962-4-23,390
1962,4,24,477,425,52,1962-4-24,373
1962,4,25,689,640,49,1962-4-25,591
1962,4,26,792,792,0,1962-4-26,792
1962,4,27,744,744,0,1962-4-27,744
1962,4,28,802,802,0,1962-4-28,802
1962,4,29,621,621,0,1962-4-29,621
1962,4,30,562,557,5,1962-4-30,552
1962,5,1,722,718,4,1962-5-1,714
1962,5,2,769,769,0,1962-5-2,769
1962,5,3,798,798,0,1962-5-3,798
1962,5,4,686,686,0,1962-5-4,686
1962,5,5,495,495,0,1962-5-5,495
1962,5,6,400,388,12,1962-5-6,376
1962,5,7,174,174,0,1962-5-7,174
1962,5,8,362,44,318,1962-5-8,-274
1962,5,9,293,46,247,1962-5-9,-201
1962,5,10,393,33,360,1962-5-10,-327
1962,5,11,618,14,604,1962-5-11,-590
1962,5,12,724,13,711,1962-5-12,-698
1962,5,13,666,20,646,1962-5-13,-626
1962,5,14,167,7,160,1962-5-14,-153
1962,5,15,187,0,187,1962-5-15,-187
1962,5,16,233,79,154,1962-5-16,-75
1962,5,17,296,56,240,1962-5-17,-184
1962,5,18,198,39,159,1962-5-18,-120
1962,5,19,183,27,156,1962-5-19,-129
1962,5,20,617,462,155,1962-5-20,307
1962,5,21,718,448,270,1962-5-21,178
1962,5,22,1391,482,909,1962-5-22,-427
1962,5,23,1211,323,888,1962-5-23,-565
1962,5,24,1119,277,842,1962-5-24,-565
1962,5,25,940,244,696,1962-5-25,-452
1962,5,26,812,196,616,1962-5-26,-420
1962,5,27,760,108,652,1962-5-27,-544
1962,5,28,780,101,679,1962-5-28,-578
1962,5,29,750,188,562,1962-5-29,-374
1962,5,30,1023,355,668,1962-5-30,-313
1962,5,31,1170,477,693,1962-5-31,-216
1962,6,1,677,92,585,1962-6-1,-493
1962,6,2,636,33,603,1962-6-2,-570
1962,6,3,324,5,319,1962-6-3,-314
1962,6,4,23,8,15,1962-6-4,-7
1962,6,5,197,29,168,1962-6-5,-139
1962,6,6,233,60,173,1962-6-6,-113
1962,6,7,162,50,112,1962-6-7,-62
1962,6,8,130,33,97,1962-6-8,-64
1962,6,9,251,13,238,1962-6-9,-225
1962,6,10,159,0,159,1962-6-10,-159
1962,6,11,136,28,108,1962-6-11,-80
1962,6,12,136,47,89,1962-6-12,-42
1962,6,13,114,25,89,1962-6-13,-64
1962,6,14,137,39,98,1962-6-14,-59
1962,6,15,179,67,112,1962-6-15,-45
1962,6,16,152,81,71,1962-6-16,10
1962,6,17,294,224,70,1962-6-17,154
1962,6,18,197,92,105,1962-6-18,-13
1962,6,19,365,132,233,1962-6-19,-101
1962,6,20,326,139,187,1962-6-20,-48
1962,6,21,119,108,11,1962-6-21,97
1962,6,22,166,119,47,1962-6-22,72
1962,6,23,161,148,13,1962-6-23,135
1962,6,24,840,840,0,1962-6-24,840
1962,6,25,756,81,675,1962-6-25,-594
1962,6,26,789,8,781,1962-6-26,-773
1962,6,27,793,574,219,1962-6-27,355
1962,6,28,780,0,780,1962-6-28,-780
1962,6,29,870,0,870,1962-6-29,-870
1962,6,30,782,0,782,1962-6-30,-782
1962,7,1,641,0,641,1962-7-1,-641
1962,7,2,496,392,104,1962-7-2,288
1962,7,3,461,389,72,1962-7-3,317
1962,7,4,500,470,30,1962-7-4,440
1962,7,5,518,489,29,1962-7-5,460
1962,7,6,950,950,0,1962-7-6,950
1962,7,7,607,607,0,1962-7-7,607
1962,7,8,358,353,5,1962-7-8,348
1962,7,9,295,295,0,1962-7-9,295
1962,7,10,302,302,0,1962-7-10,302
1962,7,11,328,328,0,1962-7-11,328
1962,7,12,300,300,0,1962-7-12,300
1962,7,13,356,334,22,1962-7-13,312
1962,7,14,329,322,7,1962-7-14,315
1962,7,15,311,311,0,1962-7-15,311
1962,7,16,297,296,1,1962-7-16,295
1962,7,17,332,325,7,1962-7-17,318
1962,7,18,274,266,8,1962-7-18,258
1962,7,19,7,7,0,1962-7-19,7
1962,7,20,13,13,0,1962-7-20,13
1962,7,21,136,128,8,1962-7-21,120
1962,7,22,86,86,0,1962-7-22,86
1962,7,23,89,89,0,1962-7-23,89
1962,7,24,49,49,0,1962-7-24,49
1962,7,25,23,23,0,1962-7-25,23
1962,7,26,11,11,0,1962-7-26,11
1962,7,27,12,0,12,1962-7-27,-12
1962,7,28,19,19,0,1962-7-28,19
1962,7,29,25,25,0,1962-7-29,25
1962,7,30,24,24,0,1962-7-30,24
1962,7,31,0,0,0,1962-7-31,0
1962,8,1,0,0,0,1962-8-1,0
1962,8,2,4,4,0,1962-8-2,4
1962,8,3,0,0,0,1962-8-3,0
1962,8,4,16,0,16,1962-8-4,-16
1962,8,5,4,3,1,1962-8-5,2
1962,8,6,27,27,0,1962-8-6,27
1962,8,7,10,10,0,1962-8-7,10
1962,8,8,25,25,0,1962-8-8,25
1962,8,9,0,0,0,1962-8-9,0
1962,8,10,0,0,0,1962-8-10,0
1962,8,11,0,0,0,1962-8-11,0
1962,8,12,39,39,0,1962-8-12,39
1962,8,13,155,155,0,1962-8-13,155
1962,8,14,462,462,0,1962-8-14,462
1962,8,15,575,575,0,1962-8-15,575
1962,8,16,566,566,0,1962-8-16,566
1962,8,17,410,410,0,1962-8-17,410
1962,8,18,513,513,0,1962-8-18,513
1962,8,19,345,345,0,1962-8-19,345
1962,8,20,224,224,0,1962-8-20,224
1962,8,21,183,183,0,1962-8-21,183
1962,8,22,132,132,0,1962-8-22,132
1962,8,23,110,108,2,1962-8-23,106
1962,8,24,280,80,200,1962-8-24,-120
1962,8,25,42,42,0,1962-8-25,42
1962,8,26,38,38,0,1962-8-26,38
1962,8,27,40,11,29,1962-8-27,-18
1962,8,28,22,0,22,1962-8-28,-22
1962,8,29,30,0,30,1962-8-29,-30
1962,8,30,50,18,32,1962-8-30,-14
1962,8,31,47,42,5,1962-8-31,37
1962,9,1,466,402,64,1962-9-1,338
1962,9,2,703,560,143,1962-9-2,417
1962,9,3,1144,817,327,1962-9-3,490
1962,9,4,1627,1249,378,1962-9-4,871
1962,9,5,1625,1326,299,1962-9-5,1027
1962,9,6,1360,1131,229,1962-9-6,902
1962,9,7,1325,1113,212,1962-9-7,901
1962,9,8,1374,1069,305,1962-9-8,764
1962,9,9,894,647,247,1962-9-9,400
1962,9,10,629,401,228,1962-9-10,173
1962,9,11,578,413,165,1962-9-11,248
1962,9,12,767,606,161,1962-9-12,445
1962,9,13,990,823,167,1962-9-13,656
1962,9,14,845,709,136,1962-9-14,573
1962,9,15,663,544,119,1962-9-15,425
1962,9,16,571,571,0,1962-9-16,571
1962,9,17,366,366,0,1962-9-17,366
1962,9,18,377,377,0,1962-9-18,377
1962,9,19,318,318,0,1962-9-19,318
1962,9,20,161,156,5,1962-9-20,151
1962,9,21,200,160,40,1962-9-21,120
1962,9,22,287,269,18,1962-9-22,251
1962,9,23,202,202,0,1962-9-23,202
1962,9,24,207,207,0,1962-9-24,207
1962,9,25,346,346,0,1962-9-25,346
1962,9,26,178,178,0,1962-9-26,178
1962,9,27,273,273,0,1962-9-27,273
1962,9,28,430,430,0,1962-9-28,430
1962,9,29,346,346,0,1962-9-29,346
1962,9,30,473,456,17,1962-9-30,439
1962,10,1,512,467,45,1962-10-1,422
1962,10,2,346,345,1,1962-10-2,344
1962,10,3,253,253,0,1962-10-3,253
1962,10,4,175,175,0,1962-10-4,175
1962,10,5,174,174,0,1962-10-5,174
1962,10,6,160,160,0,1962-10-6,160
1962,10,7,217,217,0,1962-10-7,217
1962,10,8,472,208,264,1962-10-8,-56
1962,10,9,643,209,434,1962-10-9,-225
1962,10,10,776,371,405,1962-10-10,-34
1962,10,11,667,300,367,1962-10-11,-67
1962,10,12,583,255,328,1962-10-12,-73
1962,10,13,643,303,340,1962-10-13,-37
1962,10,14,634,329,305,1962-10-14,24
1962,10,15,466,292,174,1962-10-15,118
1962,10,16,454,299,155,1962-10-16,144
1962,10,17,324,244,80,1962-10-17,164
1962,10,18,218,152,66,1962-10-18,86
1962,10,19,186,135,51,1962-10-19,84
1962,10,20,305,288,17,1962-10-20,271
1962,10,21,453,453,0,1962-10-21,453
1962,10,22,415,386,29,1962-10-22,357
1962,10,23,389,368,21,1962-10-23,347
1962,10,24,334,246,88,1962-10-24,158
1962,10,25,324,234,90,1962-10-25,144
1962,10,26,291,196,95,1962-10-26,101
1962,10,27,385,270,115,1962-10-27,155
1962,10,28,235,235,0,1962-10-28,235
1962,10,29,176,176,0,1962-10-29,176
1962,10,30,161,161,0,1962-10-30,161
1962,10,31,148,148,0,1962-10-31,148
1962,11,1,75,55,20,1962-11-1,35
1962,11,2,28,0,28,1962-11-2,-28
1962,11,3,54,0,54,1962-11-3,-54
1962,11,4,45,0,45,1962-11-4,-45
1962,11,5,17,0,17,1962-11-5,-17
1962,11,6,432,0,432,1962-11-6,-432
1962,11,7,405,2,403,1962-11-7,-401
1962,11,8,426,0,426,1962-11-8,-426
1962,11,9,365,0,365,1962-11-9,-365
1962,11,10,383,0,383,1962-11-10,-383
1962,11,11,359,0,359,1962-11-11,-359
1962,11,12,522,108,414,1962-11-12,-306
1962,11,13,578,218,360,1962-11-13,-142
1962,11,14,597,258,339,1962-11-14,-81
1962,11,15,600,219,381,1962-11-15,-162
1962,11,16,625,230,395,1962-11-16,-165
1962,11,17,718,326,392,1962-11-17,-66
1962,11,18,681,274,407,1962-11-18,-133
1962,11,19,246,161,85,1962-11-19,76
1962,11,20,213,158,55,1962-11-20,103
1962,11,21,139,121,18,1962-11-21,103
1962,11,22,106,96,10,1962-11-22,86
1962,11,23,0,0,0,1962-11-23,0
1962,11,24,16,16,0,1962-11-24,16
1962,11,25,240,240,0,1962-11-25,240
1962,11,26,180,180,0,1962-11-26,180
1962,11,27,174,174,0,1962-11-27,174
1962,11,28,153,153,0,1962-11-28,153
1962,11,29,157,157,0,1962-11-29,157
1962,11,30,200,200,0,1962-11-30,200
1962,12,1,303,303,0,1962-12-1,303
1962,12,2,349,349,0,1962-12-2,349
1962,12,3,708,369,339,1962-12-3,30
1962,12,4,521,261,260,1962-12-4,1
1962,12,5,493,241,252,1962-12-5,-11
1962,12,6,374,152,222,1962-12-6,-70
1962,12,7,266,61,205,1962-12-7,-144
1962,12,8,194,14,180,1962-12-8,-166
1962,12,9,111,0,111,1962-12-9,-111
1962,12,10,78,0,78,1962-12-10,-78
1962,12,11,37,0,37,1962-12-11,-37
1962,12,12,39,0,39,1962-12-12,-39
1962,12,13,22,0,22,1962-12-13,-22
1962,12,14,34,0,34,1962-12-14,-34
1962,12,15,21,0,21,1962-12-15,-21
1962,12,16,0,0,0,1962-12-16,0
1962,12,17,109,0,109,1962-12-17,-109
1962,12,18,208,108,100,1962-12-18,8
1962,12,19,170,135,35,1962-12-19,100
1962,12,20,211,211,0,1962-12-20,211
1962,12,21,347,332,15,1962-12-21,317
1962,12,22,236,236,0,1962-12-22,236
1962,12,23,214,214,0,1962-12-23,214
1962,12,24,269,269,0,1962-12-24,269
1962,12,25,54,54,0,1962-12-25,54
1962,12,26,17,17,0,1962-12-26,17
1962,12,27,0,0,0,1962-12-27,0
1962,12,28,0,0,0,1962-12-28,0
1962,12,29,0,0,0,1962-12-29,0
1962,12,30,0,0,0,1962-12-30,0
1962,12,31,8,8,0,1962-12-31,8
1963,1,1,93,93,0,1963-1-1,93
1963,1,2,111,97,14,1963-1-2,83
1963,1,3,93,64,29,1963-1-3,35
1963,1,4,83,48,35,1963-1-4,13
1963,1,5,35,17,18,1963-1-5,-1
1963,1,6,46,0,46,1963-1-6,-46
1963,1,7,38,38,0,1963-1-7,38
1963,1,8,0,0,0,1963-1-8,0
1963,1,9,0,0,0,1963-1-9,0
1963,1,10,160,160,0,1963-1-10,160
1963,1,11,162,162,0,1963-1-11,162
1963,1,12,174,174,0,1963-1-12,174
1963,1,13,127,127,0,1963-1-13,127
1963,1,14,417,417,0,1963-1-14,417
1963,1,15,558,558,0,1963-1-15,558
1963,1,16,409,409,0,1963-1-16,409
1963,1,17,436,436,0,1963-1-17,436
1963,1,18,361,361,0,1963-1-18,361
1963,1,19,277,277,0,1963-1-19,277
1963,1,20,224,224,0,1963-1-20,224
1963,1,21,205,205,0,1963-1-21,205
1963,1,22,0,0,0,1963-1-22,0
1963,1,23,26,26,0,1963-1-23,26
1963,1,24,12,12,0,1963-1-24,12
1963,1,25,27,27,0,1963-1-25,27
1963,1,26,19,19,0,1963-1-26,19
1963,1,27,19,19,0,1963-1-27,19
1963,1,28,79,79,0,1963-1-28,79
1963,1,29,302,302,0,1963-1-29,302
1963,1,30,521,521,0,1963-1-30,521
1963,1,31,397,397,0,1963-1-31,397
1963,2,1,715,567,148,1963-2-1,419
1963,2,2,452,88,364,1963-2-2,-276
1963,2,3,479,134,345,1963-2-3,-211
1963,2,4,427,119,308,1963-2-4,-189
1963,2,5,361,94,267,1963-2-5,-173
1963,2,6,354,160,194,1963-2-6,-34
1963,2,7,308,140,168,1963-2-7,-28
1963,2,8,264,134,130,1963-2-8,4
1963,2,9,157,101,56,1963-2-9,45
1963,2,10,185,123,62,1963-2-10,61
1963,2,11,154,103,51,1963-2-11,52
1963,2,12,105,105,0,1963-2-12,105
1963,2,13,88,88,0,1963-2-13,88
1963,2,14,115,102,13,1963-2-14,89
1963,2,15,110,110,0,1963-2-15,110
1963,2,16,131,131,0,1963-2-16,131
1963,2,17,224,224,0,1963-2-17,224
1963,2,18,253,253,0,1963-2-18,253
1963,2,19,119,119,0,1963-2-19,119
1963,2,20,99,99,0,1963-2-20,99
1963,2,21,75,75,0,1963-2-21,75
1963,2,22,82,82,0,1963-2-22,82
1963,2,23,58,58,0,1963-2-23,58
1963,2,24,53,53,0,1963-2-24,53
1963,2,25,16,16,0,1963-2-25,16
1963,2,26,30,30,0,1963-2-26,30
1963,2,27,22,22,0,1963-2-27,22
1963,2,28,0,0,0,1963-2-28,0
1963,3,1,0,0,0,1963-3-1,0
1963,3,2,0,0,0,1963-3-2,0
1963,3,3,54,54,0,1963-3-3,54
1963,3,4,303,303,0,1963-3-4,303
1963,3,5,266,262,4,1963-3-5,258
1963,3,6,223,223,0,1963-3-6,223
1963,3,7,207,207,0,1963-3-7,207
1963,3,8,164,164,0,1963-3-8,164
1963,3,9,99,99,0,1963-3-9,99
1963,3,10,58,58,0,1963-3-10,58
1963,3,11,55,55,0,1963-3-11,55
1963,3,12,40,40,0,1963-3-12,40
1963,3,13,33,33,0,1963-3-13,33
1963,3,14,27,12,15,1963-3-14,-3
1963,3,15,246,246,0,1963-3-15,246
1963,3,16,190,190,0,1963-3-16,190
1963,3,17,207,207,0,1963-3-17,207
1963,3,18,211,211,0,1963-3-18,211
1963,3,19,174,174,0,1963-3-19,174
1963,3,20,194,194,0,1963-3-20,194
1963,3,21,178,161,17,1963-3-21,144
1963,3,22,189,185,4,1963-3-22,181
1963,3,23,177,177,0,1963-3-23,177
1963,3,24,201,188,13,1963-3-24,175
1963,3,25,165,165,0,1963-3-25,165
1963,3,26,207,194,13,1963-3-26,181
1963,3,27,188,176,12,1963-3-27,164
1963,3,28,0,0,0,1963-3-28,0
1963,3,29,91,0,91,1963-3-29,-91
1963,3,30,160,0,160,1963-3-30,-160
1963,3,31,171,0,171,1963-3-31,-171
1963,4,1,140,0,140,1963-4-1,-140
1963,4,2,111,6,105,1963-4-2,-99
1963,4,3,77,0,77,1963-4-3,-77
1963,4,4,48,7,41,1963-4-4,-34
1963,4,5,34,16,18,1963-4-5,-2
1963,4,6,261,232,29,1963-4-6,203
1963,4,7,376,343,33,1963-4-7,310
1963,4,8,366,318,48,1963-4-8,270
1963,4,9,500,160,340,1963-4-9,-180
1963,4,10,481,76,405,1963-4-10,-329
1963,4,11,633,158,475,1963-4-11,-317
1963,4,12,691,211,480,1963-4-12,-269
1963,4,13,559,145,414,1963-4-13,-269
1963,4,14,460,0,460,1963-4-14,-460
1963,4,15,531,0,531,1963-4-15,-531
1963,4,16,589,0,589,1963-4-16,-589
1963,4,17,531,0,531,1963-4-17,-531
1963,4,18,604,0,604,1963-4-18,-604
1963,4,19,518,0,518,1963-4-19,-518
1963,4,20,395,0,395,1963-4-20,-395
1963,4,21,241,0,241,1963-4-21,-241
1963,4,22,6,6,0,1963-4-22,6
1963,4,23,0,0,0,1963-4-23,0
1963,4,24,0,0,0,1963-4-24,0
1963,4,25,0,0,0,1963-4-25,0
1963,4,26,0,0,0,1963-4-26,0
1963,4,27,0,0,0,1963-4-27,0
1963,4,28,325,325,0,1963-4-28,325
1963,4,29,278,278,0,1963-4-29,278
1963,4,30,336,336,0,1963-4-30,336
1963,5,1,347,347,0,1963-5-1,347
1963,5,2,324,324,0,1963-5-2,324
1963,5,3,257,257,0,1963-5-3,257
1963,5,4,262,262,0,1963-5-4,262
1963,5,5,154,154,0,1963-5-5,154
1963,5,6,216,162,54,1963-5-6,108
1963,5,7,277,120,157,1963-5-7,-37
1963,5,8,302,142,160,1963-5-8,-18
1963,5,9,515,125,390,1963-5-9,-265
1963,5,10,553,166,387,1963-5-10,-221
1963,5,11,427,40,387,1963-5-11,-347
1963,5,12,349,52,297,1963-5-12,-245
1963,5,13,476,166,310,1963-5-13,-144
1963,5,14,799,566,233,1963-5-14,333
1963,5,15,1065,864,201,1963-5-15,663
1963,5,16,1329,1130,199,1963-5-16,931
1963,5,17,933,776,157,1963-5-17,619
1963,5,18,1004,809,195,1963-5-18,614
1963,5,19,948,788,160,1963-5-19,628
1963,5,20,939,747,192,1963-5-20,555
1963,5,21,600,600,0,1963-5-21,600
1963,5,22,525,525,0,1963-5-22,525
1963,5,23,756,756,0,1963-5-23,756
1963,5,24,1033,1033,0,1963-5-24,1033
1963,5,25,580,580,0,1963-5-25,580
1963,5,26,10,10,0,1963-5-26,10
1963,5,27,54,54,0,1963-5-27,54
1963,5,28,105,105,0,1963-5-28,105
1963,5,29,106,100,6,1963-5-29,94
1963,5,30,175,175,0,1963-5-30,175
1963,5,31,302,302,0,1963-5-31,302
1963,6,1,277,277,0,1963-6-1,277
1963,6,2,233,230,3,1963-6-2,227
1963,6,3,20,20,0,1963-6-3,20
1963,6,4,18,16,2,1963-6-4,14
1963,6,5,93,12,81,1963-6-5,-69
1963,6,6,65,0,65,1963-6-6,-65
1963,6,7,130,7,123,1963-6-7,-116
1963,6,8,261,150,111,1963-6-8,39
1963,6,9,786,697,89,1963-6-9,608
1963,6,10,907,853,54,1963-6-10,799
1963,6,11,1034,1024,10,1963-6-11,1014
1963,6,12,1133,1129,4,1963-6-12,1125
1963,6,13,1024,1024,0,1963-6-13,1024
1963,6,14,979,979,0,1963-6-14,979
1963,6,15,855,855,0,1963-6-15,855
1963,6,16,724,724,0,1963-6-16,724
1963,6,17,502,502,0,1963-6-17,502
1963,6,18,152,152,0,1963-6-18,152
1963,6,19,56,56,0,1963-6-19,56
1963,6,20,71,71,0,1963-6-20,71
1963,6,21,59,59,0,1963-6-21,59
1963,6,22,11,11,0,1963-6-22,11
1963,6,23,18,18,0,1963-6-23,18
1963,6,24,123,123,0,1963-6-24,123
1963,6,25,267,267,0,1963-6-25,267
1963,6,26,249,249,0,1963-6-26,249
1963,6,27,177,177,0,1963-6-27,177
1963,6,28,124,124,0,1963-6-28,124
1963,6,29,98,98,0,1963-6-29,98
1963,6,30,37,37,0,1963-6-30,37
1963,7,1,53,53,0,1963-7-1,53
1963,7,2,32,32,0,1963-7-2,32
1963,7,3,368,368,0,1963-7-3,368
1963,7,4,370,370,0,1963-7-4,370
1963,7,5,170,170,0,1963-7-5,170
1963,7,6,228,228,0,1963-7-6,228
1963,7,7,160,160,0,1963-7-7,160
1963,7,8,173,173,0,1963-7-8,173
1963,7,9,161,161,0,1963-7-9,161
1963,7,10,165,165,0,1963-7-10,165
1963,7,11,170,170,0,1963-7-11,170
1963,7,12,171,171,0,1963-7-12,171
1963,7,13,189,189,0,1963-7-13,189
1963,7,14,220,220,0,1963-7-14,220
1963,7,15,193,193,0,1963-7-15,193
1963,7,16,19,19,0,1963-7-16,19
1963,7,17,37,37,0,1963-7-17,37
1963,7,18,32,32,0,1963-7-18,32
1963,7,19,57,57,0,1963-7-19,57
1963,7,20,68,68,0,1963-7-20,68
1963,7,21,50,50,0,1963-7-21,50
1963,7,22,44,44,0,1963-7-22,44
1963,7,23,55,45,10,1963-7-23,35
1963,7,24,93,93,0,1963-7-24,93
1963,7,25,74,74,0,1963-7-25,74
1963,7,26,22,22,0,1963-7-26,22
1963,7,27,46,46,0,1963-7-27,46
1963,7,28,7,7,0,1963-7-28,7
1963,7,29,71,71,0,1963-7-29,71
1963,7,30,336,336,0,1963-7-30,336
1963,7,31,752,752,0,1963-7-31,752
1963,8,1,717,717,0,1963-8-1,717
1963,8,2,569,569,0,1963-8-2,569
1963,8,3,604,604,0,1963-8-3,604
1963,8,4,618,618,0,1963-8-4,618
1963,8,5,587,587,0,1963-8-5,587
1963,8,6,593,593,0,1963-8-6,593
1963,8,7,488,488,0,1963-8-7,488
1963,8,8,439,439,0,1963-8-8,439
1963,8,9,494,494,0,1963-8-9,494
1963,8,10,204,204,0,1963-8-10,204
1963,8,11,254,254,0,1963-8-11,254
1963,8,12,10,0,10,1963-8-12,-10
1963,8,13,8,0,8,1963-8-13,-8
1963,8,14,17,15,2,1963-8-14,13
1963,8,15,27,0,27,1963-8-15,-27
1963,8,16,32,0,32,1963-8-16,-32
1963,8,17,218,0,218,1963-8-17,-218
1963,8,18,367,0,367,1963-8-18,-367
1963,8,19,406,0,406,1963-8-19,-406
1963,8,20,259,15,244,1963-8-20,-229
1963,8,21,261,57,204,1963-8-21,-147
1963,8,22,374,116,258,1963-8-22,-142
1963,8,23,543,197,346,1963-8-23,-149
1963,8,24,591,296,295,1963-8-24,1
1963,8,25,448,328,120,1963-8-25,208
1963,8,26,182,173,9,1963-8-26,164
1963,8,27,150,150,0,1963-8-27,150
1963,8,28,142,142,0,1963-8-28,142
1963,8,29,134,134,0,1963-8-29,134
1963,8,30,99,99,0,1963-8-30,99
1963,8,31,161,161,0,1963-8-31,161
1963,9,1,93,93,0,1963-9-1,93
1963,9,2,105,93,12,1963-9-2,81
1963,9,3,85,85,0,1963-9-3,85
1963,9,4,156,156,0,1963-9-4,156
1963,9,5,170,170,0,1963-9-5,170
1963,9,6,115,115,0,1963-9-6,115
1963,9,7,69,69,0,1963-9-7,69
1963,9,8,80,80,0,1963-9-8,80
1963,9,9,151,151,0,1963-9-9,151
1963,9,10,162,90,72,1963-9-10,18
1963,9,11,118,79,39,1963-9-11,40
1963,9,12,149,84,65,1963-9-12,19
1963,9,13,453,62,391,1963-9-13,-329
1963,9,14,1411,1005,406,1963-9-14,599
1963,9,15,1626,1209,417,1963-9-15,792
1963,9,16,1532,1193,339,1963-9-16,854
1963,9,17,1576,1303,273,1963-9-17,1030
1963,9,18,1376,1162,214,1963-9-18,948
1963,9,19,1418,1216,202,1963-9-19,1014
1963,9,20,1492,1308,184,1963-9-20,1124
1963,9,21,1503,1311,192,1963-9-21,1119
1963,9,22,1187,1187,0,1963-9-22,1187
1963,9,23,999,999,0,1963-9-23,999
1963,9,24,1000,1000,0,1963-9-24,1000
1963,9,25,818,803,15,1963-9-25,788
1963,9,26,806,806,0,1963-9-26,806
1963,9,27,0,0,0,1963-9-27,0
1963,9,28,31,31,0,1963-9-28,31
1963,9,29,0,0,0,1963-9-29,0
1963,9,30,0,0,0,1963-9-30,0
1963,10,1,0,0,0,1963-10-1,0
1963,10,2,0,0,0,1963-10-2,0
1963,10,3,26,26,0,1963-10-3,26
1963,10,4,2,2,0,1963-10-4,2
1963,10,5,0,0,0,1963-10-5,0
1963,10,6,294,294,0,1963-10-6,294
1963,10,7,357,357,0,1963-10-7,357
1963,10,8,375,375,0,1963-10-8,375
1963,10,9,442,442,0,1963-10-9,442
1963,10,10,380,380,0,1963-10-10,380
1963,10,11,488,488,0,1963-10-11,488
1963,10,12,357,357,0,1963-10-12,357
1963,10,13,363,363,0,1963-10-13,363
1963,10,14,311,311,0,1963-10-14,311
1963,10,15,371,371,0,1963-10-15,371
1963,10,16,493,493,0,1963-10-16,493
1963,10,17,470,456,14,1963-10-17,442
1963,10,18,295,295,0,1963-10-18,295
1963,10,19,120,120,0,1963-10-19,120
1963,10,20,791,791,0,1963-10-20,791
1963,10,21,877,877,0,1963-10-21,877
1963,10,22,949,949,0,1963-10-22,949
1963,10,23,969,969,0,1963-10-23,969
1963,10,24,780,776,4,1963-10-24,772
1963,10,25,726,703,23,1963-10-25,680
1963,10,26,604,526,78,1963-10-26,448
1963,10,27,607,435,172,1963-10-27,263
1963,10,28,410,410,0,1963-10-28,410
1963,10,29,550,414,136,1963-10-29,278
1963,10,30,490,417,73,1963-10-30,344
1963,10,31,555,555,0,1963-10-31,555
1963,11,1,268,268,0,1963-11-1,268
1963,11,2,454,438,16,1963-11-2,422
1963,11,3,467,59,408,1963-11-3,-349
1963,11,4,513,94,419,1963-11-4,-325
1963,11,5,239,37,202,1963-11-5,-165
1963,11,6,36,36,0,1963-11-6,36
1963,11,7,20,20,0,1963-11-7,20
1963,11,8,26,26,0,1963-11-8,26
1963,11,9,4,4,0,1963-11-9,4
1963,11,10,0,0,0,1963-11-10,0
1963,11,11,0,0,0,1963-11-11,0
1963,11,12,20,20,0,1963-11-12,20
1963,11,13,0,0,0,1963-11-13,0
1963,11,14,0,0,0,1963-11-14,0
1963,11,15,102,102,0,1963-11-15,102
1963,11,16,116,116,0,1963-11-16,116
1963,11,17,191,191,0,1963-11-17,191
1963,11,18,136,136,0,1963-11-18,136
1963,11,19,116,116,0,1963-11-19,116
1963,11,20,285,285,0,1963-11-20,285
1963,11,21,470,470,0,1963-11-21,470
1963,11,22,420,420,0,1963-11-22,420
1963,11,23,395,395,0,1963-11-23,395
1963,11,24,258,258,0,1963-11-24,258
1963,11,25,197,197,0,1963-11-25,197
1963,11,26,186,186,0,1963-11-26,186
1963,11,27,197,197,0,1963-11-27,197
1963,11,28,141,141,0,1963-11-28,141
1963,11,29,148,148,0,1963-11-29,148
1963,11,30,155,155,0,1963-11-30,155
1963,12,1,246,46,200,1963-12-1,-154
1963,12,2,252,29,223,1963-12-2,-194
1963,12,3,171,0,171,1963-12-3,-171
1963,12,4,153,0,153,1963-12-4,-153
1963,12,5,192,0,192,1963-12-5,-192
1963,12,6,153,0,153,1963-12-6,-153
1963,12,7,142,0,142,1963-12-7,-142
1963,12,8,101,0,101,1963-12-8,-101
1963,12,9,132,57,75,1963-12-9,-18
1963,12,10,105,67,38,1963-12-10,29
1963,12,11,87,78,9,1963-12-11,69
1963,12,12,41,41,0,1963-12-12,41
1963,12,13,24,24,0,1963-12-13,24
1963,12,14,0,0,0,1963-12-14,0
1963,12,15,18,18,0,1963-12-15,18
1963,12,16,0,0,0,1963-12-16,0
1963,12,17,7,7,0,1963-12-17,7
1963,12,18,25,25,0,1963-12-18,25
1963,12,19,24,24,0,1963-12-19,24
1963,12,20,52,52,0,1963-12-20,52
1963,12,21,44,44,0,1963-12-21,44
1963,12,22,39,39,0,1963-12-22,39
1963,12,23,11,11,0,1963-12-23,11
1963,12,24,68,68,0,1963-12-24,68
1963,12,25,51,51,0,1963-12-25,51
1963,12,26,0,0,0,1963-12-26,0
1963,12,27,0,0,0,1963-12-27,0
1963,12,28,0,0,0,1963-12-28,0
1963,12,29,0,0,0,1963-12-29,0
1963,12,30,0,0,0,1963-12-30,0
1963,12,31,0,0,0,1963-12-31,0
1964,1,1,0,0,0,1964-1-1,0
1964,1,2,18,14,4,1964-1-2,10
1964,1,3,14,14,0,1964-1-3,14
1964,1,4,2,0,2,1964-1-4,-2
1964,1,5,44,0,44,1964-1-5,-44
1964,1,6,34,0,34,1964-1-6,-34
1964,1,7,43,0,43,1964-1-7,-43
1964,1,8,12,0,12,1964-1-8,-12
1964,1,9,9,0,9,1964-1-9,-9
1964,1,10,10,0,10,1964-1-10,-10
1964,1,11,17,0,17,1964-1-11,-17
1964,1,12,25,0,25,1964-1-12,-25
1964,1,13,49,43,6,1964-1-13,37
1964,1,14,65,60,5,1964-1-14,55
1964,1,15,42,42,0,1964-1-15,42
1964,1,16,35,35,0,1964-1-16,35
1964,1,17,6,6,0,1964-1-17,6
1964,1,18,11,11,0,1964-1-18,11
1964,1,19,195,195,0,1964-1-19,195
1964,1,20,182,182,0,1964-1-20,182
1964,1,21,185,185,0,1964-1-21,185
1964,1,22,170,170,0,1964-1-22,170
1964,1,23,160,160,0,1964-1-23,160
1964,1,24,164,164,0,1964-1-24,164
1964,1,25,125,125,0,1964-1-25,125
1964,1,26,141,141,0,1964-1-26,141
1964,1,27,123,123,0,1964-1-27,123
1964,1,28,209,89,120,1964-1-28,-31
1964,1,29,413,35,378,1964-1-29,-343
1964,1,30,558,13,545,1964-1-30,-532
1964,1,31,197,0,197,1964-1-31,-197
1964,2,1,0,0,0,1964-2-1,0
1964,2,2,0,0,0,1964-2-2,0
1964,2,3,0,0,0,1964-2-3,0
1964,2,4,0,0,0,1964-2-4,0
1964,2,5,0,0,0,1964-2-5,0
1964,2,6,0,0,0,1964-2-6,0
1964,2,7,1,0,1,1964-2-7,-1
1964,2,8,36,0,36,1964-2-8,-36
1964,2,9,51,4,47,1964-2-9,-43
1964,2,10,39,0,39,1964-2-10,-39
1964,2,11,9,0,9,1964-2-11,-9
1964,2,12,0,0,0,1964-2-12,0
1964,2,13,0,0,0,1964-2-13,0
1964,2,14,0,0,0,1964-2-14,0
1964,2,15,81,10,71,1964-2-15,-61
1964,2,16,78,14,64,1964-2-16,-50
1964,2,17,79,21,58,1964-2-17,-37
1964,2,18,63,9,54,1964-2-18,-45
1964,2,19,43,15,28,1964-2-19,-13
1964,2,20,76,60,16,1964-2-20,44
1964,2,21,109,98,11,1964-2-21,87
1964,2,22,152,138,14,1964-2-22,124
1964,2,23,193,180,13,1964-2-23,167
1964,2,24,200,190,10,1964-2-24,180
1964,2,25,211,196,15,1964-2-25,181
1964,2,26,197,186,11,1964-2-26,175
1964,2,27,265,265,0,1964-2-27,265
1964,2,28,273,273,0,1964-2-28,273
1964,2,29,280,278,2,1964-2-29,276
1964,3,1,253,249,4,1964-3-1,245
1964,3,2,2,0,2,1964-3-2,-2
1964,3,3,8,8,0,1964-3-3,8
1964,3,4,13,13,0,1964-3-4,13
1964,3,5,7,7,0,1964-3-5,7
1964,3,6,3,3,0,1964-3-6,3
1964,3,7,5,0,5,1964-3-7,-5
1964,3,8,2,0,2,1964-3-8,-2
1964,3,9,0,0,0,1964-3-9,0
1964,3,10,0,0,0,1964-3-10,0
1964,3,11,66,58,8,1964-3-11,50
1964,3,12,201,124,77,1964-3-12,47
1964,3,13,162,88,74,1964-3-13,14
1964,3,14,162,135,27,1964-3-14,108
1964,3,15,329,329,0,1964-3-15,329
1964,3,16,460,460,0,1964-3-16,460
1964,3,17,460,460,0,1964-3-17,460
1964,3,18,172,172,0,1964-3-18,172
1964,3,19,169,169,0,1964-3-19,169
1964,3,20,151,151,0,1964-3-20,151
1964,3,21,163,163,0,1964-3-21,163
1964,3,22,336,336,0,1964-3-22,336
1964,3,23,352,352,0,1964-3-23,352
1964,3,24,393,393,0,1964-3-24,393
1964,3,25,326,326,0,1964-3-25,326
1964,3,26,212,212,0,1964-3-26,212
1964,3,27,119,116,3,1964-3-27,113
1964,3,28,105,68,37,1964-3-28,31
1964,3,29,14,0,14,1964-3-29,-14
1964,3,30,0,0,0,1964-3-30,0
1964,3,31,0,0,0,1964-3-31,0
1964,4,1,16,16,0,1964-4-1,16
1964,4,2,15,15,0,1964-4-2,15
1964,4,3,0,0,0,1964-4-3,0
1964,4,4,0,0,0,1964-4-4,0
1964,4,5,18,18,0,1964-4-5,18
1964,4,6,41,41,0,1964-4-6,41
1964,4,7,36,36,0,1964-4-7,36
1964,4,8,28,28,0,1964-4-8,28
1964,4,9,14,14,0,1964-4-9,14
1964,4,10,11,7,4,1964-4-10,3
1964,4,11,5,5,0,1964-4-11,5
1964,4,12,26,26,0,1964-4-12,26
1964,4,13,21,21,0,1964-4-13,21
1964,4,14,8,8,0,1964-4-14,8
1964,4,15,0,0,0,1964-4-15,0
1964,4,16,0,0,0,1964-4-16,0
1964,4,17,0,0,0,1964-4-17,0
1964,4,18,0,0,0,1964-4-18,0
1964,4,19,0,0,0,1964-4-19,0
1964,4,20,33,0,33,1964-4-20,-33
1964,4,21,61,0,61,1964-4-21,-61
1964,4,22,55,0,55,1964-4-22,-55
1964,4,23,36,0,36,1964-4-23,-36
1964,4,24,48,0,48,1964-4-24,-48
1964,4,25,46,0,46,1964-4-25,-46
1964,4,26,10,0,10,1964-4-26,-10
1964,4,27,7,0,7,1964-4-27,-7
1964,4,28,0,0,0,1964-4-28,0
1964,4,29,0,0,0,1964-4-29,0
1964,4,30,0,0,0,1964-4-30,0
1964,5,1,5,5,0,1964-5-1,5
1964,5,2,0,0,0,1964-5-2,0
1964,5,3,0,0,0,1964-5-3,0
1964,5,4,24,0,24,1964-5-4,-24
1964,5,5,38,0,38,1964-5-5,-38
1964,5,6,26,0,26,1964-5-6,-26
1964,5,7,26,0,26,1964-5-7,-26
1964,5,8,34,0,34,1964-5-8,-34
1964,5,9,14,0,14,1964-5-9,-14
1964,5,10,10,0,10,1964-5-10,-10
1964,5,11,25,0,25,1964-5-11,-25
1964,5,12,0,0,0,1964-5-12,0
1964,5,13,0,0,0,1964-5-13,0
1964,5,14,7,7,0,1964-5-14,7
1964,5,15,26,26,0,1964-5-15,26
1964,5,16,35,35,0,1964-5-16,35
1964,5,17,51,51,0,1964-5-17,51
1964,5,18,46,46,0,1964-5-18,46
1964,5,19,15,15,0,1964-5-19,15
1964,5,20,9,9,0,1964-5-20,9
1964,5,21,4,4,0,1964-5-21,4
1964,5,22,39,39,0,1964-5-22,39
1964,5,23,75,75,0,1964-5-23,75
1964,5,24,36,36,0,1964-5-24,36
1964,5,25,35,35,0,1964-5-25,35
1964,5,26,37,37,0,1964-5-26,37
1964,5,27,68,68,0,1964-5-27,68
1964,5,28,76,76,0,1964-5-28,76
1964,5,29,70,70,0,1964-5-29,70
1964,5,30,70,70,0,1964-5-30,70
1964,5,31,57,57,0,1964-5-31,57
1964,6,1,41,41,0,1964-6-1,41
1964,6,2,20,20,0,1964-6-2,20
1964,6,3,19,19,0,1964-6-3,19
1964,6,4,15,15,0,1964-6-4,15
1964,6,5,0,0,0,1964-6-5,0
1964,6,6,0,0,0,1964-6-6,0
1964,6,7,12,12,0,1964-6-7,12
1964,6,8,0,0,0,1964-6-8,0
1964,6,9,12,12,0,1964-6-9,12
1964,6,10,2,2,0,1964-6-10,2
1964,6,11,28,28,0,1964-6-11,28
1964,6,12,17,17,0,1964-6-12,17
1964,6,13,27,27,0,1964-6-13,27
1964,6,14,75,75,0,1964-6-14,75
1964,6,15,95,95,0,1964-6-15,95
1964,6,16,96,96,0,1964-6-16,96
1964,6,17,34,34,0,1964-6-17,34
1964,6,18,52,52,0,1964-6-18,52
1964,6,19,60,60,0,1964-6-19,60
1964,6,20,71,71,0,1964-6-20,71
1964,6,21,15,15,0,1964-6-21,15
1964,6,22,4,4,0,1964-6-22,4
1964,6,23,8,8,0,1964-6-23,8
1964,6,24,7,0,7,1964-6-24,-7
1964,6,25,0,0,0,1964-6-25,0
1964,6,26,0,0,0,1964-6-26,0
1964,6,27,0,0,0,1964-6-27,0
1964,6,28,0,0,0,1964-6-28,0
1964,6,29,22,0,22,1964-6-29,-22
1964,6,30,23,0,23,1964-6-30,-23
1964,7,1,6,0,6,1964-7-1,-6
1964,7,2,0,0,0,1964-7-2,0
1964,7,3,10,10,0,1964-7-3,10
1964,7,4,23,23,0,1964-7-4,23
1964,7,5,21,21,0,1964-7-5,21
1964,7,6,8,8,0,1964-7-6,8
1964,7,7,0,0,0,1964-7-7,0
1964,7,8,0,0,0,1964-7-8,0
1964,7,9,0,0,0,1964-7-9,0
1964,7,10,0,0,0,1964-7-10,0
1964,7,11,0,0,0,1964-7-11,0
1964,7,12,0,0,0,1964-7-12,0
1964,7,13,0,0,0,1964-7-13,0
1964,7,14,31,31,0,1964-7-14,31
1964,7,15,74,74,0,1964-7-15,74
1964,7,16,29,29,0,1964-7-16,29
1964,7,17,25,25,0,1964-7-17,25
1964,7,18,5,5,0,1964-7-18,5
1964,7,19,5,5,0,1964-7-19,5
1964,7,20,0,0,0,1964-7-20,0
1964,7,21,0,0,0,1964-7-21,0
1964,7,22,0,0,0,1964-7-22,0
1964,7,23,0,0,0,1964-7-23,0
1964,7,24,0,0,0,1964-7-24,0
1964,7,25,0,0,0,1964-7-25,0
1964,7,26,0,0,0,1964-7-26,0
1964,7,27,0,0,0,1964-7-27,0
1964,7,28,0,0,0,1964-7-28,0
1964,7,29,0,0,0,1964-7-29,0
1964,7,30,0,0,0,1964-7-30,0
1964,7,31,0,0,0,1964-7-31,0
1964,8,1,22,22,0,1964-8-1,22
1964,8,2,42,42,0,1964-8-2,42
1964,8,3,36,36,0,1964-8-3,36
1964,8,4,11,11,0,1964-8-4,11
1964,8,5,13,13,0,1964-8-5,13
1964,8,6,14,14,0,1964-8-6,14
1964,8,7,12,12,0,1964-8-7,12
1964,8,8,0,0,0,1964-8-8,0
1964,8,9,0,0,0,1964-8-9,0
1964,8,10,0,0,0,1964-8-10,0
1964,8,11,27,27,0,1964-8-11,27
1964,8,12,58,58,0,1964-8-12,58
1964,8,13,93,93,0,1964-8-13,93
1964,8,14,357,357,0,1964-8-14,357
1964,8,15,412,412,0,1964-8-15,412
1964,8,16,391,391,0,1964-8-16,391
1964,8,17,33,33,0,1964-8-17,33
1964,8,18,12,12,0,1964-8-18,12
1964,8,19,14,14,0,1964-8-19,14
1964,8,20,20,20,0,1964-8-20,20
1964,8,21,23,23,0,1964-8-21,23
1964,8,22,0,0,0,1964-8-22,0
1964,8,23,0,0,0,1964-8-23,0
1964,8,24,0,0,0,1964-8-24,0
1964,8,25,0,0,0,1964-8-25,0
1964,8,26,0,0,0,1964-8-26,0
1964,8,27,0,0,0,1964-8-27,0
1964,8,28,0,0,0,1964-8-28,0
1964,8,29,0,0,0,1964-8-29,0
1964,8,30,0,0,0,1964-8-30,0
1964,8,31,6,6,0,1964-8-31,6
1964,9,1,16,16,0,1964-9-1,16
1964,9,2,33,33,0,1964-9-2,33
1964,9,3,13,13,0,1964-9-3,13
1964,9,4,0,0,0,1964-9-4,0
1964,9,5,0,0,0,1964-9-5,0
1964,9,6,0,0,0,1964-9-6,0
1964,9,7,4,4,0,1964-9-7,4
1964,9,8,24,24,0,1964-9-8,24
1964,9,9,37,37,0,1964-9-9,37
1964,9,10,37,37,0,1964-9-10,37
1964,9,11,81,81,0,1964-9-11,81
1964,9,12,117,117,0,1964-9-12,117
1964,9,13,76,76,0,1964-9-13,76
1964,9,14,34,34,0,1964-9-14,34
1964,9,15,19,19,0,1964-9-15,19
1964,9,16,0,0,0,1964-9-16,0
1964,9,17,0,0,0,1964-9-17,0
1964,9,18,0,0,0,1964-9-18,0
1964,9,19,0,0,0,1964-9-19,0
1964,9,20,0,0,0,1964-9-20,0
1964,9,21,0,0,0,1964-9-21,0
1964,9,22,0,0,0,1964-9-22,0
1964,9,23,0,0,0,1964-9-23,0
1964,9,24,0,0,0,1964-9-24,0
1964,9,25,0,0,0,1964-9-25,0
1964,9,26,0,0,0,1964-9-26,0
1964,9,27,7,7,0,1964-9-27,7
1964,9,28,0,0,0,1964-9-28,0
1964,9,29,0,0,0,1964-9-29,0
1964,9,30,0,0,0,1964-9-30,0
1964,10,1,46,23,23,1964-10-1,0
1964,10,2,36,14,22,1964-10-2,-8
1964,10,3,4,0,4,1964-10-3,-4
1964,10,4,3,0,3,1964-10-4,-3
1964,10,5,0,0,0,1964-10-5,0
1964,10,6,45,45,0,1964-10-6,45
1964,10,7,90,70,20,1964-10-7,50
1964,10,8,163,161,2,1964-10-8,159
1964,10,9,127,127,0,1964-10-9,127
1964,10,10,19,19,0,1964-10-10,19
1964,10,11,0,0,0,1964-10-11,0
1964,10,12,0,0,0,1964-10-12,0
1964,10,13,6,6,0,1964-10-13,6
1964,10,14,2,2,0,1964-10-14,2
1964,10,15,0,0,0,1964-10-15,0
1964,10,16,0,0,0,1964-10-16,0
1964,10,17,0,0,0,1964-10-17,0
1964,10,18,29,29,0,1964-10-18,29
1964,10,19,42,42,0,1964-10-19,42
1964,10,20,24,24,0,1964-10-20,24
1964,10,21,0,0,0,1964-10-21,0
1964,10,22,8,8,0,1964-10-22,8
1964,10,23,0,0,0,1964-10-23,0
1964,10,24,0,0,0,1964-10-24,0
1964,10,25,33,33,0,1964-10-25,33
1964,10,26,11,11,0,1964-10-26,11
1964,10,27,26,17,9,1964-10-27,8
1964,10,28,0,0,0,1964-10-28,0
1964,10,29,0,0,0,1964-10-29,0
1964,10,30,20,20,0,1964-10-30,20
1964,10,31,28,0,28,1964-10-31,-28
1964,11,1,39,0,39,1964-11-1,-39
1964,11,2,15,0,15,1964-11-2,-15
1964,11,3,14,0,14,1964-11-3,-14
1964,11,4,0,0,0,1964-11-4,0
1964,11,5,0,0,0,1964-11-5,0
1964,11,6,6,6,0,1964-11-6,6
1964,11,7,0,0,0,1964-11-7,0
1964,11,8,8,8,0,1964-11-8,8
1964,11,9,0,0,0,1964-11-9,0
1964,11,10,13,13,0,1964-11-10,13
1964,11,11,0,0,0,1964-11-11,0
1964,11,12,20,20,0,1964-11-12,20
1964,11,13,11,11,0,1964-11-13,11
1964,11,14,20,20,0,1964-11-14,20
1964,11,15,16,16,0,1964-11-15,16
1964,11,16,50,50,0,1964-11-16,50
1964,11,17,102,102,0,1964-11-17,102
1964,11,18,125,94,31,1964-11-18,63
1964,11,19,117,101,16,1964-11-19,85
1964,11,20,135,135,0,1964-11-20,135
1964,11,21,72,72,0,1964-11-21,72
1964,11,22,24,24,0,1964-11-22,24
1964,11,23,0,0,0,1964-11-23,0
1964,11,24,0,0,0,1964-11-24,0
1964,11,25,6,6,0,1964-11-25,6
1964,11,26,0,0,0,1964-11-26,0
1964,11,27,0,0,0,1964-11-27,0
1964,11,28,9,9,0,1964-11-28,9
1964,11,29,12,12,0,1964-11-29,12
1964,11,30,0,0,0,1964-11-30,0
1964,12,1,0,0,0,1964-12-1,0
1964,12,2,0,0,0,1964-12-2,0
1964,12,3,0,0,0,1964-12-3,0
1964,12,4,17,17,0,1964-12-4,17
1964,12,5,0,0,0,1964-12-5,0
1964,12,6,26,26,0,1964-12-6,26
1964,12,7,7,7,0,1964-12-7,7
1964,12,8,12,12,0,1964-12-8,12
1964,12,9,0,0,0,1964-12-9,0
1964,12,10,102,0,102,1964-12-10,-102
1964,12,11,80,0,80,1964-12-11,-80
1964,12,12,75,0,75,1964-12-12,-75
1964,12,13,43,0,43,1964-12-13,-43
1964,12,14,29,0,29,1964-12-14,-29
1964,12,15,30,0,30,1964-12-15,-30
1964,12,16,62,37,25,1964-12-16,12
1964,12,17,51,16,35,1964-12-17,-19
1964,12,18,366,330,36,1964-12-18,294
1964,12,19,253,231,22,1964-12-19,209
1964,12,20,252,238,14,1964-12-20,224
1964,12,21,241,210,31,1964-12-21,179
1964,12,22,200,184,16,1964-12-22,168
1964,12,23,153,153,0,1964-12-23,153
1964,12,24,165,165,0,1964-12-24,165
1964,12,25,151,151,0,1964-12-25,151
1964,12,26,126,115,11,1964-12-26,104
1964,12,27,172,135,37,1964-12-27,98
1964,12,28,227,209,18,1964-12-28,191
1964,12,29,221,219,2,1964-12-29,217
1964,12,30,135,135,0,1964-12-30,135
1964,12,31,111,111,0,1964-12-31,111
1965,1,1,283,283,0,1965-1-1,283
1965,1,2,411,411,0,1965-1-2,411
1965,1,3,432,432,0,1965-1-3,432
1965,1,4,425,425,0,1965-1-4,425
1965,1,5,346,346,0,1965-1-5,346
1965,1,6,165,165,0,1965-1-6,165
1965,1,7,59,59,0,1965-1-7,59
1965,1,8,63,63,0,1965-1-8,63
1965,1,9,65,65,0,1965-1-9,65
1965,1,10,25,25,0,1965-1-10,25
1965,1,11,18,18,0,1965-1-11,18
1965,1,12,7,7,0,1965-1-12,7
1965,1,13,0,0,0,1965-1-13,0
1965,1,14,31,31,0,1965-1-14,31
1965,1,15,11,11,0,1965-1-15,11
1965,1,16,7,7,0,1965-1-16,7
1965,1,17,33,33,0,1965-1-17,33
1965,1,18,98,98,0,1965-1-18,98
1965,1,19,125,125,0,1965-1-19,125
1965,1,20,122,122,0,1965-1-20,122
1965,1,21,178,178,0,1965-1-21,178
1965,1,22,134,134,0,1965-1-22,134
1965,1,23,178,178,0,1965-1-23,178
1965,1,24,143,143,0,1965-1-24,143
1965,1,25,129,129,0,1965-1-25,129
1965,1,26,99,99,0,1965-1-26,99
1965,1,27,110,110,0,1965-1-27,110
1965,1,28,63,63,0,1965-1-28,63
1965,1,29,267,267,0,1965-1-29,267
1965,1,30,271,271,0,1965-1-30,271
1965,1,31,224,224,0,1965-1-31,224
1965,2,1,185,185,0,1965-2-1,185
1965,2,2,191,191,0,1965-2-2,191
1965,2,3,170,170,0,1965-2-3,170
1965,2,4,137,137,0,1965-2-4,137
1965,2,5,132,132,0,1965-2-5,132
1965,2,6,238,238,0,1965-2-6,238
1965,2,7,244,244,0,1965-2-7,244
1965,2,8,242,242,0,1965-2-8,242
1965,2,9,280,280,0,1965-2-9,280
1965,2,10,141,141,0,1965-2-10,141
1965,2,11,142,142,0,1965-2-11,142
1965,2,12,167,167,0,1965-2-12,167
1965,2,13,142,142,0,1965-2-13,142
1965,2,14,133,133,0,1965-2-14,133
1965,2,15,117,117,0,1965-2-15,117
1965,2,16,103,103,0,1965-2-16,103
1965,2,17,52,52,0,1965-2-17,52
1965,2,18,84,84,0,1965-2-18,84
1965,2,19,0,0,0,1965-2-19,0
1965,2,20,0,0,0,1965-2-20,0
1965,2,21,0,0,0,1965-2-21,0
1965,2,22,0,0,0,1965-2-22,0
1965,2,23,0,0,0,1965-2-23,0
1965,2,24,70,54,16,1965-2-24,38
1965,2,25,58,43,15,1965-2-25,28
1965,2,26,44,34,10,1965-2-26,24
1965,2,27,35,15,20,1965-2-27,-5
1965,2,28,43,14,29,1965-2-28,-15
1965,3,1,13,7,6,1965-3-1,1
1965,3,2,0,0,0,1965-3-2,0
1965,3,3,0,0,0,1965-3-3,0
1965,3,4,21,21,0,1965-3-4,21
1965,3,5,13,13,0,1965-3-5,13
1965,3,6,47,47,0,1965-3-6,47
1965,3,7,58,58,0,1965-3-7,58
1965,3,8,12,12,0,1965-3-8,12
1965,3,9,0,0,0,1965-3-9,0
1965,3,10,44,44,0,1965-3-10,44
1965,3,11,29,29,0,1965-3-11,29
1965,3,12,77,77,0,1965-3-12,77
1965,3,13,186,186,0,1965-3-13,186
1965,3,14,186,186,0,1965-3-14,186
1965,3,15,127,127,0,1965-3-15,127
1965,3,16,82,82,0,1965-3-16,82
1965,3,17,72,72,0,1965-3-17,72
1965,3,18,54,54,0,1965-3-18,54
1965,3,19,172,172,0,1965-3-19,172
1965,3,20,134,134,0,1965-3-20,134
1965,3,21,96,96,0,1965-3-21,96
1965,3,22,0,0,0,1965-3-22,0
1965,3,23,0,0,0,1965-3-23,0
1965,3,24,9,9,0,1965-3-24,9
1965,3,25,49,49,0,1965-3-25,49
1965,3,26,69,69,0,1965-3-26,69
1965,3,27,44,44,0,1965-3-27,44
1965,3,28,21,21,0,1965-3-28,21
1965,3,29,16,16,0,1965-3-29,16
1965,3,30,9,9,0,1965-3-30,9
1965,3,31,0,0,0,1965-3-31,0
1965,4,1,0,0,0,1965-4-1,0
1965,4,2,0,0,0,1965-4-2,0
1965,4,3,0,0,0,1965-4-3,0
1965,4,4,0,0,0,1965-4-4,0
1965,4,5,0,0,0,1965-4-5,0
1965,4,6,0,0,0,1965-4-6,0
1965,4,7,0,0,0,1965-4-7,0
1965,4,8,0,0,0,1965-4-8,0
1965,4,9,0,0,0,1965-4-9,0
1965,4,10,0,0,0,1965-4-10,0
1965,4,11,0,0,0,1965-4-11,0
1965,4,12,83,83,0,1965-4-12,83
1965,4,13,79,79,0,1965-4-13,79
1965,4,14,51,51,0,1965-4-14,51
1965,4,15,68,43,25,1965-4-15,18
1965,4,16,43,43,0,1965-4-16,43
1965,4,17,28,28,0,1965-4-17,28
1965,4,18,24,24,0,1965-4-18,24
1965,4,19,10,10,0,1965-4-19,10
1965,4,20,14,14,0,1965-4-20,14
1965,4,21,23,23,0,1965-4-21,23
1965,4,22,55,55,0,1965-4-22,55
1965,4,23,77,77,0,1965-4-23,77
1965,4,24,15,15,0,1965-4-24,15
1965,4,25,8,8,0,1965-4-25,8
1965,4,26,44,9,35,1965-4-26,-26
1965,4,27,47,7,40,1965-4-27,-33
1965,4,28,38,0,38,1965-4-28,-38
1965,4,29,0,0,0,1965-4-29,0
1965,4,30,0,0,0,1965-4-30,0
1965,5,1,13,13,0,1965-5-1,13
1965,5,2,18,18,0,1965-5-2,18
1965,5,3,14,14,0,1965-5-3,14
1965,5,4,16,16,0,1965-5-4,16
1965,5,5,17,17,0,1965-5-5,17
1965,5,6,0,0,0,1965-5-6,0
1965,5,7,36,36,0,1965-5-7,36
1965,5,8,56,56,0,1965-5-8,56
1965,5,9,39,39,0,1965-5-9,39
1965,5,10,26,26,0,1965-5-10,26
1965,5,11,5,5,0,1965-5-11,5
1965,5,12,29,8,21,1965-5-12,-13
1965,5,13,31,26,5,1965-5-13,21
1965,5,14,15,15,0,1965-5-14,15
1965,5,15,794,794,0,1965-5-15,794
1965,5,16,718,718,0,1965-5-16,718
1965,5,17,919,919,0,1965-5-17,919
1965,5,18,741,741,0,1965-5-18,741
1965,5,19,778,778,0,1965-5-19,778
1965,5,20,609,609,0,1965-5-20,609
1965,5,21,549,549,0,1965-5-21,549
1965,5,22,577,577,0,1965-5-22,577
1965,5,23,438,438,0,1965-5-23,438
1965,5,24,237,237,0,1965-5-24,237
1965,5,25,155,155,0,1965-5-25,155
1965,5,26,132,132,0,1965-5-26,132
1965,5,27,0,0,0,1965-5-27,0
1965,5,28,0,0,0,1965-5-28,0
1965,5,29,0,0,0,1965-5-29,0
1965,5,30,0,0,0,1965-5-30,0
1965,5,31,0,0,0,1965-5-31,0
1965,6,1,3,0,3,1965-6-1,-3
1965,6,2,151,0,151,1965-6-2,-151
1965,6,3,266,0,266,1965-6-3,-266
1965,6,4,432,0,432,1965-6-4,-432
1965,6,5,361,0,361,1965-6-5,-361
1965,6,6,268,0,268,1965-6-6,-268
1965,6,7,292,60,232,1965-6-7,-172
1965,6,8,208,74,134,1965-6-8,-60
1965,6,9,163,47,116,1965-6-9,-69
1965,6,10,16,16,0,1965-6-10,16
1965,6,11,5,5,0,1965-6-11,5
1965,6,12,0,0,0,1965-6-12,0
1965,6,13,0,0,0,1965-6-13,0
1965,6,14,0,0,0,1965-6-14,0
1965,6,15,0,0,0,1965-6-15,0
1965,6,16,0,0,0,1965-6-16,0
1965,6,17,19,0,19,1965-6-17,-19
1965,6,18,65,0,65,1965-6-18,-65
1965,6,19,101,3,98,1965-6-19,-95
1965,6,20,109,23,86,1965-6-20,-63
1965,6,21,118,21,97,1965-6-21,-76
1965,6,22,47,4,43,1965-6-22,-39
1965,6,23,0,0,0,1965-6-23,0
1965,6,24,0,0,0,1965-6-24,0
1965,6,25,0,0,0,1965-6-25,0
1965,6,26,13,13,0,1965-6-26,13
1965,6,27,29,29,0,1965-6-27,29
1965,6,28,27,27,0,1965-6-28,27
1965,6,29,34,34,0,1965-6-29,34
1965,6,30,96,96,0,1965-6-30,96
1965,7,1,33,33,0,1965-7-1,33
1965,7,2,32,32,0,1965-7-2,32
1965,7,3,29,29,0,1965-7-3,29
1965,7,4,11,11,0,1965-7-4,11
1965,7,5,8,8,0,1965-7-5,8
1965,7,6,60,60,0,1965-7-6,60
1965,7,7,124,124,0,1965-7-7,124
1965,7,8,380,380,0,1965-7-8,380
1965,7,9,315,315,0,1965-7-9,315
1965,7,10,251,251,0,1965-7-10,251
1965,7,11,259,242,17,1965-7-11,225
1965,7,12,228,225,3,1965-7-12,222
1965,7,13,231,231,0,1965-7-13,231
1965,7,14,178,178,0,1965-7-14,178
1965,7,15,26,26,0,1965-7-15,26
1965,7,16,27,27,0,1965-7-16,27
1965,7,17,13,13,0,1965-7-17,13
1965,7,18,0,0,0,1965-7-18,0
1965,7,19,0,0,0,1965-7-19,0
1965,7,20,0,0,0,1965-7-20,0
1965,7,21,0,0,0,1965-7-21,0
1965,7,22,10,10,0,1965-7-22,10
1965,7,23,0,0,0,1965-7-23,0
1965,7,24,0,0,0,1965-7-24,0
1965,7,25,16,16,0,1965-7-25,16
1965,7,26,0,0,0,1965-7-26,0
1965,7,27,11,11,0,1965-7-27,11
1965,7,28,0,0,0,1965-7-28,0
1965,7,29,0,0,0,1965-7-29,0
1965,7,30,23,23,0,1965-7-30,23
1965,7,31,11,11,0,1965-7-31,11
1965,8,1,0,0,0,1965-8-1,0
1965,8,2,0,0,0,1965-8-2,0
1965,8,3,26,26,0,1965-8-3,26
1965,8,4,7,7,0,1965-8-4,7
1965,8,5,0,0,0,1965-8-5,0
1965,8,6,63,7,56,1965-8-6,-49
1965,8,7,34,34,0,1965-8-7,34
1965,8,8,61,61,0,1965-8-8,61
1965,8,9,30,30,0,1965-8-9,30
1965,8,10,30,7,23,1965-8-10,-16
1965,8,11,46,9,37,1965-8-11,-28
1965,8,12,68,0,68,1965-8-12,-68
1965,8,13,27,0,27,1965-8-13,-27
1965,8,14,9,0,9,1965-8-14,-9
1965,8,15,0,0,0,1965-8-15,0
1965,8,16,0,0,0,1965-8-16,0
1965,8,17,0,0,0,1965-8-17,0
1965,8,18,16,16,0,1965-8-18,16
1965,8,19,0,0,0,1965-8-19,0
1965,8,20,3,3,0,1965-8-20,3
1965,8,21,0,0,0,1965-8-21,0
1965,8,22,4,4,0,1965-8-22,4
1965,8,23,0,0,0,1965-8-23,0
1965,8,24,24,24,0,1965-8-24,24
1965,8,25,0,0,0,1965-8-25,0
1965,8,26,7,7,0,1965-8-26,7
1965,8,27,77,77,0,1965-8-27,77
1965,8,28,42,42,0,1965-8-28,42
1965,8,29,28,28,0,1965-8-29,28
1965,8,30,19,19,0,1965-8-30,19
1965,8,31,61,61,0,1965-8-31,61
1965,9,1,105,105,0,1965-9-1,105
1965,9,2,95,95,0,1965-9-2,95
1965,9,3,175,175,0,1965-9-3,175
1965,9,4,276,276,0,1965-9-4,276
1965,9,5,223,223,0,1965-9-5,223
1965,9,6,102,102,0,1965-9-6,102
1965,9,7,232,232,0,1965-9-7,232
1965,9,8,231,231,0,1965-9-8,231
1965,9,9,208,208,0,1965-9-9,208
1965,9,10,194,194,0,1965-9-10,194
1965,9,11,249,249,0,1965-9-11,249
1965,9,12,298,298,0,1965-9-12,298
1965,9,13,178,178,0,1965-9-13,178
1965,9,14,72,72,0,1965-9-14,72
1965,9,15,60,60,0,1965-9-15,60
1965,9,16,29,29,0,1965-9-16,29
1965,9,17,16,16,0,1965-9-17,16
1965,9,18,7,7,0,1965-9-18,7
1965,9,19,4,4,0,1965-9-19,4
1965,9,20,0,0,0,1965-9-20,0
1965,9,21,0,0,0,1965-9-21,0
1965,9,22,0,0,0,1965-9-22,0
1965,9,23,42,42,0,1965-9-23,42
1965,9,24,148,148,0,1965-9-24,148
1965,9,25,115,115,0,1965-9-25,115
1965,9,26,153,153,0,1965-9-26,153
1965,9,27,176,128,48,1965-9-27,80
1965,9,28,268,236,32,1965-9-28,204
1965,9,29,507,495,12,1965-9-29,483
1965,9,30,521,521,0,1965-9-30,521
1965,10,1,542,538,4,1965-10-1,534
1965,10,2,566,562,4,1965-10-2,558
1965,10,3,504,366,138,1965-10-3,228
1965,10,4,692,334,358,1965-10-4,-24
1965,10,5,656,262,394,1965-10-5,-132
1965,10,6,392,152,240,1965-10-6,-88
1965,10,7,403,140,263,1965-10-7,-123
1965,10,8,23,23,0,1965-10-8,23
1965,10,9,57,57,0,1965-10-9,57
1965,10,10,138,138,0,1965-10-10,138
1965,10,11,44,44,0,1965-10-11,44
1965,10,12,32,32,0,1965-10-12,32
1965,10,13,31,31,0,1965-10-13,31
1965,10,14,7,7,0,1965-10-14,7
1965,10,15,0,0,0,1965-10-15,0
1965,10,16,4,4,0,1965-10-16,4
1965,10,17,0,0,0,1965-10-17,0
1965,10,18,0,0,0,1965-10-18,0
1965,10,19,21,21,0,1965-10-19,21
1965,10,20,54,54,0,1965-10-20,54
1965,10,21,94,94,0,1965-10-21,94
1965,10,22,228,124,104,1965-10-22,20
1965,10,23,212,80,132,1965-10-23,-52
1965,10,24,144,47,97,1965-10-24,-50
1965,10,25,103,13,90,1965-10-25,-77
1965,10,26,108,10,98,1965-10-26,-88
1965,10,27,91,0,91,1965-10-27,-91
1965,10,28,81,0,81,1965-10-28,-81
1965,10,29,72,0,72,1965-10-29,-72
1965,10,30,63,0,63,1965-10-30,-63
1965,10,31,72,0,72,1965-10-31,-72
1965,11,1,152,97,55,1965-11-1,42
1965,11,2,171,118,53,1965-11-2,65
1965,11,3,135,106,29,1965-11-3,77
1965,11,4,84,84,0,1965-11-4,84
1965,11,5,36,36,0,1965-11-5,36
1965,11,6,224,224,0,1965-11-6,224
1965,11,7,428,428,0,1965-11-7,428
1965,11,8,313,313,0,1965-11-8,313
1965,11,9,446,446,0,1965-11-9,446
1965,11,10,620,620,0,1965-11-10,620
1965,11,11,563,563,0,1965-11-11,563
1965,11,12,306,306,0,1965-11-12,306
1965,11,13,128,128,0,1965-11-13,128
1965,11,14,106,106,0,1965-11-14,106
1965,11,15,72,72,0,1965-11-15,72
1965,11,16,71,71,0,1965-11-16,71
1965,11,17,20,20,0,1965-11-17,20
1965,11,18,0,0,0,1965-11-18,0
1965,11,19,0,0,0,1965-11-19,0
1965,11,20,0,0,0,1965-11-20,0
1965,11,21,0,0,0,1965-11-21,0
1965,11,22,0,0,0,1965-11-22,0
1965,11,23,0,0,0,1965-11-23,0
1965,11,24,4,4,0,1965-11-24,4
1965,11,25,0,0,0,1965-11-25,0
1965,11,26,0,0,0,1965-11-26,0
1965,11,27,0,0,0,1965-11-27,0
1965,11,28,100,100,0,1965-11-28,100
1965,11,29,90,90,0,1965-11-29,90
1965,11,30,119,114,5,1965-11-30,109
1965,12,1,71,63,8,1965-12-1,55
1965,12,2,49,49,0,1965-12-2,49
1965,12,3,36,36,0,1965-12-3,36
1965,12,4,26,26,0,1965-12-4,26
1965,12,5,18,18,0,1965-12-5,18
1965,12,6,20,20,0,1965-12-6,20
1965,12,7,22,22,0,1965-12-7,22
1965,12,8,28,28,0,1965-12-8,28
1965,12,9,23,23,0,1965-12-9,23
1965,12,10,20,17,3,1965-12-10,14
1965,12,11,0,0,0,1965-12-11,0
1965,12,12,14,14,0,1965-12-12,14
1965,12,13,19,19,0,1965-12-13,19
1965,12,14,0,0,0,1965-12-14,0
1965,12,15,63,63,0,1965-12-15,63
1965,12,16,132,132,0,1965-12-16,132
1965,12,17,138,138,0,1965-12-17,138
1965,12,18,228,228,0,1965-12-18,228
1965,12,19,273,273,0,1965-12-19,273
1965,12,20,179,179,0,1965-12-20,179
1965,12,21,1,1,0,1965-12-21,1
1965,12,22,26,26,0,1965-12-22,26
1965,12,23,43,43,0,1965-12-23,43
1965,12,24,17,17,0,1965-12-24,17
1965,12,25,36,36,0,1965-12-25,36
1965,12,26,105,105,0,1965-12-26,105
1965,12,27,453,447,6,1965-12-27,441
1965,12,28,820,686,134,1965-12-28,552
1965,12,29,715,564,151,1965-12-29,413
1965,12,30,580,462,118,1965-12-30,344
1965,12,31,175,104,71,1965-12-31,33
1966,1,1,132,68,64,1966-1-1,4
1966,1,2,44,19,25,1966-1-2,-6
1966,1,3,54,34,20,1966-1-3,14
1966,1,4,20,11,9,1966-1-4,2
1966,1,5,17,14,3,1966-1-5,11
1966,1,6,0,0,0,1966-1-6,0
1966,1,7,3,0,3,1966-1-7,-3
1966,1,8,0,0,0,1966-1-8,0
1966,1,9,3,3,0,1966-1-9,3
1966,1,10,0,0,0,1966-1-10,0
1966,1,11,0,0,0,1966-1-11,0
1966,1,12,0,0,0,1966-1-12,0
1966,1,13,111,111,0,1966-1-13,111
1966,1,14,810,810,0,1966-1-14,810
1966,1,15,1114,1114,0,1966-1-15,1114
1966,1,16,778,778,0,1966-1-16,778
1966,1,17,723,723,0,1966-1-17,723
1966,1,18,915,915,0,1966-1-18,915
1966,1,19,699,699,0,1966-1-19,699
1966,1,20,595,595,0,1966-1-20,595
1966,1,21,335,333,2,1966-1-21,331
1966,1,22,259,248,11,1966-1-22,237
1966,1,23,452,225,227,1966-1-23,-2
1966,1,24,395,136,259,1966-1-24,-123
1966,1,25,387,109,278,1966-1-25,-169
1966,1,26,212,0,212,1966-1-26,-212
1966,1,27,117,0,117,1966-1-27,-117
1966,1,28,164,0,164,1966-1-28,-164
1966,1,29,169,0,169,1966-1-29,-169
1966,1,30,141,0,141,1966-1-30,-141
1966,1,31,129,0,129,1966-1-31,-129
1966,2,1,6,6,0,1966-2-1,6
1966,2,2,106,106,0,1966-2-2,106
1966,2,3,213,213,0,1966-2-3,213
1966,2,4,254,254,0,1966-2-4,254
1966,2,5,328,328,0,1966-2-5,328
1966,2,6,235,235,0,1966-2-6,235
1966,2,7,234,234,0,1966-2-7,234
1966,2,8,191,191,0,1966-2-8,191
1966,2,9,156,156,0,1966-2-9,156
1966,2,10,226,226,0,1966-2-10,226
1966,2,11,151,151,0,1966-2-11,151
1966,2,12,67,67,0,1966-2-12,67
1966,2,13,65,65,0,1966-2-13,65
1966,2,14,171,171,0,1966-2-14,171
1966,2,15,152,152,0,1966-2-15,152
1966,2,16,143,143,0,1966-2-16,143
1966,2,17,156,156,0,1966-2-17,156
1966,2,18,155,155,0,1966-2-18,155
1966,2,19,200,200,0,1966-2-19,200
1966,2,20,336,336,0,1966-2-20,336
1966,2,21,397,397,0,1966-2-21,397
1966,2,22,354,354,0,1966-2-22,354
1966,2,23,451,451,0,1966-2-23,451
1966,2,24,388,388,0,1966-2-24,388
1966,2,25,349,349,0,1966-2-25,349
1966,2,26,405,405,0,1966-2-26,405
1966,2,27,328,328,0,1966-2-27,328
1966,2,28,511,511,0,1966-2-28,511
1966,3,1,210,210,0,1966-3-1,210
1966,3,2,60,60,0,1966-3-2,60
1966,3,3,57,57,0,1966-3-3,57
1966,3,4,75,75,0,1966-3-4,75
1966,3,5,56,56,0,1966-3-5,56
1966,3,6,61,61,0,1966-3-6,61
1966,3,7,92,92,0,1966-3-7,92
1966,3,8,80,80,0,1966-3-8,80
1966,3,9,145,145,0,1966-3-9,145
1966,3,10,157,157,0,1966-3-10,157
1966,3,11,128,128,0,1966-3-11,128
1966,3,12,0,0,0,1966-3-12,0
1966,3,13,6,6,0,1966-3-13,6
1966,3,14,0,0,0,1966-3-14,0
1966,3,15,763,763,0,1966-3-15,763
1966,3,16,682,682,0,1966-3-16,682
1966,3,17,1250,1250,0,1966-3-17,1250
1966,3,18,1291,1291,0,1966-3-18,1291
1966,3,19,1270,1270,0,1966-3-19,1270
1966,3,20,1443,1443,0,1966-3-20,1443
1966,3,21,1046,1046,0,1966-3-21,1046
1966,3,22,964,964,0,1966-3-22,964
1966,3,23,870,870,0,1966-3-23,870
1966,3,24,798,798,0,1966-3-24,798
1966,3,25,842,842,0,1966-3-25,842
1966,3,26,758,758,0,1966-3-26,758
1966,3,27,446,446,0,1966-3-27,446
1966,3,28,474,474,0,1966-3-28,474
1966,3,29,940,940,0,1966-3-29,940
1966,3,30,1084,1084,0,1966-3-30,1084
1966,3,31,1429,1429,0,1966-3-31,1429
1966,4,1,1557,1542,15,1966-4-1,1527
1966,4,2,1624,1600,24,1966-4-2,1576
1966,4,3,1525,1515,10,1966-4-3,1505
1966,4,4,1520,1520,0,1966-4-4,1520
1966,4,5,1309,1309,0,1966-4-5,1309
1966,4,6,1353,1353,0,1966-4-6,1353
1966,4,7,1510,1510,0,1966-4-7,1510
1966,4,8,1490,1490,0,1966-4-8,1490
1966,4,9,851,851,0,1966-4-9,851
1966,4,10,855,855,0,1966-4-10,855
1966,4,11,842,842,0,1966-4-11,842
1966,4,12,979,979,0,1966-4-12,979
1966,4,13,364,364,0,1966-4-13,364
1966,4,14,308,308,0,1966-4-14,308
1966,4,15,410,410,0,1966-4-15,410
1966,4,16,339,339,0,1966-4-16,339
1966,4,17,307,307,0,1966-4-17,307
1966,4,18,308,308,0,1966-4-18,308
1966,4,19,160,160,0,1966-4-19,160
1966,4,20,397,397,0,1966-4-20,397
1966,4,21,412,412,0,1966-4-21,412
1966,4,22,379,379,0,1966-4-22,379
1966,4,23,451,451,0,1966-4-23,451
1966,4,24,705,705,0,1966-4-24,705
1966,4,25,937,937,0,1966-4-25,937
1966,4,26,762,762,0,1966-4-26,762
1966,4,27,467,467,0,1966-4-27,467
1966,4,28,526,526,0,1966-4-28,526
1966,4,29,599,594,5,1966-4-29,589
1966,4,30,361,359,2,1966-4-30,357
1966,5,1,379,328,51,1966-5-1,277
1966,5,2,360,335,25,1966-5-2,310
1966,5,3,319,289,30,1966-5-3,259
1966,5,4,312,310,2,1966-5-4,308
1966,5,5,198,198,0,1966-5-5,198
1966,5,6,256,256,0,1966-5-6,256
1966,5,7,190,190,0,1966-5-7,190
1966,5,8,140,140,0,1966-5-8,140
1966,5,9,116,116,0,1966-5-9,116
1966,5,10,0,0,0,1966-5-10,0
1966,5,11,0,0,0,1966-5-11,0
1966,5,12,65,65,0,1966-5-12,65
1966,5,13,70,70,0,1966-5-13,70
1966,5,14,120,120,0,1966-5-14,120
1966,5,15,167,167,0,1966-5-15,167
1966,5,16,357,357,0,1966-5-16,357
1966,5,17,309,295,14,1966-5-17,281
1966,5,18,261,261,0,1966-5-18,261
1966,5,19,204,173,31,1966-5-19,142
1966,5,20,999,885,114,1966-5-20,771
1966,5,21,1340,1052,288,1966-5-21,764
1966,5,22,1630,1290,340,1966-5-22,950
1966,5,23,646,354,292,1966-5-23,62
1966,5,24,862,433,429,1966-5-24,4
1966,5,25,677,368,309,1966-5-25,59
1966,5,26,656,501,155,1966-5-26,346
1966,5,27,759,732,27,1966-5-27,705
1966,5,28,507,507,0,1966-5-28,507
1966,5,29,316,316,0,1966-5-29,316
1966,5,30,306,282,24,1966-5-30,258
1966,5,31,247,209,38,1966-5-31,171
1966,6,1,496,470,26,1966-6-1,444
1966,6,2,463,443,20,1966-6-2,423
1966,6,3,252,247,5,1966-6-3,242
1966,6,4,229,225,4,1966-6-4,221
1966,6,5,226,226,0,1966-6-5,226
1966,6,6,213,213,0,1966-6-6,213
1966,6,7,211,211,0,1966-6-7,211
1966,6,8,318,318,0,1966-6-8,318
1966,6,9,297,297,0,1966-6-9,297
1966,6,10,229,229,0,1966-6-10,229
1966,6,11,310,310,0,1966-6-11,310
1966,6,12,325,325,0,1966-6-12,325
1966,6,13,269,269,0,1966-6-13,269
1966,6,14,220,220,0,1966-6-14,220
1966,6,15,160,160,0,1966-6-15,160
1966,6,16,202,192,10,1966-6-16,182
1966,6,17,442,431,11,1966-6-17,420
1966,6,18,390,389,1,1966-6-18,388
1966,6,19,406,406,0,1966-6-19,406
1966,6,20,274,274,0,1966-6-20,274
1966,6,21,287,287,0,1966-6-21,287
1966,6,22,311,282,29,1966-6-22,253
1966,6,23,456,322,134,1966-6-23,188
1966,6,24,366,250,116,1966-6-24,134
1966,6,25,396,252,144,1966-6-25,108
1966,6,26,400,230,170,1966-6-26,60
1966,6,27,451,264,187,1966-6-27,77
1966,6,28,332,148,184,1966-6-28,-36
1966,6,29,341,140,201,1966-6-29,-61
1966,6,30,292,172,120,1966-6-30,52
1966,7,1,187,144,43,1966-7-1,101
1966,7,2,200,200,0,1966-7-2,200
1966,7,3,269,269,0,1966-7-3,269
1966,7,4,490,490,0,1966-7-4,490
1966,7,5,653,653,0,1966-7-5,653
1966,7,6,1023,1023,0,1966-7-6,1023
1966,7,7,1267,1267,0,1966-7-7,1267
1966,7,8,1480,1480,0,1966-7-8,1480
1966,7,9,1190,1190,0,1966-7-9,1190
1966,7,10,564,538,26,1966-7-10,512
1966,7,11,269,206,63,1966-7-11,143
1966,7,12,466,345,121,1966-7-12,224
1966,7,13,517,453,64,1966-7-13,389
1966,7,14,303,257,46,1966-7-14,211
1966,7,15,323,312,11,1966-7-15,301
1966,7,16,582,322,260,1966-7-16,62
1966,7,17,595,280,315,1966-7-17,-35
1966,7,18,452,258,194,1966-7-18,64
1966,7,19,505,347,158,1966-7-19,189
1966,7,20,672,575,97,1966-7-20,478
1966,7,21,685,625,60,1966-7-21,565
1966,7,22,685,611,74,1966-7-22,537
1966,7,23,828,793,35,1966-7-23,758
1966,7,24,870,863,7,1966-7-24,856
1966,7,25,985,977,8,1966-7-25,969
1966,7,26,1396,1382,14,1966-7-26,1368
1966,7,27,1314,1314,0,1966-7-27,1314
1966,7,28,1150,1150,0,1966-7-28,1150
1966,7,29,1354,1354,0,1966-7-29,1354
1966,7,30,1232,1232,0,1966-7-30,1232
1966,7,31,1120,1120,0,1966-7-31,1120
1966,8,1,977,977,0,1966-8-1,977
1966,8,2,808,792,16,1966-8-2,776
1966,8,3,533,533,0,1966-8-3,533
1966,8,4,454,454,0,1966-8-4,454
1966,8,5,385,385,0,1966-8-5,385
1966,8,6,274,267,7,1966-8-6,260
1966,8,7,89,80,9,1966-8-7,71
1966,8,8,21,7,14,1966-8-8,-7
1966,8,9,0,0,0,1966-8-9,0
1966,8,10,0,0,0,1966-8-10,0
1966,8,11,44,44,0,1966-8-11,44
1966,8,12,162,162,0,1966-8-12,162
1966,8,13,164,160,4,1966-8-13,156
1966,8,14,266,226,40,1966-8-14,186
1966,8,15,219,185,34,1966-8-15,151
1966,8,16,273,195,78,1966-8-16,117
1966,8,17,190,166,24,1966-8-17,142
1966,8,18,121,117,4,1966-8-18,113
1966,8,19,142,142,0,1966-8-19,142
1966,8,20,68,68,0,1966-8-20,68
1966,8,21,65,65,0,1966-8-21,65
1966,8,22,415,415,0,1966-8-22,415
1966,8,23,576,576,0,1966-8-23,576
1966,8,24,813,813,0,1966-8-24,813
1966,8,25,1102,1102,0,1966-8-25,1102
1966,8,26,1331,1331,0,1966-8-26,1331
1966,8,27,1553,1547,6,1966-8-27,1541
1966,8,28,1333,1330,3,1966-8-28,1327
1966,8,29,1790,1790,0,1966-8-29,1790
1966,8,30,892,885,7,1966-8-30,878
1966,8,31,1107,1107,0,1966-8-31,1107
1966,9,1,1107,1107,0,1966-9-1,1107
1966,9,2,1007,1007,0,1966-9-2,1007
1966,9,3,1071,1071,0,1966-9-3,1071
1966,9,4,812,812,0,1966-9-4,812
1966,9,5,204,153,51,1966-9-5,102
1966,9,6,353,316,37,1966-9-6,279
1966,9,7,293,256,37,1966-9-7,219
1966,9,8,244,194,50,1966-9-8,144
1966,9,9,288,175,113,1966-9-9,62
1966,9,10,357,148,209,1966-9-10,-61
1966,9,11,362,89,273,1966-9-11,-184
1966,9,12,340,54,286,1966-9-12,-232
1966,9,13,678,573,105,1966-9-13,468
1966,9,14,755,755,0,1966-9-14,755
1966,9,15,893,893,0,1966-9-15,893
1966,9,16,1052,1052,0,1966-9-16,1052
1966,9,17,1777,1777,0,1966-9-17,1777
1966,9,18,1884,1884,0,1966-9-18,1884
1966,9,19,1867,1867,0,1966-9-19,1867
1966,9,20,1556,1556,0,1966-9-20,1556
1966,9,21,2046,2046,0,1966-9-21,2046
1966,9,22,2121,2121,0,1966-9-22,2121
1966,9,23,1807,1807,0,1966-9-23,1807
1966,9,24,1542,1542,0,1966-9-24,1542
1966,9,25,1647,1643,4,1966-9-25,1639
1966,9,26,583,581,2,1966-9-26,579
1966,9,27,562,562,0,1966-9-27,562
1966,9,28,304,288,16,1966-9-28,272
1966,9,29,253,243,10,1966-9-29,233
1966,9,30,415,352,63,1966-9-30,289
1966,10,1,345,193,152,1966-10-1,41
1966,10,2,332,155,177,1966-10-2,-22
1966,10,3,482,310,172,1966-10-3,138
1966,10,4,346,286,60,1966-10-4,226
1966,10,5,325,303,22,1966-10-5,281
1966,10,6,296,248,48,1966-10-6,200
1966,10,7,389,233,156,1966-10-7,77
1966,10,8,299,153,146,1966-10-8,7
1966,10,9,339,170,169,1966-10-9,1
1966,10,10,939,852,87,1966-10-10,765
1966,10,11,800,768,32,1966-10-11,736
1966,10,12,835,789,46,1966-10-12,743
1966,10,13,1005,1005,0,1966-10-13,1005
1966,10,14,966,966,0,1966-10-14,966
1966,10,15,1055,1055,0,1966-10-15,1055
1966,10,16,913,913,0,1966-10-16,913
1966,10,17,1019,1019,0,1966-10-17,1019
1966,10,18,875,875,0,1966-10-18,875
1966,10,19,1196,990,206,1966-10-19,784
1966,10,20,1121,995,126,1966-10-20,869
1966,10,21,1751,1621,130,1966-10-21,1491
1966,10,22,1479,1377,102,1966-10-22,1275
1966,10,23,1193,1130,63,1966-10-23,1067
1966,10,24,604,530,74,1966-10-24,456
1966,10,25,248,173,75,1966-10-25,98
1966,10,26,133,90,43,1966-10-26,47
1966,10,27,61,13,48,1966-10-27,-35
1966,10,28,53,27,26,1966-10-28,1
1966,10,29,70,67,3,1966-10-29,64
1966,10,30,144,144,0,1966-10-30,144
1966,10,31,157,157,0,1966-10-31,157
1966,11,1,176,176,0,1966-11-1,176
1966,11,2,160,160,0,1966-11-2,160
1966,11,3,138,138,0,1966-11-3,138
1966,11,4,78,68,10,1966-11-4,58
1966,11,5,77,45,32,1966-11-5,13
1966,11,6,182,157,25,1966-11-6,132
1966,11,7,982,982,0,1966-11-7,982
1966,11,8,926,926,0,1966-11-8,926
1966,11,9,985,985,0,1966-11-9,985
1966,11,10,874,874,0,1966-11-10,874
1966,11,11,1096,1096,0,1966-11-11,1096
1966,11,12,1127,1127,0,1966-11-12,1127
1966,11,13,986,986,0,1966-11-13,986
1966,11,14,1028,1028,0,1966-11-14,1028
1966,11,15,1032,1032,0,1966-11-15,1032
1966,11,16,1057,1057,0,1966-11-16,1057
1966,11,17,1146,1146,0,1966-11-17,1146
1966,11,18,1368,1368,0,1966-11-18,1368
1966,11,19,715,715,0,1966-11-19,715
1966,11,20,501,493,8,1966-11-20,485
1966,11,21,741,708,33,1966-11-21,675
1966,11,22,858,837,21,1966-11-22,816
1966,11,23,857,853,4,1966-11-23,849
1966,11,24,812,812,0,1966-11-24,812
1966,11,25,873,873,0,1966-11-25,873
1966,11,26,1035,1035,0,1966-11-26,1035
1966,11,27,717,717,0,1966-11-27,717
1966,11,28,225,225,0,1966-11-28,225
1966,11,29,302,292,10,1966-11-29,282
1966,11,30,257,257,0,1966-11-30,257
1966,12,1,112,112,0,1966-12-1,112
1966,12,2,70,68,2,1966-12-2,66
1966,12,3,63,59,4,1966-12-3,55
1966,12,4,789,784,5,1966-12-4,779
1966,12,5,861,838,23,1966-12-5,815
1966,12,6,759,736,23,1966-12-6,713
1966,12,7,1076,935,141,1966-12-7,794
1966,12,8,1382,1213,169,1966-12-8,1044
1966,12,9,1736,1289,447,1966-12-9,842
1966,12,10,2067,1253,814,1966-12-10,439
1966,12,11,2868,1596,1272,1966-12-11,324
1966,12,12,2748,1442,1306,1966-12-12,136
1966,12,13,2612,1288,1324,1966-12-13,-36
1966,12,14,2040,990,1050,1966-12-14,-60
1966,12,15,1910,998,912,1966-12-15,86
1966,12,16,1300,908,392,1966-12-16,516
1966,12,17,572,473,99,1966-12-17,374
1966,12,18,383,383,0,1966-12-18,383
1966,12,19,348,348,0,1966-12-19,348
1966,12,20,105,105,0,1966-12-20,105
1966,12,21,105,75,30,1966-12-21,45
1966,12,22,223,42,181,1966-12-22,-139
1966,12,23,533,347,186,1966-12-23,161
1966,12,24,650,456,194,1966-12-24,262
1966,12,25,550,320,230,1966-12-25,90
1966,12,26,622,386,236,1966-12-26,150
1966,12,27,438,246,192,1966-12-27,54
1966,12,28,346,146,200,1966-12-28,-54
1966,12,29,259,84,175,1966-12-29,-91
1966,12,30,592,297,295,1966-12-30,2
1966,12,31,860,406,454,1966-12-31,-48
1967,1,1,1008,394,614,1967-1-1,-220
1967,1,2,1512,433,1079,1967-1-2,-646
1967,1,3,2350,783,1567,1967-1-3,-784
1967,1,4,2880,1096,1784,1967-1-4,-688
1967,1,5,2923,999,1924,1967-1-5,-925
1967,1,6,3575,999,2576,1967-1-6,-1577
1967,1,7,2824,730,2094,1967-1-7,-1364
1967,1,8,2068,934,1134,1967-1-8,-200
1967,1,9,1781,1361,420,1967-1-9,941
1967,1,10,1914,1607,307,1967-1-10,1300
1967,1,11,1764,1545,219,1967-1-11,1326
1967,1,12,1759,1379,380,1967-1-12,999
1967,1,13,1932,1290,642,1967-1-13,648
1967,1,14,1840,1142,698,1967-1-14,444
1967,1,15,1423,640,783,1967-1-15,-143
1967,1,16,1223,537,686,1967-1-16,-149
1967,1,17,1516,851,665,1967-1-17,186
1967,1,18,1393,868,525,1967-1-18,343
1967,1,19,1376,960,416,1967-1-19,544
1967,1,20,1353,1033,320,1967-1-20,713
1967,1,21,1824,1437,387,1967-1-21,1050
1967,1,22,1256,1171,85,1967-1-22,1086
1967,1,23,1594,1004,590,1967-1-23,414
1967,1,24,1329,834,495,1967-1-24,339
1967,1,25,1276,824,452,1967-1-25,372
1967,1,26,1624,1183,441,1967-1-26,742
1967,1,27,1795,1319,476,1967-1-27,843
1967,1,28,2133,1673,460,1967-1-28,1213
1967,1,29,1930,1481,449,1967-1-29,1032
1967,1,30,1886,1443,443,1967-1-30,1000
1967,1,31,1990,1323,667,1967-1-31,656
1967,2,1,1317,703,614,1967-2-1,89
1967,2,2,1463,824,639,1967-2-2,185
1967,2,3,1422,812,610,1967-2-3,202
1967,2,4,1539,691,848,1967-2-4,-157
1967,2,5,1337,849,488,1967-2-5,361
1967,2,6,1302,943,359,1967-2-6,584
1967,2,7,2107,1743,364,1967-2-7,1379
1967,2,8,1704,1487,217,1967-2-8,1270
1967,2,9,1694,1373,321,1967-2-9,1052
1967,2,10,1616,1406,210,1967-2-10,1196
1967,2,11,1290,1110,180,1967-2-11,930
1967,2,12,945,787,158,1967-2-12,629
1967,2,13,1133,928,205,1967-2-13,723
1967,2,14,494,381,113,1967-2-14,268
1967,2,15,646,529,117,1967-2-15,412
1967,2,16,804,674,130,1967-2-16,544
1967,2,17,678,534,144,1967-2-17,390
1967,2,18,616,518,98,1967-2-18,420
1967,2,19,521,449,72,1967-2-19,377
1967,2,20,797,523,274,1967-2-20,249
1967,2,21,1010,771,239,1967-2-21,532
1967,2,22,1767,1488,279,1967-2-22,1209
1967,2,23,2095,1866,229,1967-2-23,1637
1967,2,24,2266,2095,171,1967-2-24,1924
1967,2,25,2518,2364,154,1967-2-25,2210
1967,2,26,2702,2358,344,1967-2-26,2014
1967,2,27,2749,2178,571,1967-2-27,1607
1967,2,28,3279,2349,930,1967-2-28,1419
1967,3,1,3755,2760,995,1967-3-1,1765
1967,3,2,4217,3202,1015,1967-3-2,2187
1967,3,3,4264,2904,1360,1967-3-3,1544
1967,3,4,5467,3355,2112,1967-3-4,1243
1967,3,5,3516,1618,1898,1967-3-5,-280
1967,3,6,2651,1152,1499,1967-3-6,-347
1967,3,7,2451,978,1473,1967-3-7,-495
1967,3,8,1924,408,1516,1967-3-8,-1108
1967,3,9,1392,379,1013,1967-3-9,-634
1967,3,10,1350,484,866,1967-3-10,-382
1967,3,11,971,244,727,1967-3-11,-483
1967,3,12,729,182,547,1967-3-12,-365
1967,3,13,580,160,420,1967-3-13,-260
1967,3,14,454,178,276,1967-3-14,-98
1967,3,15,637,393,244,1967-3-15,149
1967,3,16,912,607,305,1967-3-16,302
1967,3,17,1054,754,300,1967-3-17,454
1967,3,18,1003,702,301,1967-3-18,401
1967,3,19,641,476,165,1967-3-19,311
1967,3,20,1326,1161,165,1967-3-20,996
1967,3,21,1608,1563,45,1967-3-21,1518
1967,3,22,1806,1728,78,1967-3-22,1650
1967,3,23,1826,1804,22,1967-3-23,1782
1967,3,24,2176,2100,76,1967-3-24,2024
1967,3,25,2322,2085,237,1967-3-25,1848
1967,3,26,2077,1889,188,1967-3-26,1701
1967,3,27,1987,1716,271,1967-3-27,1445
1967,3,28,2460,1912,548,1967-3-28,1364
1967,3,29,2731,1926,805,1967-3-29,1121
1967,3,30,3106,1949,1157,1967-3-30,792
1967,3,31,3134,2015,1119,1967-3-31,896
1967,4,1,2093,1313,780,1967-4-1,533
1967,4,2,726,278,448,1967-4-2,-170
1967,4,3,206,100,106,1967-4-3,-6
1967,4,4,290,245,45,1967-4-4,200
1967,4,5,410,205,205,1967-4-5,0
1967,4,6,526,201,325,1967-4-6,-124
1967,4,7,523,198,325,1967-4-7,-127
1967,4,8,976,284,692,1967-4-8,-408
1967,4,9,999,208,791,1967-4-9,-583
1967,4,10,1104,215,889,1967-4-10,-674
1967,4,11,1240,296,944,1967-4-11,-648
1967,4,12,1405,375,1030,1967-4-12,-655
1967,4,13,987,860,127,1967-4-13,733
1967,4,14,1070,1070,0,1967-4-14,1070
1967,4,15,1176,1176,0,1967-4-15,1176
1967,4,16,600,589,11,1967-4-16,578
1967,4,17,824,635,189,1967-4-17,446
1967,4,18,796,534,262,1967-4-18,272
1967,4,19,869,663,206,1967-4-19,457
1967,4,20,805,581,224,1967-4-20,357
1967,4,21,1003,562,441,1967-4-21,121
1967,4,22,1200,611,589,1967-4-22,22
1967,4,23,1055,650,405,1967-4-23,245
1967,4,24,1075,595,480,1967-4-24,115
1967,4,25,1072,615,457,1967-4-25,158
1967,4,26,517,345,172,1967-4-26,173
1967,4,27,538,379,159,1967-4-27,220
1967,4,28,1014,490,524,1967-4-28,-34
1967,4,29,917,428,489,1967-4-29,-61
1967,4,30,749,218,531,1967-4-30,-313
1967,5,1,1026,595,431,1967-5-1,164
1967,5,2,1013,531,482,1967-5-2,49
1967,5,3,1050,542,508,1967-5-3,34
1967,5,4,875,493,382,1967-5-4,111
1967,5,5,915,589,326,1967-5-5,263
1967,5,6,670,533,137,1967-5-6,396
1967,5,7,498,409,89,1967-5-7,320
1967,5,8,389,327,62,1967-5-8,265
1967,5,9,405,305,100,1967-5-9,205
1967,5,10,333,317,16,1967-5-10,301
1967,5,11,421,414,7,1967-5-11,407
1967,5,12,454,419,35,1967-5-12,384
1967,5,13,482,409,73,1967-5-13,336
1967,5,14,202,115,87,1967-5-14,28
1967,5,15,389,127,262,1967-5-15,-135
1967,5,16,380,131,249,1967-5-16,-118
1967,5,17,353,141,212,1967-5-17,-71
1967,5,18,488,233,255,1967-5-18,-22
1967,5,19,935,661,274,1967-5-19,387
1967,5,20,1729,1275,454,1967-5-20,821
1967,5,21,2548,2148,400,1967-5-21,1748
1967,5,22,2922,2560,362,1967-5-22,2198
1967,5,23,3323,2942,381,1967-5-23,2561
1967,5,24,3551,3192,359,1967-5-24,2833
1967,5,25,3875,3402,473,1967-5-25,2929
1967,5,26,4740,3771,969,1967-5-26,2802
1967,5,27,4376,3327,1049,1967-5-27,2278
1967,5,28,3999,3093,906,1967-5-28,2187
1967,5,29,3840,3053,787,1967-5-29,2266
1967,5,30,3579,2859,720,1967-5-30,2139
1967,5,31,3889,3123,766,1967-5-31,2357
1967,6,1,2508,2008,500,1967-6-1,1508
1967,6,2,2080,1806,274,1967-6-2,1532
1967,6,3,1926,1709,217,1967-6-3,1492
1967,6,4,1923,1736,187,1967-6-4,1549
1967,6,5,1553,1356,197,1967-6-5,1159
1967,6,6,1346,1234,112,1967-6-6,1122
1967,6,7,995,936,59,1967-6-7,877
1967,6,8,746,727,19,1967-6-8,708
1967,6,9,693,682,11,1967-6-9,671
1967,6,10,106,24,82,1967-6-10,-58
1967,6,11,104,46,58,1967-6-11,-12
1967,6,12,166,20,146,1967-6-12,-126
1967,6,13,223,23,200,1967-6-13,-177
1967,6,14,198,0,198,1967-6-14,-198
1967,6,15,411,211,200,1967-6-15,11
1967,6,16,422,304,118,1967-6-16,186
1967,6,17,742,578,164,1967-6-17,414
1967,6,18,690,607,83,1967-6-18,524
1967,6,19,467,410,57,1967-6-19,353
1967,6,20,870,850,20,1967-6-20,830
1967,6,21,981,909,72,1967-6-21,837
1967,6,22,1099,940,159,1967-6-22,781
1967,6,23,999,810,189,1967-6-23,621
1967,6,24,1540,1136,404,1967-6-24,732
1967,6,25,1625,1119,506,1967-6-25,613
1967,6,26,1344,908,436,1967-6-26,472
1967,6,27,1123,768,355,1967-6-27,413
1967,6,28,1354,1022,332,1967-6-28,690
1967,6,29,1199,931,268,1967-6-29,663
1967,6,30,1337,942,395,1967-6-30,547
1967,7,1,1277,841,436,1967-7-1,405
1967,7,2,1121,735,386,1967-7-2,349
1967,7,3,1223,766,457,1967-7-3,309
1967,7,4,1368,857,511,1967-7-4,346
1967,7,5,1196,708,488,1967-7-5,220
1967,7,6,1161,667,494,1967-7-6,173
1967,7,7,800,376,424,1967-7-7,-48
1967,7,8,627,366,261,1967-7-8,105
1967,7,9,526,326,200,1967-7-9,126
1967,7,10,484,309,175,1967-7-10,134
1967,7,11,308,302,6,1967-7-11,296
1967,7,12,196,109,87,1967-7-12,22
1967,7,13,244,116,128,1967-7-13,-12
1967,7,14,669,341,328,1967-7-14,13
1967,7,15,898,431,467,1967-7-15,-36
1967,7,16,494,73,421,1967-7-16,-348
1967,7,17,365,31,334,1967-7-17,-303
1967,7,18,493,84,409,1967-7-18,-325
1967,7,19,282,58,224,1967-7-19,-166
1967,7,20,286,0,286,1967-7-20,-286
1967,7,21,784,461,323,1967-7-21,138
1967,7,22,1285,1008,277,1967-7-22,731
1967,7,23,2000,1817,183,1967-7-23,1634
1967,7,24,3003,2782,221,1967-7-24,2561
1967,7,25,3101,2924,177,1967-7-25,2747
1967,7,26,3165,3012,153,1967-7-26,2859
1967,7,27,3924,3770,154,1967-7-27,3616
1967,7,28,4004,3853,151,1967-7-28,3702
1967,7,29,3550,3498,52,1967-7-29,3446
1967,7,30,3561,3493,68,1967-7-30,3425
1967,7,31,3373,3353,20,1967-7-31,3333
1967,8,1,3448,3383,65,1967-8-1,3318
1967,8,2,2985,2819,166,1967-8-2,2653
1967,8,3,2393,2242,151,1967-8-3,2091
1967,8,4,2102,1921,181,1967-8-4,1740
1967,8,5,2134,1354,780,1967-8-5,574
1967,8,6,2835,1547,1288,1967-8-6,259
1967,8,7,2403,1101,1302,1967-8-7,-201
1967,8,8,2224,983,1241,1967-8-8,-258
1967,8,9,1631,698,933,1967-8-9,-235
1967,8,10,1244,536,708,1967-8-10,-172
1967,8,11,1643,810,833,1967-8-11,-23
1967,8,12,1729,1045,684,1967-8-12,361
1967,8,13,2136,956,1180,1967-8-13,-224
1967,8,14,1433,245,1188,1967-8-14,-943
1967,8,15,1353,282,1071,1967-8-15,-789
1967,8,16,1350,313,1037,1967-8-16,-724
1967,8,17,1755,749,1006,1967-8-17,-257
1967,8,18,1827,796,1031,1967-8-18,-235
1967,8,19,2246,1576,670,1967-8-19,906
1967,8,20,2432,1907,525,1967-8-20,1382
1967,8,21,2757,2262,495,1967-8-21,1767
1967,8,22,2748,2182,566,1967-8-22,1616
1967,8,23,2384,1915,469,1967-8-23,1446
1967,8,24,2310,1782,528,1967-8-24,1254
1967,8,25,2178,1575,603,1967-8-25,972
1967,8,26,1816,1563,253,1967-8-26,1310
1967,8,27,1689,1365,324,1967-8-27,1041
1967,8,28,2323,1635,688,1967-8-28,947
1967,8,29,2275,1669,606,1967-8-29,1063
1967,8,30,2026,1604,422,1967-8-30,1182
1967,8,31,2176,1604,572,1967-8-31,1032
1967,9,1,1429,995,434,1967-9-1,561
1967,9,2,1542,857,685,1967-9-2,172
1967,9,3,1176,667,509,1967-9-3,158
1967,9,4,1292,592,700,1967-9-4,-108
1967,9,5,921,473,448,1967-9-5,25
1967,9,6,918,351,567,1967-9-6,-216
1967,9,7,850,314,536,1967-9-7,-222
1967,9,8,1199,722,477,1967-9-8,245
1967,9,9,1160,631,529,1967-9-9,102
1967,9,10,1065,733,332,1967-9-10,401
1967,9,11,1165,797,368,1967-9-11,429
1967,9,12,1192,864,328,1967-9-12,536
1967,9,13,1015,747,268,1967-9-13,479
1967,9,14,792,577,215,1967-9-14,362
1967,9,15,587,410,177,1967-9-15,233
1967,9,16,521,346,175,1967-9-16,171
1967,9,17,551,304,247,1967-9-17,57
1967,9,18,830,303,527,1967-9-18,-224
1967,9,19,835,373,462,1967-9-19,-89
1967,9,20,887,368,519,1967-9-20,-151
1967,9,21,704,233,471,1967-9-21,-238
1967,9,22,652,204,448,1967-9-22,-244
1967,9,23,481,145,336,1967-9-23,-191
1967,9,24,209,81,128,1967-9-24,-47
1967,9,25,650,465,185,1967-9-25,280
1967,9,26,777,760,17,1967-9-26,743
1967,9,27,987,987,0,1967-9-27,987
1967,9,28,824,576,248,1967-9-28,328
1967,9,29,645,413,232,1967-9-29,181
1967,9,30,728,388,340,1967-9-30,48
1967,10,1,896,448,448,1967-10-1,0
1967,10,2,1255,704,551,1967-10-2,153
1967,10,3,1340,701,639,1967-10-3,62
1967,10,4,1263,751,512,1967-10-4,239
1967,10,5,1317,623,694,1967-10-5,-71
1967,10,6,1221,347,874,1967-10-6,-527
1967,10,7,1207,275,932,1967-10-7,-657
1967,10,8,621,81,540,1967-10-8,-459
1967,10,9,711,303,408,1967-10-9,-105
1967,10,10,976,785,191,1967-10-10,594
1967,10,11,1309,1061,248,1967-10-11,813
1967,10,12,959,747,212,1967-10-12,535
1967,10,13,888,706,182,1967-10-13,524
1967,10,14,626,467,159,1967-10-14,308
1967,10,15,555,371,184,1967-10-15,187
1967,10,16,306,227,79,1967-10-16,148
1967,10,17,243,138,105,1967-10-17,33
1967,10,18,299,211,88,1967-10-18,123
1967,10,19,408,347,61,1967-10-19,286
1967,10,20,658,634,24,1967-10-20,610
1967,10,21,713,713,0,1967-10-21,713
1967,10,22,1010,1010,0,1967-10-22,1010
1967,10,23,862,862,0,1967-10-23,862
1967,10,24,1046,1046,0,1967-10-24,1046
1967,10,25,1070,1070,0,1967-10-25,1070
1967,10,26,1634,1634,0,1967-10-26,1634
1967,10,27,2332,2204,128,1967-10-27,2076
1967,10,28,3110,2523,587,1967-10-28,1936
1967,10,29,2548,1719,829,1967-10-29,890
1967,10,30,1779,855,924,1967-10-30,-69
1967,10,31,1480,677,803,1967-10-31,-126
1967,11,1,1358,609,749,1967-11-1,-140
1967,11,2,1345,637,708,1967-11-2,-71
1967,11,3,1441,679,762,1967-11-3,-83
1967,11,4,1495,856,639,1967-11-4,217
1967,11,5,879,355,524,1967-11-5,-169
1967,11,6,674,276,398,1967-11-6,-122
1967,11,7,870,348,522,1967-11-7,-174
1967,11,8,188,4,184,1967-11-8,-180
1967,11,9,437,253,184,1967-11-9,69
1967,11,10,585,281,304,1967-11-10,-23
1967,11,11,368,368,0,1967-11-11,368
1967,11,12,549,549,0,1967-11-12,549
1967,11,13,1560,1468,92,1967-11-13,1376
1967,11,14,1456,1417,39,1967-11-14,1378
1967,11,15,1591,1492,99,1967-11-15,1393
1967,11,16,1804,1657,147,1967-11-16,1510
1967,11,17,1509,1492,17,1967-11-17,1475
1967,11,18,1808,1703,105,1967-11-18,1598
1967,11,19,1945,1888,57,1967-11-19,1831
1967,11,20,2811,2544,267,1967-11-20,2277
1967,11,21,2405,2363,42,1967-11-21,2321
1967,11,22,2560,2483,77,1967-11-22,2406
1967,11,23,2041,1899,142,1967-11-23,1757
1967,11,24,2132,1777,355,1967-11-24,1422
1967,11,25,2156,1600,556,1967-11-25,1044
1967,11,26,1519,985,534,1967-11-26,451
1967,11,27,1897,1427,470,1967-11-27,957
1967,11,28,2553,1598,955,1967-11-28,643
1967,11,29,2551,1585,966,1967-11-29,619
1967,11,30,2116,880,1236,1967-11-30,-356
1967,12,1,2066,567,1499,1967-12-1,-932
1967,12,2,1084,463,621,1967-12-2,-158
1967,12,3,988,619,369,1967-12-3,250
1967,12,4,743,480,263,1967-12-4,217
1967,12,5,639,336,303,1967-12-5,33
1967,12,6,1007,463,544,1967-12-6,-81
1967,12,7,1350,688,662,1967-12-7,26
1967,12,8,1044,611,433,1967-12-8,178
1967,12,9,1184,675,509,1967-12-9,166
1967,12,10,1016,658,358,1967-12-10,300
1967,12,11,1162,663,499,1967-12-11,164
1967,12,12,1146,575,571,1967-12-12,4
1967,12,13,1390,720,670,1967-12-13,50
1967,12,14,1538,612,926,1967-12-14,-314
1967,12,15,2089,1079,1010,1967-12-15,69
1967,12,16,2669,1619,1050,1967-12-16,569
1967,12,17,3501,2291,1210,1967-12-17,1081
1967,12,18,3983,2987,996,1967-12-18,1991
1967,12,19,3551,3141,410,1967-12-19,2731
1967,12,20,3582,3211,371,1967-12-20,2840
1967,12,21,3519,2815,704,1967-12-21,2111
1967,12,22,3609,2624,985,1967-12-22,1639
1967,12,23,2056,1226,830,1967-12-23,396
1967,12,24,1172,285,887,1967-12-24,-602
1967,12,25,1349,278,1071,1967-12-25,-793
1967,12,26,2229,267,1962,1967-12-26,-1695
1967,12,27,2135,194,1941,1967-12-27,-1747
1967,12,28,2748,13,2735,1967-12-28,-2722
1967,12,29,2857,26,2831,1967-12-29,-2805
1967,12,30,2608,4,2604,1967-12-30,-2600
1967,12,31,2117,0,2117,1967-12-31,-2117
1968,1,1,2513,0,2513,1968-1-1,-2513
1968,1,2,2953,0,2953,1968-1-2,-2953
1968,1,3,2910,18,2892,1968-1-3,-2874
1968,1,4,3466,368,3098,1968-1-4,-2730
1968,1,5,3930,1107,2823,1968-1-5,-1716
1968,1,6,3700,1241,2459,1968-1-6,-1218
1968,1,7,4245,2451,1794,1968-1-7,657
1968,1,8,4837,3203,1634,1968-1-8,1569
1968,1,9,4066,2907,1159,1968-1-9,1748
1968,1,10,3634,2701,933,1968-1-10,1768
1968,1,11,3116,2283,833,1968-1-11,1450
1968,1,12,2636,1940,696,1968-1-12,1244
1968,1,13,2480,1923,557,1968-1-13,1366
1968,1,14,1988,1583,405,1968-1-14,1178
1968,1,15,1733,1404,329,1968-1-15,1075
1968,1,16,909,766,143,1968-1-16,623
1968,1,17,894,846,48,1968-1-17,798
1968,1,18,706,476,230,1968-1-18,246
1968,1,19,507,191,316,1968-1-19,-125
1968,1,20,226,61,165,1968-1-20,-104
1968,1,21,193,30,163,1968-1-21,-133
1968,1,22,258,87,171,1968-1-22,-84
1968,1,23,203,84,119,1968-1-23,-35
1968,1,24,1334,996,338,1968-1-24,658
1968,1,25,2426,2013,413,1968-1-25,1600
1968,1,26,2440,2141,299,1968-1-26,1842
1968,1,27,2489,2240,249,1968-1-27,1991
1968,1,28,3546,3296,250,1968-1-28,3046
1968,1,29,3643,3441,202,1968-1-29,3239
1968,1,30,4454,4101,353,1968-1-30,3748
1968,1,31,4531,4110,421,1968-1-31,3689
1968,2,1,5220,4462,758,1968-2-1,3704
1968,2,2,4775,3952,823,1968-2-2,3129
1968,2,3,4617,3726,891,1968-2-3,2835
1968,2,4,4007,3371,636,1968-2-4,2735
1968,2,5,3774,3163,611,1968-2-5,2552
1968,2,6,1986,1583,403,1968-2-6,1180
1968,2,7,1055,695,360,1968-2-7,335
1968,2,8,1437,897,540,1968-2-8,357
1968,2,9,1621,1238,383,1968-2-9,855
1968,2,10,1583,1259,324,1968-2-10,935
1968,2,11,1562,1430,132,1968-2-11,1298
1968,2,12,1392,1250,142,1968-2-12,1108
1968,2,13,1134,1024,110,1968-2-13,914
1968,2,14,936,830,106,1968-2-14,724
1968,2,15,851,688,163,1968-2-15,525
1968,2,16,845,678,167,1968-2-16,511
1968,2,17,593,313,280,1968-2-17,33
1968,2,18,403,191,212,1968-2-18,-21
1968,2,19,327,119,208,1968-2-19,-89
1968,2,20,708,495,213,1968-2-20,282
1968,2,21,1270,1144,126,1968-2-21,1018
1968,2,22,1501,1404,97,1968-2-22,1307
1968,2,23,1340,1186,154,1968-2-23,1032
1968,2,24,1504,1333,171,1968-2-24,1162
1968,2,25,2351,1946,405,1968-2-25,1541
1968,2,26,2218,1810,408,1968-2-26,1402
1968,2,27,1914,1586,328,1968-2-27,1258
1968,2,28,1713,1305,408,1968-2-28,897
1968,2,29,1862,1168,694,1968-2-29,474
1968,3,1,1571,995,576,1968-3-1,419
1968,3,2,1599,1010,589,1968-3-2,421
1968,3,3,1194,691,503,1968-3-3,188
1968,3,4,635,187,448,1968-3-4,-261
1968,3,5,522,159,363,1968-3-5,-204
1968,3,6,495,180,315,1968-3-6,-135
1968,3,7,504,96,408,1968-3-7,-312
1968,3,8,522,0,522,1968-3-8,-522
1968,3,9,511,122,389,1968-3-9,-267
1968,3,10,555,158,397,1968-3-10,-239
1968,3,11,734,324,410,1968-3-11,-86
1968,3,12,1047,604,443,1968-3-12,161
1968,3,13,1890,1259,631,1968-3-13,628
1968,3,14,1016,936,80,1968-3-14,856
1968,3,15,1027,966,61,1968-3-15,905
1968,3,16,1013,986,27,1968-3-16,959
1968,3,17,1006,997,9,1968-3-17,988
1968,3,18,971,963,8,1968-3-18,955
1968,3,19,849,835,14,1968-3-19,821
1968,3,20,828,734,94,1968-3-20,640
1968,3,21,875,667,208,1968-3-21,459
1968,3,22,1006,821,185,1968-3-22,636
1968,3,23,1346,1061,285,1968-3-23,776
1968,3,24,1666,1160,506,1968-3-24,654
1968,3,25,1842,1359,483,1968-3-25,876
1968,3,26,1469,963,506,1968-3-26,457
1968,3,27,1532,833,699,1968-3-27,134
1968,3,28,1667,726,941,1968-3-28,-215
1968,3,29,1652,751,901,1968-3-29,-150
1968,3,30,1607,687,920,1968-3-30,-233
1968,3,31,1490,622,868,1968-3-31,-246
1968,4,1,1264,537,727,1968-4-1,-190
1968,4,2,1189,453,736,1968-4-2,-283
1968,4,3,1028,396,632,1968-4-3,-236
1968,4,4,1002,324,678,1968-4-4,-354
1968,4,5,1034,326,708,1968-4-5,-382
1968,4,6,1082,299,783,1968-4-6,-484
1968,4,7,840,302,538,1968-4-7,-236
1968,4,8,1299,907,392,1968-4-8,515
1968,4,9,1709,1268,441,1968-4-9,827
1968,4,10,1712,1323,389,1968-4-10,934
1968,4,11,2059,1611,448,1968-4-11,1163
1968,4,12,1556,1482,74,1968-4-12,1408
1968,4,13,1469,1377,92,1968-4-13,1285
1968,4,14,1619,1406,213,1968-4-14,1193
1968,4,15,1540,1307,233,1968-4-15,1074
1968,4,16,1361,1210,151,1968-4-16,1059
1968,4,17,1061,931,130,1968-4-17,801
1968,4,18,876,767,109,1968-4-18,658
1968,4,19,751,719,32,1968-4-19,687
1968,4,20,742,706,36,1968-4-20,670
1968,4,21,770,743,27,1968-4-21,716
1968,4,22,279,262,17,1968-4-22,245
1968,4,23,425,329,96,1968-4-23,233
1968,4,24,213,97,116,1968-4-24,-19
1968,4,25,375,184,191,1968-4-25,-7
1968,4,26,349,170,179,1968-4-26,-9
1968,4,27,417,207,210,1968-4-27,-3
1968,4,28,480,209,271,1968-4-28,-62
1968,4,29,447,312,135,1968-4-29,177
1968,4,30,1111,986,125,1968-4-30,861
1968,5,1,1325,1225,100,1968-5-1,1125
1968,5,2,2008,1933,75,1968-5-2,1858
1968,5,3,1910,1840,70,1968-5-3,1770
1968,5,4,1586,1555,31,1968-5-4,1524
1968,5,5,1652,1609,43,1968-5-5,1566
1968,5,6,1652,1500,152,1968-5-6,1348
1968,5,7,1771,1662,109,1968-5-7,1553
1968,5,8,1133,1041,92,1968-5-8,949
1968,5,9,999,902,97,1968-5-9,805
1968,5,10,974,905,69,1968-5-10,836
1968,5,11,699,649,50,1968-5-11,599
1968,5,12,635,594,41,1968-5-12,553
1968,5,13,772,704,68,1968-5-13,636
1968,5,14,1077,414,663,1968-5-14,-249
1968,5,15,1128,338,790,1968-5-15,-452
1968,5,16,890,199,691,1968-5-16,-492
1968,5,17,2833,1179,1654,1968-5-17,-475
1968,5,18,2915,1279,1636,1968-5-18,-357
1968,5,19,3096,1305,1791,1968-5-19,-486
1968,5,20,3149,1359,1790,1968-5-20,-431
1968,5,21,2873,1160,1713,1968-5-21,-553
1968,5,22,3259,1480,1779,1968-5-22,-299
1968,5,23,2843,1291,1552,1968-5-23,-261
1968,5,24,2871,1337,1534,1968-5-24,-197
1968,5,25,2478,1304,1174,1968-5-25,130
1968,5,26,2229,1085,1144,1968-5-26,-59
1968,5,27,2463,1111,1352,1968-5-27,-241
1968,5,28,2207,974,1233,1968-5-28,-259
1968,5,29,2018,934,1084,1968-5-29,-150
1968,5,30,1678,646,1032,1968-5-30,-386
1968,5,31,1905,822,1083,1968-5-31,-261
1968,6,1,1729,740,989,1968-6-1,-249
1968,6,2,1398,662,736,1968-6-2,-74
1968,6,3,1877,606,1271,1968-6-3,-665
1968,6,4,1535,432,1103,1968-6-4,-671
1968,6,5,1286,269,1017,1968-6-5,-748
1968,6,6,1820,558,1262,1968-6-6,-704
1968,6,7,1335,446,889,1968-6-7,-443
1968,6,8,1571,732,839,1968-6-8,-107
1968,6,9,1314,973,341,1968-6-9,632
1968,6,10,1290,879,411,1968-6-10,468
1968,6,11,1467,816,651,1968-6-11,165
1968,6,12,1890,879,1011,1968-6-12,-132
1968,6,13,2328,883,1445,1968-6-13,-562
1968,6,14,2210,1089,1121,1968-6-14,-32
1968,6,15,2053,932,1121,1968-6-15,-189
1968,6,16,1727,651,1076,1968-6-16,-425
1968,6,17,1748,791,957,1968-6-17,-166
1968,6,18,2110,1144,966,1968-6-18,178
1968,6,19,2193,1399,794,1968-6-19,605
1968,6,20,2442,2075,367,1968-6-20,1708
1968,6,21,2590,2246,344,1968-6-21,1902
1968,6,22,2658,2283,375,1968-6-22,1908
1968,6,23,2437,2089,348,1968-6-23,1741
1968,6,24,2786,2365,421,1968-6-24,1944
1968,6,25,2460,2335,125,1968-6-25,2210
1968,6,26,2508,2331,177,1968-6-26,2154
1968,6,27,1160,939,221,1968-6-27,718
1968,6,28,1198,850,348,1968-6-28,502
1968,6,29,952,637,315,1968-6-29,322
1968,6,30,1084,667,417,1968-6-30,250
1968,7,1,737,589,148,1968-7-1,441
1968,7,2,602,602,0,1968-7-2,602
1968,7,3,518,497,21,1968-7-3,476
1968,7,4,684,684,0,1968-7-4,684
1968,7,5,646,485,161,1968-7-5,324
1968,7,6,1500,1332,168,1968-7-6,1164
1968,7,7,1946,1836,110,1968-7-7,1726
1968,7,8,1943,1792,151,1968-7-8,1641
1968,7,9,1909,1799,110,1968-7-9,1689
1968,7,10,1991,1632,359,1968-7-10,1273
1968,7,11,2252,1894,358,1968-7-11,1536
1968,7,12,2160,1849,311,1968-7-12,1538
1968,7,13,2341,2009,332,1968-7-13,1677
1968,7,14,1724,1494,230,1968-7-14,1264
1968,7,15,1793,1567,226,1968-7-15,1341
1968,7,16,1736,1309,427,1968-7-16,882
1968,7,17,1607,1086,521,1968-7-17,565
1968,7,18,1392,916,476,1968-7-18,440
1968,7,19,1296,884,412,1968-7-19,472
1968,7,20,1025,528,497,1968-7-20,31
1968,7,21,906,385,521,1968-7-21,-136
1968,7,22,839,259,580,1968-7-22,-321
1968,7,23,925,155,770,1968-7-23,-615
1968,7,24,1708,535,1173,1968-7-24,-638
1968,7,25,2172,855,1317,1968-7-25,-462
1968,7,26,2357,795,1562,1968-7-26,-767
1968,7,27,1768,774,994,1968-7-27,-220
1968,7,28,1515,827,688,1968-7-28,139
1968,7,29,1684,1144,540,1968-7-29,604
1968,7,30,1464,1349,115,1968-7-30,1234
1968,7,31,800,800,0,1968-7-31,800
1968,8,1,583,583,0,1968-8-1,583
1968,8,2,1122,1084,38,1968-8-2,1046
1968,8,3,1495,1415,80,1968-8-3,1335
1968,8,4,1515,1388,127,1968-8-4,1261
1968,8,5,1359,1238,121,1968-8-5,1117
1968,8,6,971,927,44,1968-8-6,883
1968,8,7,1183,1046,137,1968-8-7,909
1968,8,8,1313,1171,142,1968-8-8,1029
1968,8,9,1008,933,75,1968-8-9,858
1968,8,10,1006,782,224,1968-8-10,558
1968,8,11,1192,959,233,1968-8-11,726
1968,8,12,2320,937,1383,1968-8-12,-446
1968,8,13,3064,1556,1508,1968-8-13,48
1968,8,14,4108,1639,2469,1968-8-14,-830
1968,8,15,4365,1278,3087,1968-8-15,-1809
1968,8,16,3178,546,2632,1968-8-16,-2086
1968,8,17,2510,487,2023,1968-8-17,-1536
1968,8,18,2457,487,1970,1968-8-18,-1483
1968,8,19,2368,511,1857,1968-8-19,-1346
1968,8,20,1965,350,1615,1968-8-20,-1265
1968,8,21,2181,330,1851,1968-8-21,-1521
1968,8,22,2176,513,1663,1968-8-22,-1150
1968,8,23,1989,522,1467,1968-8-23,-945
1968,8,24,1498,536,962,1968-8-24,-426
1968,8,25,800,353,447,1968-8-25,-94
1968,8,26,437,178,259,1968-8-26,-81
1968,8,27,445,106,339,1968-8-27,-233
1968,8,28,302,68,234,1968-8-28,-166
1968,8,29,657,414,243,1968-8-29,171
1968,8,30,724,459,265,1968-8-30,194
1968,8,31,568,362,206,1968-8-31,156
1968,9,1,535,297,238,1968-9-1,59
1968,9,2,860,358,502,1968-9-2,-144
1968,9,3,1249,369,880,1968-9-3,-511
1968,9,4,1665,429,1236,1968-9-4,-807
1968,9,5,1430,333,1097,1968-9-5,-764
1968,9,6,1149,303,846,1968-9-6,-543
1968,9,7,1096,269,827,1968-9-7,-558
1968,9,8,1088,235,853,1968-9-8,-618
1968,9,9,1860,232,1628,1968-9-9,-1396
1968,9,10,1460,196,1264,1968-9-10,-1068
1968,9,11,1493,273,1220,1968-9-11,-947
1968,9,12,1584,270,1314,1968-9-12,-1044
1968,9,13,1165,206,959,1968-9-13,-753
1968,9,14,1085,185,900,1968-9-14,-715
1968,9,15,793,145,648,1968-9-15,-503
1968,9,16,802,368,434,1968-9-16,-66
1968,9,17,627,377,250,1968-9-17,127
1968,9,18,1191,933,258,1968-9-18,675
1968,9,19,1222,983,239,1968-9-19,744
1968,9,20,1130,1026,104,1968-9-20,922
1968,9,21,1168,1115,53,1968-9-21,1062
1968,9,22,1008,974,34,1968-9-22,940
1968,9,23,1224,1164,60,1968-9-23,1104
1968,9,24,1342,1290,52,1968-9-24,1238
1968,9,25,1956,1623,333,1968-9-25,1290
1968,9,26,1997,1728,269,1968-9-26,1459
1968,9,27,1705,1447,258,1968-9-27,1189
1968,9,28,1729,1428,301,1968-9-28,1127
1968,9,29,1345,960,385,1968-9-29,575
1968,9,30,974,673,301,1968-9-30,372
1968,10,1,973,701,272,1968-10-1,429
1968,10,2,966,658,308,1968-10-2,350
1968,10,3,1067,765,302,1968-10-3,463
1968,10,4,1240,957,283,1968-10-4,674
1968,10,5,1240,986,254,1968-10-5,732
1968,10,6,1169,840,329,1968-10-6,511
1968,10,7,1202,858,344,1968-10-7,514
1968,10,8,1123,636,487,1968-10-8,149
1968,10,9,909,553,356,1968-10-9,197
1968,10,10,875,492,383,1968-10-10,109
1968,10,11,1070,745,325,1968-10-11,420
1968,10,12,1048,632,416,1968-10-12,216
1968,10,13,888,675,213,1968-10-13,462
1968,10,14,745,615,130,1968-10-14,485
1968,10,15,795,658,137,1968-10-15,521
1968,10,16,719,578,141,1968-10-16,437
1968,10,17,1389,1274,115,1968-10-17,1159
1968,10,18,1195,1165,30,1968-10-18,1135
1968,10,19,1721,1439,282,1968-10-19,1157
1968,10,20,1682,1454,228,1968-10-20,1226
1968,10,21,1819,1576,243,1968-10-21,1333
1968,10,22,2161,1425,736,1968-10-22,689
1968,10,23,2070,1059,1011,1968-10-23,48
1968,10,24,1581,571,1010,1968-10-24,-439
1968,10,25,2296,840,1456,1968-10-25,-616
1968,10,26,2133,656,1477,1968-10-26,-821
1968,10,27,1955,608,1347,1968-10-27,-739
1968,10,28,1954,479,1475,1968-10-28,-996
1968,10,29,2176,548,1628,1968-10-29,-1080
1968,10,30,1699,123,1576,1968-10-30,-1453
1968,10,31,1747,151,1596,1968-10-31,-1445
1968,11,1,2042,354,1688,1968-11-1,-1334
1968,11,2,2085,373,1712,1968-11-2,-1339
1968,11,3,1820,312,1508,1968-11-3,-1196
1968,11,4,788,309,479,1968-11-4,-170
1968,11,5,850,329,521,1968-11-5,-192
1968,11,6,953,423,530,1968-11-6,-107
1968,11,7,839,429,410,1968-11-7,19
1968,11,8,1146,754,392,1968-11-8,362
1968,11,9,1344,1131,213,1968-11-9,918
1968,11,10,1516,1258,258,1968-11-10,1000
1968,11,11,1367,1152,215,1968-11-11,937
1968,11,12,1021,960,61,1968-11-12,899
1968,11,13,1064,1037,27,1968-11-13,1010
1968,11,14,1086,1044,42,1968-11-14,1002
1968,11,15,1017,993,24,1968-11-15,969
1968,11,16,954,932,22,1968-11-16,910
1968,11,17,1182,1164,18,1968-11-17,1146
1968,11,18,1284,1259,25,1968-11-18,1234
1968,11,19,1329,768,561,1968-11-19,207
1968,11,20,1371,660,711,1968-11-20,-51
1968,11,21,985,478,507,1968-11-21,-29
1968,11,22,764,318,446,1968-11-22,-128
1968,11,23,697,178,519,1968-11-23,-341
1968,11,24,603,65,538,1968-11-24,-473
1968,11,25,802,22,780,1968-11-25,-758
1968,11,26,1217,0,1217,1968-11-26,-1217
1968,11,27,1370,0,1370,1968-11-27,-1370
1968,11,28,869,0,869,1968-11-28,-869
1968,11,29,897,0,897,1968-11-29,-897
1968,11,30,768,97,671,1968-11-30,-574
1968,12,1,1035,280,755,1968-12-1,-475
1968,12,2,1627,743,884,1968-12-2,-141
1968,12,3,1741,977,764,1968-12-3,213
1968,12,4,1963,1379,584,1968-12-4,795
1968,12,5,1700,1249,451,1968-12-5,798
1968,12,6,1706,1337,369,1968-12-6,968
1968,12,7,1746,1378,368,1968-12-7,1010
1968,12,8,2142,1699,443,1968-12-8,1256
1968,12,9,2374,1930,444,1968-12-9,1486
1968,12,10,2775,2041,734,1968-12-10,1307
1968,12,11,2769,1941,828,1968-12-11,1113
1968,12,12,1943,979,964,1968-12-12,15
1968,12,13,832,132,700,1968-12-13,-568
1968,12,14,1145,73,1072,1968-12-14,-999
1968,12,15,1113,99,1014,1968-12-15,-915
1968,12,16,919,137,782,1968-12-16,-645
1968,12,17,643,198,445,1968-12-17,-247
1968,12,18,1354,628,726,1968-12-18,-98
1968,12,19,1355,93,1262,1968-12-19,-1169
1968,12,20,714,57,657,1968-12-20,-600
1968,12,21,1230,649,581,1968-12-21,68
1968,12,22,2456,1349,1107,1968-12-22,242
1968,12,23,1929,1325,604,1968-12-23,721
1968,12,24,1601,922,679,1968-12-24,243
1968,12,25,1688,831,857,1968-12-25,-26
1968,12,26,2530,1427,1103,1968-12-26,324
1968,12,27,2401,1509,892,1968-12-27,617
1968,12,28,1890,1340,550,1968-12-28,790
1968,12,29,1575,1215,360,1968-12-29,855
1968,12,30,1673,1345,328,1968-12-30,1017
1968,12,31,1667,1375,292,1968-12-31,1083
1969,1,1,1229,1057,172,1969-1-1,885
1969,1,2,1851,1725,126,1969-1-2,1599
1969,1,3,1297,1196,101,1969-1-3,1095
1969,1,4,2230,1622,608,1969-1-4,1014
1969,1,5,2438,1769,669,1969-1-5,1100
1969,1,6,2942,2159,783,1969-1-6,1376
1969,1,7,2741,1758,983,1969-1-7,775
1969,1,8,2403,1424,979,1969-1-8,445
1969,1,9,2428,1287,1141,1969-1-9,146
1969,1,10,2764,1349,1415,1969-1-10,-66
1969,1,11,2385,1062,1323,1969-1-11,-261
1969,1,12,2048,863,1185,1969-1-12,-322
1969,1,13,1817,779,1038,1969-1-13,-259
1969,1,14,2213,1085,1128,1969-1-14,-43
1969,1,15,2032,921,1111,1969-1-15,-190
1969,1,16,2087,1052,1035,1969-1-16,17
1969,1,17,1664,974,690,1969-1-17,284
1969,1,18,1238,909,329,1969-1-18,580
1969,1,19,879,755,124,1969-1-19,631
1969,1,20,638,555,83,1969-1-20,472
1969,1,21,676,602,74,1969-1-21,528
1969,1,22,744,662,82,1969-1-22,580
1969,1,23,671,613,58,1969-1-23,555
1969,1,24,428,407,21,1969-1-24,386
1969,1,25,773,773,0,1969-1-25,773
1969,1,26,867,867,0,1969-1-26,867
1969,1,27,1457,1457,0,1969-1-27,1457
1969,1,28,726,726,0,1969-1-28,726
1969,1,29,1278,1254,24,1969-1-29,1230
1969,1,30,903,857,46,1969-1-30,811
1969,1,31,854,752,102,1969-1-31,650
1969,2,1,753,638,115,1969-2-1,523
1969,2,2,836,599,237,1969-2-2,362
1969,2,3,766,457,309,1969-2-3,148
1969,2,4,691,431,260,1969-2-4,171
1969,2,5,712,610,102,1969-2-5,508
1969,2,6,817,704,113,1969-2-6,591
1969,2,7,1124,1023,101,1969-2-7,922
1969,2,8,948,817,131,1969-2-8,686
1969,2,9,853,747,106,1969-2-9,641
1969,2,10,856,714,142,1969-2-10,572
1969,2,11,1036,858,178,1969-2-11,680
1969,2,12,360,254,106,1969-2-12,148
1969,2,13,519,371,148,1969-2-13,223
1969,2,14,473,289,184,1969-2-14,105
1969,2,15,788,409,379,1969-2-15,30
1969,2,16,804,444,360,1969-2-16,84
1969,2,17,923,545,378,1969-2-17,167
1969,2,18,1164,822,342,1969-2-18,480
1969,2,19,1246,958,288,1969-2-19,670
1969,2,20,1342,1033,309,1969-2-20,724
1969,2,21,1519,1243,276,1969-2-21,967
1969,2,22,1640,1366,274,1969-2-22,1092
1969,2,23,2383,1844,539,1969-2-23,1305
1969,2,24,2465,1665,800,1969-2-24,865
1969,2,25,2837,1651,1186,1969-2-25,465
1969,2,26,2921,1776,1145,1969-2-26,631
1969,2,27,2647,1338,1309,1969-2-27,29
1969,2,28,2203,1116,1087,1969-2-28,29
1969,3,1,1785,629,1156,1969-3-1,-527
1969,3,2,1454,526,928,1969-3-2,-402
1969,3,3,1135,305,830,1969-3-3,-525
1969,3,4,1151,284,867,1969-3-4,-583
1969,3,5,1078,326,752,1969-3-5,-426
1969,3,6,1242,539,703,1969-3-6,-164
1969,3,7,1242,678,564,1969-3-7,114
1969,3,8,1330,912,418,1969-3-8,494
1969,3,9,1281,1118,163,1969-3-9,955
1969,3,10,1189,1065,124,1969-3-10,941
1969,3,11,1156,940,216,1969-3-11,724
1969,3,12,1149,940,209,1969-3-12,731
1969,3,13,1112,790,322,1969-3-13,468
1969,3,14,964,722,242,1969-3-14,480
1969,3,15,1087,921,166,1969-3-15,755
1969,3,16,2191,1880,311,1969-3-16,1569
1969,3,17,2822,2314,508,1969-3-17,1806
1969,3,18,3551,2914,637,1969-3-18,2277
1969,3,19,2901,2368,533,1969-3-19,1835
1969,3,20,2908,2404,504,1969-3-20,1900
1969,3,21,3404,2568,836,1969-3-21,1732
1969,3,22,3633,2751,882,1969-3-22,1869
1969,3,23,3302,2509,793,1969-3-23,1716
1969,3,24,3220,2497,723,1969-3-24,1774
1969,3,25,3309,2636,673,1969-3-25,1963
1969,3,26,3003,2408,595,1969-3-26,1813
1969,3,27,3109,2555,554,1969-3-27,2001
1969,3,28,3731,3334,397,1969-3-28,2937
1969,3,29,2748,2526,222,1969-3-29,2304
1969,3,30,2808,2658,150,1969-3-30,2508
1969,3,31,2811,2565,246,1969-3-31,2319
1969,4,1,2691,2587,104,1969-4-1,2483
1969,4,2,2512,2350,162,1969-4-2,2188
1969,4,3,3056,2851,205,1969-4-3,2646
1969,4,4,2862,2656,206,1969-4-4,2450
1969,4,5,2390,2325,65,1969-4-5,2260
1969,4,6,2328,2182,146,1969-4-6,2036
1969,4,7,1901,1794,107,1969-4-7,1687
1969,4,8,1834,1464,370,1969-4-8,1094
1969,4,9,1028,600,428,1969-4-9,172
1969,4,10,1117,518,599,1969-4-10,-81
1969,4,11,1454,838,616,1969-4-11,222
1969,4,12,1370,600,770,1969-4-12,-170
1969,4,13,1616,1003,613,1969-4-13,390
1969,4,14,1972,1260,712,1969-4-14,548
1969,4,15,1838,1072,766,1969-4-15,306
1969,4,16,1661,872,789,1969-4-16,83
1969,4,17,1692,962,730,1969-4-17,232
1969,4,18,1302,705,597,1969-4-18,108
1969,4,19,1469,768,701,1969-4-19,67
1969,4,20,1360,669,691,1969-4-20,-22
1969,4,21,1444,932,512,1969-4-21,420
1969,4,22,1314,756,558,1969-4-22,198
1969,4,23,521,319,202,1969-4-23,117
1969,4,24,814,667,147,1969-4-24,520
1969,4,25,714,576,138,1969-4-25,438
1969,4,26,556,483,73,1969-4-26,410
1969,4,27,674,658,16,1969-4-27,642
1969,4,28,568,552,16,1969-4-28,536
1969,4,29,467,460,7,1969-4-29,453
1969,4,30,736,736,0,1969-4-30,736
1969,5,1,816,540,276,1969-5-1,264
1969,5,2,864,550,314,1969-5-2,236
1969,5,3,1080,538,542,1969-5-3,-4
1969,5,4,1123,345,778,1969-5-4,-433
1969,5,5,1147,359,788,1969-5-5,-429
1969,5,6,677,14,663,1969-5-6,-649
1969,5,7,484,9,475,1969-5-7,-466
1969,5,8,584,31,553,1969-5-8,-522
1969,5,9,772,17,755,1969-5-9,-738
1969,5,10,592,23,569,1969-5-10,-546
1969,5,11,839,370,469,1969-5-11,-99
1969,5,12,1192,582,610,1969-5-12,-28
1969,5,13,1260,557,703,1969-5-13,-146
1969,5,14,1009,544,465,1969-5-14,79
1969,5,15,1117,819,298,1969-5-15,521
1969,5,16,1075,823,252,1969-5-16,571
1969,5,17,1286,865,421,1969-5-17,444
1969,5,18,1346,754,592,1969-5-18,162
1969,5,19,2030,1120,910,1969-5-19,210
1969,5,20,1890,884,1006,1969-5-20,-122
1969,5,21,2313,928,1385,1969-5-21,-457
1969,5,22,2185,765,1420,1969-5-22,-655
1969,5,23,2250,850,1400,1969-5-23,-550
1969,5,24,2264,755,1509,1969-5-24,-754
1969,5,25,2392,718,1674,1969-5-25,-956
1969,5,26,2540,901,1639,1969-5-26,-738
1969,5,27,2104,523,1581,1969-5-27,-1058
1969,5,28,2191,574,1617,1969-5-28,-1043
1969,5,29,907,562,345,1969-5-29,217
1969,5,30,762,581,181,1969-5-30,400
1969,5,31,311,205,106,1969-5-31,99
1969,6,1,244,149,95,1969-6-1,54
1969,6,2,279,179,100,1969-6-2,79
1969,6,3,678,634,44,1969-6-3,590
1969,6,4,772,531,241,1969-6-4,290
1969,6,5,2560,1869,691,1969-6-5,1178
1969,6,6,3236,2078,1158,1969-6-6,920
1969,6,7,3080,2045,1035,1969-6-7,1010
1969,6,8,3550,2186,1364,1969-6-8,822
1969,6,9,3388,1954,1434,1969-6-9,520
1969,6,10,3875,2013,1862,1969-6-10,151
1969,6,11,4220,1996,2224,1969-6-11,-228
1969,6,12,3932,1807,2125,1969-6-12,-318
1969,6,13,4421,2162,2259,1969-6-13,-97
1969,6,14,4235,1983,2252,1969-6-14,-269
1969,6,15,4151,1949,2202,1969-6-15,-253
1969,6,16,1702,1117,585,1969-6-16,532
1969,6,17,1193,1031,162,1969-6-17,869
1969,6,18,789,652,137,1969-6-18,515
1969,6,19,881,814,67,1969-6-19,747
1969,6,20,957,945,12,1969-6-20,933
1969,6,21,846,826,20,1969-6-21,806
1969,6,22,779,770,9,1969-6-22,761
1969,6,23,700,669,31,1969-6-23,638
1969,6,24,762,663,99,1969-6-24,564
1969,6,25,815,655,160,1969-6-25,495
1969,6,26,126,47,79,1969-6-26,-32
1969,6,27,120,35,85,1969-6-27,-50
1969,6,28,307,137,170,1969-6-28,-33
1969,6,29,511,144,367,1969-6-29,-223
1969,6,30,709,280,429,1969-6-30,-149
1969,7,1,2127,656,1471,1969-7-1,-815
1969,7,2,1885,613,1272,1969-7-2,-659
1969,7,3,2440,730,1710,1969-7-3,-980
1969,7,4,2304,590,1714,1969-7-4,-1124
1969,7,5,2083,534,1549,1969-7-5,-1015
1969,7,6,1922,577,1345,1969-7-6,-768
1969,7,7,1694,580,1114,1969-7-7,-534
1969,7,8,1550,535,1015,1969-7-8,-480
1969,7,9,1511,460,1051,1969-7-9,-591
1969,7,10,1502,625,877,1969-7-10,-252
1969,7,11,1407,485,922,1969-7-11,-437
1969,7,12,1444,498,946,1969-7-12,-448
1969,7,13,1145,465,680,1969-7-13,-215
1969,7,14,664,529,135,1969-7-14,394
1969,7,15,648,547,101,1969-7-15,446
1969,7,16,657,544,113,1969-7-16,431
1969,7,17,1082,1023,59,1969-7-17,964
1969,7,18,795,753,42,1969-7-18,711
1969,7,19,611,611,0,1969-7-19,611
1969,7,20,484,471,13,1969-7-20,458
1969,7,21,410,349,61,1969-7-21,288
1969,7,22,305,208,97,1969-7-22,111
1969,7,23,168,96,72,1969-7-23,24
1969,7,24,458,74,384,1969-7-24,-310
1969,7,25,467,77,390,1969-7-25,-313
1969,7,26,572,99,473,1969-7-26,-374
1969,7,27,742,34,708,1969-7-27,-674
1969,7,28,1091,39,1052,1969-7-28,-1013
1969,7,29,1071,9,1062,1969-7-29,-1053
1969,7,30,1203,13,1190,1969-7-30,-1177
1969,7,31,1753,100,1653,1969-7-31,-1553
1969,8,1,2699,179,2520,1969-8-1,-2341
1969,8,2,2958,336,2622,1969-8-2,-2286
1969,8,3,2836,555,2281,1969-8-3,-1726
1969,8,4,3010,728,2282,1969-8-4,-1554
1969,8,5,2856,770,2086,1969-8-5,-1316
1969,8,6,2777,683,2094,1969-8-6,-1411
1969,8,7,1748,509,1239,1969-8-7,-730
1969,8,8,641,108,533,1969-8-8,-425
1969,8,9,687,175,512,1969-8-9,-337
1969,8,10,865,323,542,1969-8-10,-219
1969,8,11,955,204,751,1969-8-11,-547
1969,8,12,663,106,557,1969-8-12,-451
1969,8,13,388,71,317,1969-8-13,-246
1969,8,14,447,97,350,1969-8-14,-253
1969,8,15,528,95,433,1969-8-15,-338
1969,8,16,295,73,222,1969-8-16,-149
1969,8,17,208,56,152,1969-8-17,-96
1969,8,18,122,46,76,1969-8-18,-30
1969,8,19,82,24,58,1969-8-19,-34
1969,8,20,75,15,60,1969-8-20,-45
1969,8,21,75,30,45,1969-8-21,-15
1969,8,22,975,927,48,1969-8-22,879
1969,8,23,823,810,13,1969-8-23,797
1969,8,24,1047,944,103,1969-8-24,841
1969,8,25,1100,971,129,1969-8-25,842
1969,8,26,1340,1205,135,1969-8-26,1070
1969,8,27,1649,1524,125,1969-8-27,1399
1969,8,28,1723,1533,190,1969-8-28,1343
1969,8,29,1374,1154,220,1969-8-29,934
1969,8,30,1225,1062,163,1969-8-30,899
1969,8,31,1033,882,151,1969-8-31,731
1969,9,1,867,659,208,1969-9-1,451
1969,9,2,832,536,296,1969-9-2,240
1969,9,3,591,317,274,1969-9-3,43
1969,9,4,731,275,456,1969-9-4,-181
1969,9,5,788,331,457,1969-9-5,-126
1969,9,6,369,341,28,1969-9-6,313
1969,9,7,556,483,73,1969-9-7,410
1969,9,8,605,328,277,1969-9-8,51
1969,9,9,672,87,585,1969-9-9,-498
1969,9,10,601,63,538,1969-9-10,-475
1969,9,11,578,88,490,1969-9-11,-402
1969,9,12,704,105,599,1969-9-12,-494
1969,9,13,1054,257,797,1969-9-13,-540
1969,9,14,1252,335,917,1969-9-14,-582
1969,9,15,966,445,521,1969-9-15,-76
1969,9,16,896,453,443,1969-9-16,10
1969,9,17,882,490,392,1969-9-17,98
1969,9,18,780,459,321,1969-9-18,138
1969,9,19,534,370,164,1969-9-19,206
1969,9,20,395,217,178,1969-9-20,39
1969,9,21,878,556,322,1969-9-21,234
1969,9,22,1063,801,262,1969-9-22,539
1969,9,23,921,738,183,1969-9-23,555
1969,9,24,1074,862,212,1969-9-24,650
1969,9,25,1455,1064,391,1969-9-25,673
1969,9,26,1304,946,358,1969-9-26,588
1969,9,27,1305,796,509,1969-9-27,287
1969,9,28,1176,609,567,1969-9-28,42
1969,9,29,772,230,542,1969-9-29,-312
1969,9,30,773,256,517,1969-9-30,-261
1969,10,1,840,170,670,1969-10-1,-500
1969,10,2,1156,368,788,1969-10-2,-420
1969,10,3,1103,445,658,1969-10-3,-213
1969,10,4,1034,375,659,1969-10-4,-284
1969,10,5,1156,559,597,1969-10-5,-38
1969,10,6,1498,921,577,1969-10-6,344
1969,10,7,1586,1071,515,1969-10-7,556
1969,10,8,1652,1219,433,1969-10-8,786
1969,10,9,1693,1496,197,1969-10-9,1299
1969,10,10,1599,1411,188,1969-10-10,1223
1969,10,11,1639,1482,157,1969-10-11,1325
1969,10,12,1020,863,157,1969-10-12,706
1969,10,13,594,366,228,1969-10-13,138
1969,10,14,580,288,292,1969-10-14,-4
1969,10,15,650,289,361,1969-10-15,-72
1969,10,16,571,243,328,1969-10-16,-85
1969,10,17,314,239,75,1969-10-17,164
1969,10,18,590,514,76,1969-10-18,438
1969,10,19,529,472,57,1969-10-19,415
1969,10,20,2321,2239,82,1969-10-20,2157
1969,10,21,2961,2668,293,1969-10-21,2375
1969,10,22,2852,2487,365,1969-10-22,2122
1969,10,23,2701,2490,211,1969-10-23,2279
1969,10,24,2651,2368,283,1969-10-24,2085
1969,10,25,2463,2236,227,1969-10-25,2009
1969,10,26,2565,2322,243,1969-10-26,2079
1969,10,27,2478,2190,288,1969-10-27,1902
1969,10,28,2301,2061,240,1969-10-28,1821
1969,10,29,2009,1821,188,1969-10-29,1633
1969,10,30,2131,1938,193,1969-10-30,1745
1969,10,31,1561,1410,151,1969-10-31,1259
1969,11,1,685,592,93,1969-11-1,499
1969,11,2,269,206,63,1969-11-2,143
1969,11,3,477,410,67,1969-11-3,343
1969,11,4,855,803,52,1969-11-4,751
1969,11,5,844,835,9,1969-11-5,826
1969,11,6,1092,1076,16,1969-11-6,1060
1969,11,7,954,889,65,1969-11-7,824
1969,11,8,906,849,57,1969-11-8,792
1969,11,9,828,714,114,1969-11-9,600
1969,11,10,830,719,111,1969-11-10,608
1969,11,11,621,573,48,1969-11-11,525
1969,11,12,539,495,44,1969-11-12,451
1969,11,13,484,442,42,1969-11-13,400
1969,11,14,899,884,15,1969-11-14,869
1969,11,15,2415,2403,12,1969-11-15,2391
1969,11,16,2143,2131,12,1969-11-16,2119
1969,11,17,2814,2717,97,1969-11-17,2620
1969,11,18,2769,2690,79,1969-11-18,2611
1969,11,19,2840,2703,137,1969-11-19,2566
1969,11,20,2763,2724,39,1969-11-20,2685
1969,11,21,2989,2914,75,1969-11-21,2839
1969,11,22,2779,2715,64,1969-11-22,2651
1969,11,23,2855,2724,131,1969-11-23,2593
1969,11,24,2944,2768,176,1969-11-24,2592
1969,11,25,3260,2700,560,1969-11-25,2140
1969,11,26,3409,2606,803,1969-11-26,1803
1969,11,27,3064,2269,795,1969-11-27,1474
1969,11,28,1733,940,793,1969-11-28,147
1969,11,29,951,189,762,1969-11-29,-573
1969,11,30,950,226,724,1969-11-30,-498
1969,12,1,783,173,610,1969-12-1,-437
1969,12,2,1149,340,809,1969-12-2,-469
1969,12,3,1107,401,706,1969-12-3,-305
1969,12,4,1181,518,663,1969-12-4,-145
1969,12,5,1419,759,660,1969-12-5,99
1969,12,6,1210,694,516,1969-12-6,178
1969,12,7,365,156,209,1969-12-7,-53
1969,12,8,330,210,120,1969-12-8,90
1969,12,9,392,137,255,1969-12-9,-118
1969,12,10,463,144,319,1969-12-10,-175
1969,12,11,224,128,96,1969-12-11,32
1969,12,12,986,274,712,1969-12-12,-438
1969,12,13,1431,770,661,1969-12-13,109
1969,12,14,1126,625,501,1969-12-14,124
1969,12,15,1128,672,456,1969-12-15,216
1969,12,16,1133,673,460,1969-12-16,213
1969,12,17,1230,765,465,1969-12-17,300
1969,12,18,1241,874,367,1969-12-18,507
1969,12,19,1086,774,312,1969-12-19,462
1969,12,20,1147,722,425,1969-12-20,297
1969,12,21,1404,619,785,1969-12-21,-166
1969,12,22,1980,845,1135,1969-12-22,-290
1969,12,23,1978,775,1203,1969-12-23,-428
1969,12,24,1912,753,1159,1969-12-24,-406
1969,12,25,1999,584,1415,1969-12-25,-831
1969,12,26,1566,369,1197,1969-12-26,-828
1969,12,27,1497,340,1157,1969-12-27,-817
1969,12,28,1374,339,1035,1969-12-28,-696
1969,12,29,1640,555,1085,1969-12-29,-530
1969,12,30,2310,693,1617,1969-12-30,-924
1969,12,31,1851,934,917,1969-12-31,17
1970,1,1,1740,857,883,1970-1-1,-26
1970,1,2,1391,722,669,1970-1-2,53
1970,1,3,1116,658,458,1970-1-3,200
1970,1,4,1015,629,386,1970-1-4,243
1970,1,5,1047,712,335,1970-1-5,377
1970,1,6,528,528,0,1970-1-6,528
1970,1,7,358,358,0,1970-1-7,358
1970,1,8,249,215,34,1970-1-8,181
1970,1,9,433,24,409,1970-1-9,-385
1970,1,10,727,0,727,1970-1-10,-727
1970,1,11,2027,62,1965,1970-1-11,-1903
1970,1,12,3099,137,2962,1970-1-12,-2825
1970,1,13,2424,75,2349,1970-1-13,-2274
1970,1,14,2147,67,2080,1970-1-14,-2013
1970,1,15,1836,184,1652,1970-1-15,-1468
1970,1,16,1659,156,1503,1970-1-16,-1347
1970,1,17,1970,216,1754,1970-1-17,-1538
1970,1,18,1715,331,1384,1970-1-18,-1053
1970,1,19,1586,506,1080,1970-1-19,-574
1970,1,20,1661,456,1205,1970-1-20,-749
1970,1,21,1752,359,1393,1970-1-21,-1034
1970,1,22,1922,327,1595,1970-1-22,-1268
1970,1,23,1865,269,1596,1970-1-23,-1327
1970,1,24,1067,233,834,1970-1-24,-601
1970,1,25,1199,199,1000,1970-1-25,-801
1970,1,26,1673,49,1624,1970-1-26,-1575
1970,1,27,2018,78,1940,1970-1-27,-1862
1970,1,28,2036,81,1955,1970-1-28,-1874
1970,1,29,2487,126,2361,1970-1-29,-2235
1970,1,30,2299,118,2181,1970-1-30,-2063
1970,1,31,2348,125,2223,1970-1-31,-2098
1970,2,1,2586,96,2490,1970-2-1,-2394
1970,2,2,688,237,451,1970-2-2,-214
1970,2,3,730,250,480,1970-2-3,-230
1970,2,4,342,127,215,1970-2-4,-88
1970,2,5,285,120,165,1970-2-5,-45
1970,2,6,689,62,627,1970-2-6,-565
1970,2,7,906,43,863,1970-2-7,-820
1970,2,8,1144,282,862,1970-2-8,-580
1970,2,9,1722,634,1088,1970-2-9,-454
1970,2,10,1673,988,685,1970-2-10,303
1970,2,11,2492,1344,1148,1970-2-11,196
1970,2,12,3255,1423,1832,1970-2-12,-409
1970,2,13,3256,1193,2063,1970-2-13,-870
1970,2,14,3208,1113,2095,1970-2-14,-982
1970,2,15,3129,964,2165,1970-2-15,-1201
1970,2,16,3550,952,2598,1970-2-16,-1646
1970,2,17,3256,316,2940,1970-2-17,-2624
1970,2,18,3005,220,2785,1970-2-18,-2565
1970,2,19,2889,242,2647,1970-2-19,-2405
1970,2,20,2422,291,2131,1970-2-20,-1840
1970,2,21,2542,744,1798,1970-2-21,-1054
1970,2,22,2716,1072,1644,1970-2-22,-572
1970,2,23,3149,1608,1541,1970-2-23,67
1970,2,24,2777,1513,1264,1970-2-24,249
1970,2,25,3018,1484,1534,1970-2-25,-50
1970,2,26,2662,1417,1245,1970-2-26,172
1970,2,27,2310,1126,1184,1970-2-27,-58
1970,2,28,2765,1558,1207,1970-2-28,351
1970,3,1,2521,1631,890,1970-3-1,741
1970,3,2,2343,1540,803,1970-3-2,737
1970,3,3,2081,1408,673,1970-3-3,735
1970,3,4,2140,1165,975,1970-3-4,190
1970,3,5,1898,770,1128,1970-3-5,-358
1970,3,6,1888,780,1108,1970-3-6,-328
1970,3,7,1837,793,1044,1970-3-7,-251
1970,3,8,1653,673,980,1970-3-8,-307
1970,3,9,1742,667,1075,1970-3-9,-408
1970,3,10,1590,592,998,1970-3-10,-406
1970,3,11,1255,213,1042,1970-3-11,-829
1970,3,12,1319,211,1108,1970-3-12,-897
1970,3,13,1324,290,1034,1970-3-13,-744
1970,3,14,1071,248,823,1970-3-14,-575
1970,3,15,997,267,730,1970-3-15,-463
1970,3,16,692,20,672,1970-3-16,-652
1970,3,17,303,10,293,1970-3-17,-283
1970,3,18,518,229,289,1970-3-18,-60
1970,3,19,594,97,497,1970-3-19,-400
1970,3,20,1090,644,446,1970-3-20,198
1970,3,21,1245,758,487,1970-3-21,271
1970,3,22,1210,959,251,1970-3-22,708
1970,3,23,1329,1020,309,1970-3-23,711
1970,3,24,1654,1297,357,1970-3-24,940
1970,3,25,1639,1197,442,1970-3-25,755
1970,3,26,1530,1223,307,1970-3-26,916
1970,3,27,1404,1202,202,1970-3-27,1000
1970,3,28,981,809,172,1970-3-28,637
1970,3,29,1086,722,364,1970-3-29,358
1970,3,30,943,536,407,1970-3-30,129
1970,3,31,991,387,604,1970-3-31,-217
1970,4,1,1292,512,780,1970-4-1,-268
1970,4,2,1553,516,1037,1970-4-2,-521
1970,4,3,2208,461,1747,1970-4-3,-1286
1970,4,4,2262,446,1816,1970-4-4,-1370
1970,4,5,2712,542,2170,1970-4-5,-1628
1970,4,6,2611,632,1979,1970-4-6,-1347
1970,4,7,2437,601,1836,1970-4-7,-1235
1970,4,8,2663,867,1796,1970-4-8,-929
1970,4,9,2961,1422,1539,1970-4-9,-117
1970,4,10,3396,1657,1739,1970-4-10,-82
1970,4,11,3938,1766,2172,1970-4-11,-406
1970,4,12,3484,1472,2012,1970-4-12,-540
1970,4,13,3831,1416,2415,1970-4-13,-999
1970,4,14,3459,1203,2256,1970-4-14,-1053
1970,4,15,2043,907,1136,1970-4-15,-229
1970,4,16,1772,942,830,1970-4-16,112
1970,4,17,1608,1103,505,1970-4-17,598
1970,4,18,1995,1536,459,1970-4-18,1077
1970,4,19,703,314,389,1970-4-19,-75
1970,4,20,554,165,389,1970-4-20,-224
1970,4,21,526,177,349,1970-4-21,-172
1970,4,22,809,361,448,1970-4-22,-87
1970,4,23,724,324,400,1970-4-23,-76
1970,4,24,1171,723,448,1970-4-24,275
1970,4,25,1080,353,727,1970-4-25,-374
1970,4,26,843,225,618,1970-4-26,-393
1970,4,27,818,172,646,1970-4-27,-474
1970,4,28,1037,197,840,1970-4-28,-643
1970,4,29,1224,199,1025,1970-4-29,-826
1970,4,30,1889,615,1274,1970-4-30,-659
1970,5,1,1992,718,1274,1970-5-1,-556
1970,5,2,1781,638,1143,1970-5-2,-505
1970,5,3,2021,1019,1002,1970-5-3,17
1970,5,4,2345,1414,931,1970-5-4,483
1970,5,5,2369,1443,926,1970-5-5,517
1970,5,6,2064,1078,986,1970-5-6,92
1970,5,7,2130,1035,1095,1970-5-7,-60
1970,5,8,1652,1036,616,1970-5-8,420
1970,5,9,1804,1253,551,1970-5-9,702
1970,5,10,1829,1166,663,1970-5-10,503
1970,5,11,1674,1035,639,1970-5-11,396
1970,5,12,2526,1814,712,1970-5-12,1102
1970,5,13,2863,2018,845,1970-5-13,1173
1970,5,14,3588,2300,1288,1970-5-14,1012
1970,5,15,3479,2140,1339,1970-5-15,801
1970,5,16,3671,2162,1509,1970-5-16,653
1970,5,17,3684,2236,1448,1970-5-17,788
1970,5,18,2849,1770,1079,1970-5-18,691
1970,5,19,2890,1824,1066,1970-5-19,758
1970,5,20,2502,1624,878,1970-5-20,746
1970,5,21,1799,1388,411,1970-5-21,977
1970,5,22,1585,1223,362,1970-5-22,861
1970,5,23,1227,997,230,1970-5-23,767
1970,5,24,1059,619,440,1970-5-24,179
1970,5,25,1107,274,833,1970-5-25,-559
1970,5,26,1385,166,1219,1970-5-26,-1053
1970,5,27,1569,173,1396,1970-5-27,-1223
1970,5,28,1506,199,1307,1970-5-28,-1108
1970,5,29,1492,245,1247,1970-5-29,-1002
1970,5,30,1717,299,1418,1970-5-30,-1119
1970,5,31,1776,502,1274,1970-5-31,-772
1970,6,1,1342,415,927,1970-6-1,-512
1970,6,2,1376,454,922,1970-6-2,-468
1970,6,3,780,453,327,1970-6-3,126
1970,6,4,644,138,506,1970-6-4,-368
1970,6,5,615,115,500,1970-6-5,-385
1970,6,6,492,108,384,1970-6-6,-276
1970,6,7,837,432,405,1970-6-7,27
1970,6,8,1416,958,458,1970-6-8,500
1970,6,9,1032,866,166,1970-6-9,700
1970,6,10,1130,874,256,1970-6-10,618
1970,6,11,1658,1479,179,1970-6-11,1300
1970,6,12,2167,1982,185,1970-6-12,1797
1970,6,13,2323,2123,200,1970-6-13,1923
1970,6,14,2977,2640,337,1970-6-14,2303
1970,6,15,3065,2748,317,1970-6-15,2431
1970,6,16,2752,2458,294,1970-6-16,2164
1970,6,17,2786,2472,314,1970-6-17,2158
1970,6,18,2437,2081,356,1970-6-18,1725
1970,6,19,1963,1660,303,1970-6-19,1357
1970,6,20,1601,1301,300,1970-6-20,1001
1970,6,21,1575,1270,305,1970-6-21,965
1970,6,22,1557,1220,337,1970-6-22,883
1970,6,23,751,475,276,1970-6-23,199
1970,6,24,675,412,263,1970-6-24,149
1970,6,25,812,457,355,1970-6-25,102
1970,6,26,802,646,156,1970-6-26,490
1970,6,27,1519,918,601,1970-6-27,317
1970,6,28,1564,926,638,1970-6-28,288
1970,6,29,1513,792,721,1970-6-29,71
1970,6,30,1726,760,966,1970-6-30,-206
1970,7,1,2215,865,1350,1970-7-1,-485
1970,7,2,2476,973,1503,1970-7-2,-530
1970,7,3,2454,881,1573,1970-7-3,-692
1970,7,4,2638,778,1860,1970-7-4,-1082
1970,7,5,2765,1010,1755,1970-7-5,-745
1970,7,6,2615,909,1706,1970-7-6,-797
1970,7,7,2254,650,1604,1970-7-7,-954
1970,7,8,2146,548,1598,1970-7-8,-1050
1970,7,9,1524,621,903,1970-7-9,-282
1970,7,10,1415,547,868,1970-7-10,-321
1970,7,11,1133,576,557,1970-7-11,19
1970,7,12,1123,538,585,1970-7-12,-47
1970,7,13,820,561,259,1970-7-13,302
1970,7,14,538,365,173,1970-7-14,192
1970,7,15,547,347,200,1970-7-15,147
1970,7,16,388,273,115,1970-7-16,158
1970,7,17,695,570,125,1970-7-17,445
1970,7,18,980,849,131,1970-7-18,718
1970,7,19,1214,1042,172,1970-7-19,870
1970,7,20,1340,1183,157,1970-7-20,1026
1970,7,21,1826,1653,173,1970-7-21,1480
1970,7,22,1949,1711,238,1970-7-22,1473
1970,7,23,1665,1410,255,1970-7-23,1155
1970,7,24,1529,1257,272,1970-7-24,985
1970,7,25,1888,1304,584,1970-7-25,720
1970,7,26,1539,1090,449,1970-7-26,641
1970,7,27,2274,1708,566,1970-7-27,1142
1970,7,28,2140,1594,546,1970-7-28,1048
1970,7,29,1885,1393,492,1970-7-29,901
1970,7,30,1891,1394,497,1970-7-30,897
1970,7,31,1165,809,356,1970-7-31,453
1970,8,1,966,701,265,1970-8-1,436
1970,8,2,871,683,188,1970-8-2,495
1970,8,3,666,509,157,1970-8-3,352
1970,8,4,822,725,97,1970-8-4,628
1970,8,5,918,846,72,1970-8-5,774
1970,8,6,723,642,81,1970-8-6,561
1970,8,7,891,679,212,1970-8-7,467
1970,8,8,871,691,180,1970-8-8,511
1970,8,9,1233,991,242,1970-8-9,749
1970,8,10,1183,1022,161,1970-8-10,861
1970,8,11,1004,894,110,1970-8-11,784
1970,8,12,970,922,48,1970-8-12,874
1970,8,13,1315,1254,61,1970-8-13,1193
1970,8,14,2830,2798,32,1970-8-14,2766
1970,8,15,2701,2371,330,1970-8-15,2041
1970,8,16,1610,795,815,1970-8-16,-20
1970,8,17,1534,670,864,1970-8-17,-194
1970,8,18,1817,880,937,1970-8-18,-57
1970,8,19,1737,598,1139,1970-8-19,-541
1970,8,20,1292,716,576,1970-8-20,140
1970,8,21,1371,1099,272,1970-8-21,827
1970,8,22,1106,1043,63,1970-8-22,980
1970,8,23,1250,1024,226,1970-8-23,798
1970,8,24,1425,1075,350,1970-8-24,725
1970,8,25,1189,818,371,1970-8-25,447
1970,8,26,1012,717,295,1970-8-26,422
1970,8,27,873,715,158,1970-8-27,557
1970,8,28,895,746,149,1970-8-28,597
1970,8,29,1602,1334,268,1970-8-29,1066
1970,8,30,1902,1656,246,1970-8-30,1410
1970,8,31,2058,1869,189,1970-8-31,1680
1970,9,1,1685,1545,140,1970-9-1,1405
1970,9,2,1695,1581,114,1970-9-2,1467
1970,9,3,1911,1859,52,1970-9-3,1807
1970,9,4,1919,1870,49,1970-9-4,1821
1970,9,5,2047,1999,48,1970-9-5,1951
1970,9,6,2155,1935,220,1970-9-6,1715
1970,9,7,2168,1777,391,1970-9-7,1386
1970,9,8,1916,1594,322,1970-9-8,1272
1970,9,9,1736,1510,226,1970-9-9,1284
1970,9,10,1144,843,301,1970-9-10,542
1970,9,11,1084,851,233,1970-9-11,618
1970,9,12,494,245,249,1970-9-12,-4
1970,9,13,421,141,280,1970-9-13,-139
1970,9,14,343,155,188,1970-9-14,-33
1970,9,15,418,101,317,1970-9-15,-216
1970,9,16,378,132,246,1970-9-16,-114
1970,9,17,364,219,145,1970-9-17,74
1970,9,18,503,397,106,1970-9-18,291
1970,9,19,755,613,142,1970-9-19,471
1970,9,20,1094,957,137,1970-9-20,820
1970,9,21,1255,1103,152,1970-9-21,951
1970,9,22,1186,1177,9,1970-9-22,1168
1970,9,23,1699,1298,401,1970-9-23,897
1970,9,24,1860,1414,446,1970-9-24,968
1970,9,25,1600,1145,455,1970-9-25,690
1970,9,26,1459,996,463,1970-9-26,533
1970,9,27,1492,1060,432,1970-9-27,628
1970,9,28,1100,663,437,1970-9-28,226
1970,9,29,930,508,422,1970-9-29,86
1970,9,30,881,427,454,1970-9-30,-27
1970,10,1,896,435,461,1970-10-1,-26
1970,10,2,763,307,456,1970-10-2,-149
1970,10,3,579,78,501,1970-10-3,-423
1970,10,4,867,153,714,1970-10-4,-561
1970,10,5,997,181,816,1970-10-5,-635
1970,10,6,858,368,490,1970-10-6,-122
1970,10,7,699,254,445,1970-10-7,-191
1970,10,8,1311,664,647,1970-10-8,17
1970,10,9,1362,230,1132,1970-10-9,-902
1970,10,10,1317,449,868,1970-10-10,-419
1970,10,11,1067,360,707,1970-10-11,-347
1970,10,12,1737,695,1042,1970-10-12,-347
1970,10,13,829,653,176,1970-10-13,477
1970,10,14,848,777,71,1970-10-14,706
1970,10,15,770,729,41,1970-10-15,688
1970,10,16,903,819,84,1970-10-16,735
1970,10,17,910,754,156,1970-10-17,598
1970,10,18,814,810,4,1970-10-18,806
1970,10,19,993,933,60,1970-10-19,873
1970,10,20,990,962,28,1970-10-20,934
1970,10,21,887,846,41,1970-10-21,805
1970,10,22,1098,1049,49,1970-10-22,1000
1970,10,23,1882,1865,17,1970-10-23,1848
1970,10,24,2149,2131,18,1970-10-24,2113
1970,10,25,2255,2238,17,1970-10-25,2221
1970,10,26,2515,2504,11,1970-10-26,2493
1970,10,27,2028,1957,71,1970-10-27,1886
1970,10,28,1834,1683,151,1970-10-28,1532
1970,10,29,2065,1847,218,1970-10-29,1629
1970,10,30,1708,1539,169,1970-10-30,1370
1970,10,31,1476,1285,191,1970-10-31,1094
1970,11,1,1277,1048,229,1970-11-1,819
1970,11,2,910,733,177,1970-11-2,556
1970,11,3,891,481,410,1970-11-3,71
1970,11,4,888,489,399,1970-11-4,90
1970,11,5,565,88,477,1970-11-5,-389
1970,11,6,623,108,515,1970-11-6,-407
1970,11,7,673,100,573,1970-11-7,-473
1970,11,8,332,43,289,1970-11-8,-246
1970,11,9,346,126,220,1970-11-9,-94
1970,11,10,709,442,267,1970-11-10,175
1970,11,11,920,650,270,1970-11-11,380
1970,11,12,1368,1061,307,1970-11-12,754
1970,11,13,1800,1547,253,1970-11-13,1294
1970,11,14,2375,2176,199,1970-11-14,1977
1970,11,15,3035,2663,372,1970-11-15,2291
1970,11,16,3471,3102,369,1970-11-16,2733
1970,11,17,3623,3206,417,1970-11-17,2789
1970,11,18,3328,2975,353,1970-11-18,2622
1970,11,19,3419,3269,150,1970-11-19,3119
1970,11,20,3259,3084,175,1970-11-20,2909
1970,11,21,2227,2141,86,1970-11-21,2055
1970,11,22,1666,1608,58,1970-11-22,1550
1970,11,23,1251,1020,231,1970-11-23,789
1970,11,24,1035,766,269,1970-11-24,497
1970,11,25,578,382,196,1970-11-25,186
1970,11,26,931,810,121,1970-11-26,689
1970,11,27,1247,1169,78,1970-11-27,1091
1970,11,28,1252,1052,200,1970-11-28,852
1970,11,29,1379,1031,348,1970-11-29,683
1970,11,30,1611,1021,590,1970-11-30,431
1970,12,1,1597,992,605,1970-12-1,387
1970,12,2,1304,791,513,1970-12-2,278
1970,12,3,1052,551,501,1970-12-3,50
1970,12,4,1272,596,676,1970-12-4,-80
1970,12,5,1458,890,568,1970-12-5,322
1970,12,6,1800,1183,617,1970-12-6,566
1970,12,7,2270,1572,698,1970-12-7,874
1970,12,8,1873,1425,448,1970-12-8,977
1970,12,9,2025,1534,491,1970-12-9,1043
1970,12,10,1727,1409,318,1970-12-10,1091
1970,12,11,1765,1350,415,1970-12-11,935
1970,12,12,1177,962,215,1970-12-12,747
1970,12,13,1412,1039,373,1970-12-13,666
1970,12,14,1978,1523,455,1970-12-14,1068
1970,12,15,1770,1334,436,1970-12-15,898
1970,12,16,1344,1171,173,1970-12-16,998
1970,12,17,1211,1182,29,1970-12-17,1153
1970,12,18,1206,936,270,1970-12-18,666
1970,12,19,1296,1054,242,1970-12-19,812
1970,12,20,1339,1107,232,1970-12-20,875
1970,12,21,1881,1622,259,1970-12-21,1363
1970,12,22,1486,1312,174,1970-12-22,1138
1970,12,23,1151,1056,95,1970-12-23,961
1970,12,24,1405,1309,96,1970-12-24,1213
1970,12,25,1250,1177,73,1970-12-25,1104
1970,12,26,614,568,46,1970-12-26,522
1970,12,27,259,238,21,1970-12-27,217
1970,12,28,520,509,11,1970-12-28,498
1970,12,29,503,390,113,1970-12-29,277
1970,12,30,794,565,229,1970-12-30,336
1970,12,31,1277,860,417,1970-12-31,443
1971,1,1,1215,849,366,1971-1-1,483
1971,1,2,1263,837,426,1971-1-2,411
1971,1,3,783,674,109,1971-1-3,565
1971,1,4,2000,608,1392,1971-1-4,-784
1971,1,5,1987,323,1664,1971-1-5,-1341
1971,1,6,1777,300,1477,1971-1-6,-1177
1971,1,7,1610,263,1347,1971-1-7,-1084
1971,1,8,1610,283,1327,1971-1-8,-1044
1971,1,9,1510,441,1069,1971-1-9,-628
1971,1,10,1101,200,901,1971-1-10,-701
1971,1,11,1094,184,910,1971-1-11,-726
1971,1,12,1127,177,950,1971-1-12,-773
1971,1,13,1059,184,875,1971-1-13,-691
1971,1,14,1589,665,924,1971-1-14,-259
1971,1,15,1441,769,672,1971-1-15,97
1971,1,16,2361,1680,681,1971-1-16,999
1971,1,17,1663,1631,32,1971-1-17,1599
1971,1,18,2407,2229,178,1971-1-18,2051
1971,1,19,2708,2094,614,1971-1-19,1480
1971,1,20,2641,1836,805,1971-1-20,1031
1971,1,21,2581,1830,751,1971-1-21,1079
1971,1,22,2532,1837,695,1971-1-22,1142
1971,1,23,2518,1744,774,1971-1-23,970
1971,1,24,3116,1418,1698,1971-1-24,-280
1971,1,25,2726,1259,1467,1971-1-25,-208
1971,1,26,2889,1199,1690,1971-1-26,-491
1971,1,27,2406,1254,1152,1971-1-27,102
1971,1,28,2297,1143,1154,1971-1-28,-11
1971,1,29,2210,1290,920,1971-1-29,370
1971,1,30,1899,1321,578,1971-1-30,743
1971,1,31,2096,1290,806,1971-1-31,484
1971,2,1,2153,1354,799,1971-2-1,555
1971,2,2,2043,1347,696,1971-2-2,651
1971,2,3,2005,1365,640,1971-2-3,725
1971,2,4,2027,1431,596,1971-2-4,835
1971,2,5,2131,1428,703,1971-2-5,725
1971,2,6,1898,1582,316,1971-2-6,1266
1971,2,7,2045,1741,304,1971-2-7,1437
1971,2,8,1036,738,298,1971-2-8,440
1971,2,9,522,249,273,1971-2-9,-24
1971,2,10,408,95,313,1971-2-10,-218
1971,2,11,520,221,299,1971-2-11,-78
1971,2,12,685,344,341,1971-2-12,3
1971,2,13,714,535,179,1971-2-13,356
1971,2,14,792,656,136,1971-2-14,520
1971,2,15,690,506,184,1971-2-15,322
1971,2,16,786,598,188,1971-2-16,410
1971,2,17,1255,586,669,1971-2-17,-83
1971,2,18,1811,584,1227,1971-2-18,-643
1971,2,19,1902,540,1362,1971-2-19,-822
1971,2,20,1724,281,1443,1971-2-20,-1162
1971,2,21,1580,314,1266,1971-2-21,-952
1971,2,22,1631,413,1218,1971-2-22,-805
1971,2,23,2038,645,1393,1971-2-23,-748
1971,2,24,1752,637,1115,1971-2-24,-478
1971,2,25,1631,636,995,1971-2-25,-359
1971,2,26,1546,802,744,1971-2-26,58
1971,2,27,1430,713,717,1971-2-27,-4
1971,2,28,1392,752,640,1971-2-28,112
1971,3,1,1342,547,795,1971-3-1,-248
1971,3,2,1141,582,559,1971-3-2,23
1971,3,3,993,580,413,1971-3-3,167
1971,3,4,544,432,112,1971-3-4,320
1971,3,5,603,479,124,1971-3-5,355
1971,3,6,495,427,68,1971-3-6,359
1971,3,7,732,280,452,1971-3-7,-172
1971,3,8,801,258,543,1971-3-8,-285
1971,3,9,562,72,490,1971-3-9,-418
1971,3,10,536,50,486,1971-3-10,-436
1971,3,11,736,62,674,1971-3-11,-612
1971,3,12,904,365,539,1971-3-12,-174
1971,3,13,852,293,559,1971-3-13,-266
1971,3,14,738,233,505,1971-3-14,-272
1971,3,15,613,184,429,1971-3-15,-245
1971,3,16,602,169,433,1971-3-16,-264
1971,3,17,626,126,500,1971-3-17,-374
1971,3,18,913,140,773,1971-3-18,-633
1971,3,19,955,162,793,1971-3-19,-631
1971,3,20,857,133,724,1971-3-20,-591
1971,3,21,652,65,587,1971-3-21,-522
1971,3,22,318,26,292,1971-3-22,-266
1971,3,23,355,25,330,1971-3-23,-305
1971,3,24,353,0,353,1971-3-24,-353
1971,3,25,669,75,594,1971-3-25,-519
1971,3,26,617,84,533,1971-3-26,-449
1971,3,27,604,81,523,1971-3-27,-442
1971,3,28,548,65,483,1971-3-28,-418
1971,3,29,550,49,501,1971-3-29,-452
1971,3,30,517,88,429,1971-3-30,-341
1971,3,31,602,56,546,1971-3-31,-490
1971,4,1,680,137,543,1971-4-1,-406
1971,4,2,717,99,618,1971-4-2,-519
1971,4,3,752,289,463,1971-4-3,-174
1971,4,4,874,299,575,1971-4-4,-276
1971,4,5,647,252,395,1971-4-5,-143
1971,4,6,529,235,294,1971-4-6,-59
1971,4,7,432,320,112,1971-4-7,208
1971,4,8,714,599,115,1971-4-8,484
1971,4,9,568,505,63,1971-4-9,442
1971,4,10,959,717,242,1971-4-10,475
1971,4,11,706,450,256,1971-4-11,194
1971,4,12,1380,877,503,1971-4-12,374
1971,4,13,1541,926,615,1971-4-13,311
1971,4,14,1603,840,763,1971-4-14,77
1971,4,15,1586,782,804,1971-4-15,-22
1971,4,16,1348,759,589,1971-4-16,170
1971,4,17,1487,826,661,1971-4-17,165
1971,4,18,1456,811,645,1971-4-18,166
1971,4,19,1421,846,575,1971-4-19,271
1971,4,20,1462,854,608,1971-4-20,246
1971,4,21,1075,764,311,1971-4-21,453
1971,4,22,1050,763,287,1971-4-22,476
1971,4,23,780,725,55,1971-4-23,670
1971,4,24,239,129,110,1971-4-24,19
1971,4,25,387,58,329,1971-4-25,-271
1971,4,26,343,91,252,1971-4-26,-161
1971,4,27,543,266,277,1971-4-27,-11
1971,4,28,488,247,241,1971-4-28,6
1971,4,29,418,222,196,1971-4-29,26
1971,4,30,334,162,172,1971-4-30,-10
1971,5,1,292,136,156,1971-5-1,-20
1971,5,2,350,220,130,1971-5-2,90
1971,5,3,442,287,155,1971-5-3,132
1971,5,4,648,501,147,1971-5-4,354
1971,5,5,910,756,154,1971-5-5,602
1971,5,6,1291,1175,116,1971-5-6,1059
1971,5,7,1521,1408,113,1971-5-7,1295
1971,5,8,1557,1557,0,1971-5-8,1557
1971,5,9,1596,1596,0,1971-5-9,1596
1971,5,10,1493,1493,0,1971-5-10,1493
1971,5,11,1618,1618,0,1971-5-11,1618
1971,5,12,1585,1585,0,1971-5-12,1585
1971,5,13,816,812,4,1971-5-13,808
1971,5,14,862,862,0,1971-5-14,862
1971,5,15,408,395,13,1971-5-15,382
1971,5,16,435,418,17,1971-5-16,401
1971,5,17,333,280,53,1971-5-17,227
1971,5,18,315,295,20,1971-5-18,275
1971,5,19,275,275,0,1971-5-19,275
1971,5,20,196,196,0,1971-5-20,196
1971,5,21,161,161,0,1971-5-21,161
1971,5,22,103,103,0,1971-5-22,103
1971,5,23,11,11,0,1971-5-23,11
1971,5,24,59,59,0,1971-5-24,59
1971,5,25,328,328,0,1971-5-25,328
1971,5,26,437,434,3,1971-5-26,431
1971,5,27,484,330,154,1971-5-27,176
1971,5,28,960,446,514,1971-5-28,-68
1971,5,29,856,480,376,1971-5-29,104
1971,5,30,819,489,330,1971-5-30,159
1971,5,31,594,433,161,1971-5-31,272
1971,6,1,703,445,258,1971-6-1,187
1971,6,2,740,371,369,1971-6-2,2
1971,6,3,706,364,342,1971-6-3,22
1971,6,4,370,24,346,1971-6-4,-322
1971,6,5,338,13,325,1971-6-5,-312
1971,6,6,324,0,324,1971-6-6,-324
1971,6,7,322,140,182,1971-6-7,-42
1971,6,8,339,170,169,1971-6-8,1
1971,6,9,290,136,154,1971-6-9,-18
1971,6,10,295,140,155,1971-6-10,-15
1971,6,11,296,169,127,1971-6-11,42
1971,6,12,259,137,122,1971-6-12,15
1971,6,13,181,58,123,1971-6-13,-65
1971,6,14,131,40,91,1971-6-14,-51
1971,6,15,59,0,59,1971-6-15,-59
1971,6,16,94,0,94,1971-6-16,-94
1971,6,17,137,61,76,1971-6-17,-15
1971,6,18,115,51,64,1971-6-18,-13
1971,6,19,127,73,54,1971-6-19,19
1971,6,20,229,172,57,1971-6-20,115
1971,6,21,206,116,90,1971-6-21,26
1971,6,22,325,103,222,1971-6-22,-119
1971,6,23,175,74,101,1971-6-23,-27
1971,6,24,356,149,207,1971-6-24,-58
1971,6,25,518,216,302,1971-6-25,-86
1971,6,26,694,286,408,1971-6-26,-122
1971,6,27,1219,448,771,1971-6-27,-323
1971,6,28,1514,444,1070,1971-6-28,-626
1971,6,29,1694,491,1203,1971-6-29,-712
1971,6,30,1864,691,1173,1971-6-30,-482
1971,7,1,1937,642,1295,1971-7-1,-653
1971,7,2,1704,476,1228,1971-7-2,-752
1971,7,3,1498,349,1149,1971-7-3,-800
1971,7,4,1542,269,1273,1971-7-4,-1004
1971,7,5,1749,129,1620,1971-7-5,-1491
1971,7,6,1429,112,1317,1971-7-6,-1205
1971,7,7,1584,100,1484,1971-7-7,-1384
1971,7,8,1277,84,1193,1971-7-8,-1109
1971,7,9,872,113,759,1971-7-9,-646
1971,7,10,512,259,253,1971-7-10,6
1971,7,11,503,247,256,1971-7-11,-9
1971,7,12,907,593,314,1971-7-12,279
1971,7,13,1219,974,245,1971-7-13,729
1971,7,14,1139,943,196,1971-7-14,747
1971,7,15,1150,975,175,1971-7-15,800
1971,7,16,1133,910,223,1971-7-16,687
1971,7,17,1026,901,125,1971-7-17,776
1971,7,18,880,840,40,1971-7-18,800
1971,7,19,994,977,17,1971-7-19,960
1971,7,20,906,906,0,1971-7-20,906
1971,7,21,782,782,0,1971-7-21,782
1971,7,22,915,856,59,1971-7-22,797
1971,7,23,951,756,195,1971-7-23,561
1971,7,24,1744,1220,524,1971-7-24,696
1971,7,25,1337,937,400,1971-7-25,537
1971,7,26,1229,795,434,1971-7-26,361
1971,7,27,1175,793,382,1971-7-27,411
1971,7,28,786,317,469,1971-7-28,-152
1971,7,29,666,289,377,1971-7-29,-88
1971,7,30,743,328,415,1971-7-30,-87
1971,7,31,494,85,409,1971-7-31,-324
1971,8,1,486,74,412,1971-8-1,-338
1971,8,2,392,47,345,1971-8-2,-298
1971,8,3,521,39,482,1971-8-3,-443
1971,8,4,520,24,496,1971-8-4,-472
1971,8,5,536,25,511,1971-8-5,-486
1971,8,6,411,10,401,1971-8-6,-391
1971,8,7,459,23,436,1971-8-7,-413
1971,8,8,737,156,581,1971-8-8,-425
1971,8,9,811,248,563,1971-8-9,-315
1971,8,10,787,263,524,1971-8-10,-261
1971,8,11,774,327,447,1971-8-11,-120
1971,8,12,680,347,333,1971-8-12,14
1971,8,13,504,226,278,1971-8-13,-52
1971,8,14,549,276,273,1971-8-14,3
1971,8,15,459,235,224,1971-8-15,11
1971,8,16,342,307,35,1971-8-16,272
1971,8,17,638,296,342,1971-8-17,-46
1971,8,18,1685,222,1463,1971-8-18,-1241
1971,8,19,2108,184,1924,1971-8-19,-1740
1971,8,20,2493,194,2299,1971-8-20,-2105
1971,8,21,2666,207,2459,1971-8-21,-2252
1971,8,22,2592,161,2431,1971-8-22,-2270
1971,8,23,2561,182,2379,1971-8-23,-2197
1971,8,24,2517,179,2338,1971-8-24,-2159
1971,8,25,2382,227,2155,1971-8-25,-1928
1971,8,26,2214,209,2005,1971-8-26,-1796
1971,8,27,1802,0,1802,1971-8-27,-1802
1971,8,28,1597,0,1597,1971-8-28,-1597
1971,8,29,1186,0,1186,1971-8-29,-1186
1971,8,30,262,0,262,1971-8-30,-262
1971,8,31,170,0,170,1971-8-31,-170
1971,9,1,196,0,196,1971-9-1,-196
1971,9,2,61,0,61,1971-9-2,-61
1971,9,3,220,26,194,1971-9-3,-168
1971,9,4,207,13,194,1971-9-4,-181
1971,9,5,271,20,251,1971-9-5,-231
1971,9,6,630,215,415,1971-9-6,-200
1971,9,7,988,457,531,1971-9-7,-74
1971,9,8,1203,585,618,1971-9-8,-33
1971,9,9,1022,435,587,1971-9-9,-152
1971,9,10,290,144,146,1971-9-10,-2
1971,9,11,98,98,0,1971-9-11,98
1971,9,12,175,141,34,1971-9-12,107
1971,9,13,442,289,153,1971-9-13,136
1971,9,14,716,266,450,1971-9-14,-184
1971,9,15,814,242,572,1971-9-15,-330
1971,9,16,701,192,509,1971-9-16,-317
1971,9,17,606,200,406,1971-9-17,-206
1971,9,18,560,197,363,1971-9-18,-166
1971,9,19,408,152,256,1971-9-19,-104
1971,9,20,323,142,181,1971-9-20,-39
1971,9,21,430,309,121,1971-9-21,188
1971,9,22,512,387,125,1971-9-22,262
1971,9,23,264,154,110,1971-9-23,44
1971,9,24,660,45,615,1971-9-24,-570
1971,9,25,637,22,615,1971-9-25,-593
1971,9,26,591,0,591,1971-9-26,-591
1971,9,27,782,0,782,1971-9-27,-782
1971,9,28,1519,640,879,1971-9-28,-239
1971,9,29,1346,642,704,1971-9-29,-62
1971,9,30,1299,641,658,1971-9-30,-17
1971,10,1,1130,549,581,1971-10-1,-32
1971,10,2,924,421,503,1971-10-2,-82
1971,10,3,840,351,489,1971-10-3,-138
1971,10,4,691,269,422,1971-10-4,-153
1971,10,5,769,297,472,1971-10-5,-175
1971,10,6,902,374,528,1971-10-6,-154
1971,10,7,366,328,38,1971-10-7,290
1971,10,8,345,325,20,1971-10-8,305
1971,10,9,297,282,15,1971-10-9,267
1971,10,10,257,257,0,1971-10-10,257
1971,10,11,87,87,0,1971-10-11,87
1971,10,12,85,65,20,1971-10-12,45
1971,10,13,53,15,38,1971-10-13,-23
1971,10,14,40,0,40,1971-10-14,-40
1971,10,15,34,0,34,1971-10-15,-34
1971,10,16,163,146,17,1971-10-16,129
1971,10,17,331,331,0,1971-10-17,331
1971,10,18,791,791,0,1971-10-18,791
1971,10,19,969,969,0,1971-10-19,969
1971,10,20,1420,1389,31,1971-10-20,1358
1971,10,21,1935,1503,432,1971-10-21,1071
1971,10,22,2018,1688,330,1971-10-22,1358
1971,10,23,1980,1712,268,1971-10-23,1444
1971,10,24,2384,2082,302,1971-10-24,1780
1971,10,25,2578,2284,294,1971-10-25,1990
1971,10,26,2207,1925,282,1971-10-26,1643
1971,10,27,2242,1784,458,1971-10-27,1326
1971,10,28,1158,780,378,1971-10-28,402
1971,10,29,834,445,389,1971-10-29,56
1971,10,30,654,286,368,1971-10-30,-82
1971,10,31,1110,273,837,1971-10-31,-564
1971,11,1,1108,282,826,1971-11-1,-544
1971,11,2,1240,286,954,1971-11-2,-668
1971,11,3,1062,340,722,1971-11-3,-382
1971,11,4,1049,389,660,1971-11-4,-271
1971,11,5,1275,426,849,1971-11-5,-423
1971,11,6,846,318,528,1971-11-6,-210
1971,11,7,480,49,431,1971-11-7,-382
1971,11,8,458,60,398,1971-11-8,-338
1971,11,9,419,39,380,1971-11-9,-341
1971,11,10,419,3,416,1971-11-10,-413
1971,11,11,522,145,377,1971-11-11,-232
1971,11,12,509,78,431,1971-11-12,-353
1971,11,13,506,54,452,1971-11-13,-398
1971,11,14,529,13,516,1971-11-14,-503
1971,11,15,554,9,545,1971-11-15,-536
1971,11,16,490,5,485,1971-11-16,-480
1971,11,17,713,11,702,1971-11-17,-691
1971,11,18,696,33,663,1971-11-18,-630
1971,11,19,829,12,817,1971-11-19,-805
1971,11,20,753,14,739,1971-11-20,-725
1971,11,21,657,19,638,1971-11-21,-619
1971,11,22,1537,627,910,1971-11-22,-283
1971,11,23,1593,656,937,1971-11-23,-281
1971,11,24,1604,628,976,1971-11-24,-348
1971,11,25,1401,618,783,1971-11-25,-165
1971,11,26,1289,570,719,1971-11-26,-149
1971,11,27,1234,363,871,1971-11-27,-508
1971,11,28,1361,316,1045,1971-11-28,-729
1971,11,29,1201,187,1014,1971-11-29,-827
1971,11,30,1083,113,970,1971-11-30,-857
1971,12,1,898,81,817,1971-12-1,-736
1971,12,2,1181,132,1049,1971-12-2,-917
1971,12,3,550,223,327,1971-12-3,-104
1971,12,4,427,0,427,1971-12-4,-427
1971,12,5,667,65,602,1971-12-5,-537
1971,12,6,1062,169,893,1971-12-6,-724
1971,12,7,954,123,831,1971-12-7,-708
1971,12,8,902,164,738,1971-12-8,-574
1971,12,9,1090,283,807,1971-12-9,-524
1971,12,10,1142,501,641,1971-12-10,-140
1971,12,11,1477,813,664,1971-12-11,149
1971,12,12,1409,811,598,1971-12-12,213
1971,12,13,976,756,220,1971-12-13,536
1971,12,14,1028,814,214,1971-12-14,600
1971,12,15,854,612,242,1971-12-15,370
1971,12,16,959,530,429,1971-12-16,101
1971,12,17,1382,653,729,1971-12-17,-76
1971,12,18,1726,684,1042,1971-12-18,-358
1971,12,19,1577,608,969,1971-12-19,-361
1971,12,20,1452,353,1099,1971-12-20,-746
1971,12,21,1337,251,1086,1971-12-21,-835
1971,12,22,1310,238,1072,1971-12-22,-834
1971,12,23,1164,148,1016,1971-12-23,-868
1971,12,24,984,0,984,1971-12-24,-984
1971,12,25,813,0,813,1971-12-25,-813
1971,12,26,635,0,635,1971-12-26,-635
1971,12,27,921,94,827,1971-12-27,-733
1971,12,28,633,96,537,1971-12-28,-441
1971,12,29,588,72,516,1971-12-29,-444
1971,12,30,397,67,330,1971-12-30,-263
1971,12,31,481,48,433,1971-12-31,-385
1972,1,1,438,41,397,1972-1-1,-356
1972,1,2,368,29,339,1972-1-2,-310
1972,1,3,413,34,379,1972-1-3,-345
1972,1,4,337,33,304,1972-1-4,-271
1972,1,5,269,35,234,1972-1-5,-199
1972,1,6,355,194,161,1972-1-6,33
1972,1,7,276,90,186,1972-1-7,-96
1972,1,8,229,78,151,1972-1-8,-73
1972,1,9,170,13,157,1972-1-9,-144
1972,1,10,89,0,89,1972-1-10,-89
1972,1,11,58,0,58,1972-1-11,-58
1972,1,12,237,0,237,1972-1-12,-237
1972,1,13,174,0,174,1972-1-13,-174
1972,1,14,456,0,456,1972-1-14,-456
1972,1,15,597,6,591,1972-1-15,-585
1972,1,16,595,71,524,1972-1-16,-453
1972,1,17,465,37,428,1972-1-17,-391
1972,1,18,599,14,585,1972-1-18,-571
1972,1,19,496,15,481,1972-1-19,-466
1972,1,20,893,292,601,1972-1-20,-309
1972,1,21,1018,374,644,1972-1-21,-270
1972,1,22,1125,584,541,1972-1-22,43
1972,1,23,1277,548,729,1972-1-23,-181
1972,1,24,1090,557,533,1972-1-24,24
1972,1,25,1203,406,797,1972-1-25,-391
1972,1,26,565,194,371,1972-1-26,-177
1972,1,27,554,176,378,1972-1-27,-202
1972,1,28,431,140,291,1972-1-28,-151
1972,1,29,499,119,380,1972-1-29,-261
1972,1,30,494,143,351,1972-1-30,-208
1972,1,31,423,160,263,1972-1-31,-103
1972,2,1,324,128,196,1972-2-1,-68
1972,2,2,197,58,139,1972-2-2,-81
1972,2,3,255,143,112,1972-2-3,31
1972,2,4,365,210,155,1972-2-4,55
1972,2,5,334,168,166,1972-2-5,2
1972,2,6,408,176,232,1972-2-6,-56
1972,2,7,211,0,211,1972-2-7,-211
1972,2,8,569,420,149,1972-2-8,271
1972,2,9,414,251,163,1972-2-9,88
1972,2,10,650,230,420,1972-2-10,-190
1972,2,11,793,341,452,1972-2-11,-111
1972,2,12,785,353,432,1972-2-12,-79
1972,2,13,741,319,422,1972-2-13,-103
1972,2,14,787,238,549,1972-2-14,-311
1972,2,15,1060,261,799,1972-2-15,-538
1972,2,16,1865,877,988,1972-2-16,-111
1972,2,17,2446,1367,1079,1972-2-17,288
1972,2,18,2451,1378,1073,1972-2-18,305
1972,2,19,3800,1765,2035,1972-2-19,-270
1972,2,20,3432,1706,1726,1972-2-20,-20
1972,2,21,2891,1301,1590,1972-2-21,-289
1972,2,22,2697,1358,1339,1972-2-22,19
1972,2,23,2574,1368,1206,1972-2-23,162
1972,2,24,2042,1224,818,1972-2-24,406
1972,2,25,2126,1003,1123,1972-2-25,-120
1972,2,26,1539,738,801,1972-2-26,-63
1972,2,27,1124,471,653,1972-2-27,-182
1972,2,28,1290,694,596,1972-2-28,98
1972,2,29,638,77,561,1972-2-29,-484
1972,3,1,1439,205,1234,1972-3-1,-1029
1972,3,2,1828,292,1536,1972-3-2,-1244
1972,3,3,1739,282,1457,1972-3-3,-1175
1972,3,4,1524,267,1257,1972-3-4,-990
1972,3,5,1598,55,1543,1972-3-5,-1488
1972,3,6,1546,12,1534,1972-3-6,-1522
1972,3,7,1680,178,1502,1972-3-7,-1324
1972,3,8,1738,396,1342,1972-3-8,-946
1972,3,9,2132,801,1331,1972-3-9,-530
1972,3,10,2107,907,1200,1972-3-10,-293
1972,3,11,1992,827,1165,1972-3-11,-338
1972,3,12,1803,783,1020,1972-3-12,-237
1972,3,13,1855,833,1022,1972-3-13,-189
1972,3,14,1283,833,450,1972-3-14,383
1972,3,15,1217,1012,205,1972-3-15,807
1972,3,16,1058,837,221,1972-3-16,616
1972,3,17,968,710,258,1972-3-17,452
1972,3,18,912,696,216,1972-3-18,480
1972,3,19,1085,900,185,1972-3-19,715
1972,3,20,1091,841,250,1972-3-20,591
1972,3,21,1125,896,229,1972-3-21,667
1972,3,22,1031,794,237,1972-3-22,557
1972,3,23,1035,835,200,1972-3-23,635
1972,3,24,1089,875,214,1972-3-24,661
1972,3,25,782,588,194,1972-3-25,394
1972,3,26,521,435,86,1972-3-26,349
1972,3,27,202,185,17,1972-3-27,168
1972,3,28,189,116,73,1972-3-28,43
1972,3,29,324,63,261,1972-3-29,-198
1972,3,30,272,0,272,1972-3-30,-272
1972,3,31,270,0,270,1972-3-31,-270
1972,4,1,197,7,190,1972-4-1,-183
1972,4,2,193,37,156,1972-4-2,-119
1972,4,3,149,32,117,1972-4-3,-85
1972,4,4,136,23,113,1972-4-4,-90
1972,4,5,116,10,106,1972-4-5,-96
1972,4,6,493,58,435,1972-4-6,-377
1972,4,7,765,117,648,1972-4-7,-531
1972,4,8,795,41,754,1972-4-8,-713
1972,4,9,721,25,696,1972-4-9,-671
1972,4,10,780,136,644,1972-4-10,-508
1972,4,11,660,88,572,1972-4-11,-484
1972,4,12,752,113,639,1972-4-12,-526
1972,4,13,440,98,342,1972-4-13,-244
1972,4,14,375,72,303,1972-4-14,-231
1972,4,15,910,80,830,1972-4-15,-750
1972,4,16,745,75,670,1972-4-16,-595
1972,4,17,678,60,618,1972-4-17,-558
1972,4,18,791,80,711,1972-4-18,-631
1972,4,19,643,59,584,1972-4-19,-525
1972,4,20,494,63,431,1972-4-20,-368
1972,4,21,657,232,425,1972-4-21,-193
1972,4,22,617,250,367,1972-4-22,-117
1972,4,23,634,213,421,1972-4-23,-208
1972,4,24,551,201,350,1972-4-24,-149
1972,4,25,697,347,350,1972-4-25,-3
1972,4,26,521,317,204,1972-4-26,113
1972,4,27,817,653,164,1972-4-27,489
1972,4,28,1012,861,151,1972-4-28,710
1972,4,29,700,693,7,1972-4-29,686
1972,4,30,133,133,0,1972-4-30,133
1972,5,1,141,113,28,1972-5-1,85
1972,5,2,208,133,75,1972-5-2,58
1972,5,3,205,5,200,1972-5-3,-195
1972,5,4,358,9,349,1972-5-4,-340
1972,5,5,246,4,242,1972-5-5,-238
1972,5,6,682,51,631,1972-5-6,-580
1972,5,7,751,73,678,1972-5-7,-605
1972,5,8,791,73,718,1972-5-8,-645
1972,5,9,831,149,682,1972-5-9,-533
1972,5,10,1049,363,686,1972-5-10,-323
1972,5,11,1286,560,726,1972-5-11,-166
1972,5,12,1544,574,970,1972-5-12,-396
1972,5,13,1755,580,1175,1972-5-13,-595
1972,5,14,2480,752,1728,1972-5-14,-976
1972,5,15,2533,261,2272,1972-5-15,-2011
1972,5,16,2400,217,2183,1972-5-16,-1966
1972,5,17,2376,332,2044,1972-5-17,-1712
1972,5,18,2160,349,1811,1972-5-18,-1462
1972,5,19,2078,393,1685,1972-5-19,-1292
1972,5,20,1752,343,1409,1972-5-20,-1066
1972,5,21,1633,295,1338,1972-5-21,-1043
1972,5,22,1355,233,1122,1972-5-22,-889
1972,5,23,1347,201,1146,1972-5-23,-945
1972,5,24,1605,718,887,1972-5-24,-169
1972,5,25,2073,1040,1033,1972-5-25,7
1972,5,26,1971,887,1084,1972-5-26,-197
1972,5,27,1262,690,572,1972-5-27,118
1972,5,28,556,551,5,1972-5-28,546
1972,5,29,837,652,185,1972-5-29,467
1972,5,30,1412,705,707,1972-5-30,-2
1972,5,31,1199,642,557,1972-5-31,85
1972,6,1,1024,541,483,1972-6-1,58
1972,6,2,1120,509,611,1972-6-2,-102
1972,6,3,1259,500,759,1972-6-3,-259
1972,6,4,1180,437,743,1972-6-4,-306
1972,6,5,1951,483,1468,1972-6-5,-985
1972,6,6,1655,65,1590,1972-6-6,-1525
1972,6,7,1587,42,1545,1972-6-7,-1503
1972,6,8,1955,52,1903,1972-6-8,-1851
1972,6,9,1580,9,1571,1972-6-9,-1562
1972,6,10,1362,6,1356,1972-6-10,-1350
1972,6,11,1897,0,1897,1972-6-11,-1897
1972,6,12,1576,8,1568,1972-6-12,-1560
1972,6,13,707,0,707,1972-6-13,-707
1972,6,14,676,21,655,1972-6-14,-634
1972,6,15,1416,446,970,1972-6-15,-524
1972,6,16,1435,334,1101,1972-6-16,-767
1972,6,17,1515,278,1237,1972-6-17,-959
1972,6,18,1667,306,1361,1972-6-18,-1055
1972,6,19,1402,262,1140,1972-6-19,-878
1972,6,20,1367,326,1041,1972-6-20,-715
1972,6,21,1533,596,937,1972-6-21,-341
1972,6,22,1663,636,1027,1972-6-22,-391
1972,6,23,1620,590,1030,1972-6-23,-440
1972,6,24,1187,501,686,1972-6-24,-185
1972,6,25,994,428,566,1972-6-25,-138
1972,6,26,899,349,550,1972-6-26,-201
1972,6,27,1078,353,725,1972-6-27,-372
1972,6,28,682,380,302,1972-6-28,78
1972,6,29,822,571,251,1972-6-29,320
1972,6,30,849,628,221,1972-6-30,407
1972,7,1,729,539,190,1972-7-1,349
1972,7,2,912,704,208,1972-7-2,496
1972,7,3,914,635,279,1972-7-3,356
1972,7,4,1352,654,698,1972-7-4,-44
1972,7,5,1374,670,704,1972-7-5,-34
1972,7,6,1222,701,521,1972-7-6,180
1972,7,7,1137,609,528,1972-7-7,81
1972,7,8,929,470,459,1972-7-8,11
1972,7,9,601,323,278,1972-7-9,45
1972,7,10,512,282,230,1972-7-10,52
1972,7,11,572,281,291,1972-7-11,-10
1972,7,12,792,321,471,1972-7-12,-150
1972,7,13,1014,364,650,1972-7-13,-286
1972,7,14,1182,472,710,1972-7-14,-238
1972,7,15,1226,570,656,1972-7-15,-86
1972,7,16,717,29,688,1972-7-16,-659
1972,7,17,720,31,689,1972-7-17,-658
1972,7,18,631,30,601,1972-7-18,-571
1972,7,19,611,119,492,1972-7-19,-373
1972,7,20,543,159,384,1972-7-20,-225
1972,7,21,666,306,360,1972-7-21,-54
1972,7,22,658,298,360,1972-7-22,-62
1972,7,23,446,210,236,1972-7-23,-26
1972,7,24,890,120,770,1972-7-24,-650
1972,7,25,661,129,532,1972-7-25,-403
1972,7,26,637,219,418,1972-7-26,-199
1972,7,27,863,413,450,1972-7-27,-37
1972,7,28,926,427,499,1972-7-28,-72
1972,7,29,1367,965,402,1972-7-29,563
1972,7,30,1998,1629,369,1972-7-30,1260
1972,7,31,2002,1452,550,1972-7-31,902
1972,8,1,1965,1412,553,1972-8-1,859
1972,8,2,1802,1404,398,1972-8-2,1006
1972,8,3,1614,1231,383,1972-8-3,848
1972,8,4,1297,1107,190,1972-8-4,917
1972,8,5,1540,1221,319,1972-8-5,902
1972,8,6,1396,1134,262,1972-8-6,872
1972,8,7,1315,1074,241,1972-8-7,833
1972,8,8,1257,984,273,1972-8-8,711
1972,8,9,1563,1040,523,1972-8-9,517
1972,8,10,1381,1110,271,1972-8-10,839
1972,8,11,1011,971,40,1972-8-11,931
1972,8,12,765,712,53,1972-8-12,659
1972,8,13,361,271,90,1972-8-13,181
1972,8,14,215,21,194,1972-8-14,-173
1972,8,15,236,121,115,1972-8-15,6
1972,8,16,307,144,163,1972-8-16,-19
1972,8,17,421,196,225,1972-8-17,-29
1972,8,18,571,296,275,1972-8-18,21
1972,8,19,583,362,221,1972-8-19,141
1972,8,20,630,351,279,1972-8-20,72
1972,8,21,536,92,444,1972-8-21,-352
1972,8,22,920,233,687,1972-8-22,-454
1972,8,23,903,265,638,1972-8-23,-373
1972,8,24,1037,242,795,1972-8-24,-553
1972,8,25,969,197,772,1972-8-25,-575
1972,8,26,874,218,656,1972-8-26,-438
1972,8,27,1067,478,589,1972-8-27,-111
1972,8,28,1376,853,523,1972-8-28,330
1972,8,29,1822,975,847,1972-8-29,128
1972,8,30,1706,978,728,1972-8-30,250
1972,8,31,1163,600,563,1972-8-31,37
1972,9,1,969,424,545,1972-9-1,-121
1972,9,2,562,236,326,1972-9-2,-90
1972,9,3,691,215,476,1972-9-3,-261
1972,9,4,563,157,406,1972-9-4,-249
1972,9,5,644,104,540,1972-9-5,-436
1972,9,6,449,151,298,1972-9-6,-147
1972,9,7,478,207,271,1972-9-7,-64
1972,9,8,474,200,274,1972-9-8,-74
1972,9,9,649,197,452,1972-9-9,-255
1972,9,10,593,231,362,1972-9-10,-131
1972,9,11,405,172,233,1972-9-11,-61
1972,9,12,345,163,182,1972-9-12,-19
1972,9,13,300,134,166,1972-9-13,-32
1972,9,14,270,146,124,1972-9-14,22
1972,9,15,325,193,132,1972-9-15,61
1972,9,16,415,196,219,1972-9-16,-23
1972,9,17,357,35,322,1972-9-17,-287
1972,9,18,170,25,145,1972-9-18,-120
1972,9,19,209,20,189,1972-9-19,-169
1972,9,20,417,37,380,1972-9-20,-343
1972,9,21,980,77,903,1972-9-21,-826
1972,9,22,1163,239,924,1972-9-22,-685
1972,9,23,1126,177,949,1972-9-23,-772
1972,9,24,1117,140,977,1972-9-24,-837
1972,9,25,1051,96,955,1972-9-25,-859
1972,9,26,931,132,799,1972-9-26,-667
1972,9,27,692,125,567,1972-9-27,-442
1972,9,28,497,54,443,1972-9-28,-389
1972,9,29,658,269,389,1972-9-29,-120
1972,9,30,642,275,367,1972-9-30,-92
1972,10,1,774,458,316,1972-10-1,142
1972,10,2,691,505,186,1972-10-2,319
1972,10,3,565,379,186,1972-10-3,193
1972,10,4,356,258,98,1972-10-4,160
1972,10,5,303,189,114,1972-10-5,75
1972,10,6,266,150,116,1972-10-6,34
1972,10,7,168,117,51,1972-10-7,66
1972,10,8,127,86,41,1972-10-8,45
1972,10,9,102,67,35,1972-10-9,32
1972,10,10,126,96,30,1972-10-10,66
1972,10,11,174,80,94,1972-10-11,-14
1972,10,12,135,12,123,1972-10-12,-111
1972,10,13,0,0,0,1972-10-13,0
1972,10,14,7,7,0,1972-10-14,7
1972,10,15,246,11,235,1972-10-15,-224
1972,10,16,649,100,549,1972-10-16,-449
1972,10,17,682,15,667,1972-10-17,-652
1972,10,18,597,0,597,1972-10-18,-597
1972,10,19,780,0,780,1972-10-19,-780
1972,10,20,782,0,782,1972-10-20,-782
1972,10,21,1193,0,1193,1972-10-21,-1193
1972,10,22,1045,0,1045,1972-10-22,-1045
1972,10,23,2473,0,2473,1972-10-23,-2473
1972,10,24,2992,0,2992,1972-10-24,-2992
1972,10,25,3002,0,3002,1972-10-25,-3002
1972,10,26,2930,0,2930,1972-10-26,-2930
1972,10,27,2809,4,2805,1972-10-27,-2801
1972,10,28,2388,28,2360,1972-10-28,-2332
1972,10,29,1953,3,1950,1972-10-29,-1947
1972,10,30,1576,16,1560,1972-10-30,-1544
1972,10,31,1639,30,1609,1972-10-31,-1579
1972,11,1,1778,15,1763,1972-11-1,-1748
1972,11,2,1533,36,1497,1972-11-2,-1461
1972,11,3,1214,11,1203,1972-11-3,-1192
1972,11,4,946,0,946,1972-11-4,-946
1972,11,5,102,0,102,1972-11-5,-102
1972,11,6,493,0,493,1972-11-6,-493
1972,11,7,175,0,175,1972-11-7,-175
1972,11,8,17,0,17,1972-11-8,-17
1972,11,9,18,6,12,1972-11-9,-6
1972,11,10,60,60,0,1972-11-10,60
1972,11,11,305,256,49,1972-11-11,207
1972,11,12,707,312,395,1972-11-12,-83
1972,11,13,503,80,423,1972-11-13,-343
1972,11,14,362,16,346,1972-11-14,-330
1972,11,15,289,0,289,1972-11-15,-289
1972,11,16,301,0,301,1972-11-16,-301
1972,11,17,324,24,300,1972-11-17,-276
1972,11,18,266,0,266,1972-11-18,-266
1972,11,19,395,0,395,1972-11-19,-395
1972,11,20,572,0,572,1972-11-20,-572
1972,11,21,768,0,768,1972-11-21,-768
1972,11,22,716,0,716,1972-11-22,-716
1972,11,23,815,0,815,1972-11-23,-815
1972,11,24,1061,0,1061,1972-11-24,-1061
1972,11,25,781,0,781,1972-11-25,-781
1972,11,26,573,12,561,1972-11-26,-549
1972,11,27,639,22,617,1972-11-27,-595
1972,11,28,364,5,359,1972-11-28,-354
1972,11,29,220,0,220,1972-11-29,-220
1972,11,30,349,0,349,1972-11-30,-349
1972,12,1,332,4,328,1972-12-1,-324
1972,12,2,226,1,225,1972-12-2,-224
1972,12,3,241,0,241,1972-12-3,-241
1972,12,4,66,0,66,1972-12-4,-66
1972,12,5,57,0,57,1972-12-5,-57
1972,12,6,124,107,17,1972-12-6,90
1972,12,7,254,240,14,1972-12-7,226
1972,12,8,615,615,0,1972-12-8,615
1972,12,9,715,715,0,1972-12-9,715
1972,12,10,650,619,31,1972-12-10,588
1972,12,11,557,539,18,1972-12-11,521
1972,12,12,647,390,257,1972-12-12,133
1972,12,13,933,409,524,1972-12-13,-115
1972,12,14,833,267,566,1972-12-14,-299
1972,12,15,972,341,631,1972-12-15,-290
1972,12,16,926,278,648,1972-12-16,-370
1972,12,17,770,189,581,1972-12-17,-392
1972,12,18,581,146,435,1972-12-18,-289
1972,12,19,586,264,322,1972-12-19,-58
1972,12,20,613,323,290,1972-12-20,33
1972,12,21,846,463,383,1972-12-21,80
1972,12,22,708,672,36,1972-12-22,636
1972,12,23,643,635,8,1972-12-23,627
1972,12,24,585,563,22,1972-12-24,541
1972,12,25,609,603,6,1972-12-25,597
1972,12,26,498,494,4,1972-12-26,490
1972,12,27,515,476,39,1972-12-27,437
1972,12,28,578,503,75,1972-12-28,428
1972,12,29,378,330,48,1972-12-29,282
1972,12,30,534,372,162,1972-12-30,210
1972,12,31,820,690,130,1972-12-31,560
1973,1,1,601,573,28,1973-1-1,545
1973,1,2,563,538,25,1973-1-2,513
1973,1,3,751,729,22,1973-1-3,707
1973,1,4,743,726,17,1973-1-4,709
1973,1,5,915,788,127,1973-1-5,661
1973,1,6,927,854,73,1973-1-6,781
1973,1,7,876,791,85,1973-1-7,706
1973,1,8,794,762,32,1973-1-8,730
1973,1,9,752,672,80,1973-1-9,592
1973,1,10,578,534,44,1973-1-10,490
1973,1,11,391,366,25,1973-1-11,341
1973,1,12,240,231,9,1973-1-12,222
1973,1,13,335,322,13,1973-1-13,309
1973,1,14,369,351,18,1973-1-14,333
1973,1,15,347,336,11,1973-1-15,325
1973,1,16,272,269,3,1973-1-16,266
1973,1,17,279,266,13,1973-1-17,253
1973,1,18,311,212,99,1973-1-18,113
1973,1,19,316,246,70,1973-1-19,176
1973,1,20,259,169,90,1973-1-20,79
1973,1,21,375,275,100,1973-1-21,175
1973,1,22,365,245,120,1973-1-22,125
1973,1,23,342,241,101,1973-1-23,140
1973,1,24,311,208,103,1973-1-24,105
1973,1,25,158,141,17,1973-1-25,124
1973,1,26,64,58,6,1973-1-26,52
1973,1,27,43,43,0,1973-1-27,43
1973,1,28,25,25,0,1973-1-28,25
1973,1,29,31,18,13,1973-1-29,5
1973,1,30,21,21,0,1973-1-30,21
1973,1,31,17,17,0,1973-1-31,17
1973,2,1,9,9,0,1973-2-1,9
1973,2,2,160,5,155,1973-2-2,-150
1973,2,3,137,6,131,1973-2-3,-125
1973,2,4,143,0,143,1973-2-4,-143
1973,2,5,523,419,104,1973-2-5,315
1973,2,6,312,293,19,1973-2-6,274
1973,2,7,390,383,7,1973-2-7,376
1973,2,8,399,384,15,1973-2-8,369
1973,2,9,492,474,18,1973-2-9,456
1973,2,10,683,436,247,1973-2-10,189
1973,2,11,594,354,240,1973-2-11,114
1973,2,12,588,304,284,1973-2-12,20
1973,2,13,652,231,421,1973-2-13,-190
1973,2,14,728,320,408,1973-2-14,-88
1973,2,15,689,315,374,1973-2-15,-59
1973,2,16,509,113,396,1973-2-16,-283
1973,2,17,408,101,307,1973-2-17,-206
1973,2,18,260,14,246,1973-2-18,-232
1973,2,19,247,0,247,1973-2-19,-247
1973,2,20,239,23,216,1973-2-20,-193
1973,2,21,295,8,287,1973-2-21,-279
1973,2,22,183,2,181,1973-2-22,-179
1973,2,23,312,269,43,1973-2-23,226
1973,2,24,583,515,68,1973-2-24,447
1973,2,25,644,585,59,1973-2-25,526
1973,2,26,595,593,2,1973-2-26,591
1973,2,27,523,523,0,1973-2-27,523
1973,2,28,566,559,7,1973-2-28,552
1973,3,1,618,517,101,1973-3-1,416
1973,3,2,576,485,91,1973-3-2,394
1973,3,3,474,445,29,1973-3-3,416
1973,3,4,621,430,191,1973-3-4,239
1973,3,5,519,386,133,1973-3-5,253
1973,3,6,672,388,284,1973-3-6,104
1973,3,7,534,291,243,1973-3-7,48
1973,3,8,555,60,495,1973-3-8,-435
1973,3,9,822,69,753,1973-3-9,-684
1973,3,10,978,75,903,1973-3-10,-828
1973,3,11,1119,173,946,1973-3-11,-773
1973,3,12,1164,272,892,1973-3-12,-620
1973,3,13,1093,260,833,1973-3-13,-573
1973,3,14,1040,227,813,1973-3-14,-586
1973,3,15,1226,554,672,1973-3-15,-118
1973,3,16,665,25,640,1973-3-16,-615
1973,3,17,600,24,576,1973-3-17,-552
1973,3,18,449,15,434,1973-3-18,-419
1973,3,19,595,213,382,1973-3-19,-169
1973,3,20,230,230,0,1973-3-20,230
1973,3,21,267,267,0,1973-3-21,267
1973,3,22,561,561,0,1973-3-22,561
1973,3,23,635,635,0,1973-3-23,635
1973,3,24,556,556,0,1973-3-24,556
1973,3,25,510,510,0,1973-3-25,510
1973,3,26,441,441,0,1973-3-26,441
1973,3,27,802,339,463,1973-3-27,-124
1973,3,28,886,305,581,1973-3-28,-276
1973,3,29,947,353,594,1973-3-29,-241
1973,3,30,1090,456,634,1973-3-30,-178
1973,3,31,1137,502,635,1973-3-31,-133
1973,4,1,1257,681,576,1973-4-1,105
1973,4,2,1533,717,816,1973-4-2,-99
1973,4,3,1761,621,1140,1973-4-3,-519
1973,4,4,1265,176,1089,1973-4-4,-913
1973,4,5,1228,216,1012,1973-4-5,-796
1973,4,6,1066,188,878,1973-4-6,-690
1973,4,7,836,170,666,1973-4-7,-496
1973,4,8,942,115,827,1973-4-8,-712
1973,4,9,820,52,768,1973-4-9,-716
1973,4,10,753,41,712,1973-4-10,-671
1973,4,11,513,0,513,1973-4-11,-513
1973,4,12,358,0,358,1973-4-12,-358
1973,4,13,362,0,362,1973-4-13,-362
1973,4,14,371,0,371,1973-4-14,-371
1973,4,15,231,0,231,1973-4-15,-231
1973,4,16,365,11,354,1973-4-16,-343
1973,4,17,204,3,201,1973-4-17,-198
1973,4,18,204,201,3,1973-4-18,198
1973,4,19,390,293,97,1973-4-19,196
1973,4,20,536,392,144,1973-4-20,248
1973,4,21,467,376,91,1973-4-21,285
1973,4,22,1068,491,577,1973-4-22,-86
1973,4,23,877,418,459,1973-4-23,-41
1973,4,24,743,301,442,1973-4-24,-141
1973,4,25,636,241,395,1973-4-25,-154
1973,4,26,587,227,360,1973-4-26,-133
1973,4,27,695,346,349,1973-4-27,-3
1973,4,28,993,697,296,1973-4-28,401
1973,4,29,929,827,102,1973-4-29,725
1973,4,30,962,919,43,1973-4-30,876
1973,5,1,408,0,408,1973-5-1,-408
1973,5,2,809,0,809,1973-5-2,-809
1973,5,3,708,0,708,1973-5-3,-708
1973,5,4,724,3,721,1973-5-4,-718
1973,5,5,800,0,800,1973-5-5,-800
1973,5,6,679,0,679,1973-5-6,-679
1973,5,7,561,20,541,1973-5-7,-521
1973,5,8,441,5,436,1973-5-8,-431
1973,5,9,303,0,303,1973-5-9,-303
1973,5,10,281,0,281,1973-5-10,-281
1973,5,11,239,6,233,1973-5-11,-227
1973,5,12,164,5,159,1973-5-12,-154
1973,5,13,42,0,42,1973-5-13,-42
1973,5,14,0,0,0,1973-5-14,0
1973,5,15,167,137,30,1973-5-15,107
1973,5,16,529,420,109,1973-5-16,311
1973,5,17,516,463,53,1973-5-17,410
1973,5,18,508,476,32,1973-5-18,444
1973,5,19,465,456,9,1973-5-19,447
1973,5,20,463,441,22,1973-5-20,419
1973,5,21,435,425,10,1973-5-21,415
1973,5,22,441,401,40,1973-5-22,361
1973,5,23,344,331,13,1973-5-23,318
1973,5,24,408,278,130,1973-5-24,148
1973,5,25,450,199,251,1973-5-25,-52
1973,5,26,522,247,275,1973-5-26,-28
1973,5,27,408,175,233,1973-5-27,-58
1973,5,28,231,13,218,1973-5-28,-205
1973,5,29,261,21,240,1973-5-29,-219
1973,5,30,337,144,193,1973-5-30,-49
1973,5,31,111,111,0,1973-5-31,111
1973,6,1,87,87,0,1973-6-1,87
1973,6,2,80,80,0,1973-6-2,80
1973,6,3,34,0,34,1973-6-3,-34
1973,6,4,6,0,6,1973-6-4,-6
1973,6,5,0,0,0,1973-6-5,0
1973,6,6,29,29,0,1973-6-6,29
1973,6,7,677,527,150,1973-6-7,377
1973,6,8,393,287,106,1973-6-8,181
1973,6,9,381,284,97,1973-6-9,187
1973,6,10,271,206,65,1973-6-10,141
1973,6,11,584,521,63,1973-6-11,458
1973,6,12,473,435,38,1973-6-12,397
1973,6,13,627,596,31,1973-6-13,565
1973,6,14,606,593,13,1973-6-14,580
1973,6,15,438,427,11,1973-6-15,416
1973,6,16,178,161,17,1973-6-16,144
1973,6,17,130,129,1,1973-6-17,128
1973,6,18,149,125,24,1973-6-18,101
1973,6,19,606,66,540,1973-6-19,-474
1973,6,20,857,75,782,1973-6-20,-707
1973,6,21,1019,99,920,1973-6-21,-821
1973,6,22,897,37,860,1973-6-22,-823
1973,6,23,776,9,767,1973-6-23,-758
1973,6,24,648,0,648,1973-6-24,-648
1973,6,25,558,0,558,1973-6-25,-558
1973,6,26,520,0,520,1973-6-26,-520
1973,6,27,482,0,482,1973-6-27,-482
1973,6,28,321,0,321,1973-6-28,-321
1973,6,29,686,424,262,1973-6-29,162
1973,6,30,717,582,135,1973-6-30,447
1973,7,1,555,498,57,1973-7-1,441
1973,7,2,540,517,23,1973-7-2,494
1973,7,3,559,490,69,1973-7-3,421
1973,7,4,545,510,35,1973-7-4,475
1973,7,5,595,505,90,1973-7-5,415
1973,7,6,650,490,160,1973-7-6,330
1973,7,7,663,551,112,1973-7-7,439
1973,7,8,483,457,26,1973-7-8,431
1973,7,9,648,641,7,1973-7-9,634
1973,7,10,854,854,0,1973-7-10,854
1973,7,11,820,820,0,1973-7-11,820
1973,7,12,220,218,2,1973-7-12,216
1973,7,13,12,4,8,1973-7-13,-4
1973,7,14,20,0,20,1973-7-14,-20
1973,7,15,38,0,38,1973-7-15,-38
1973,7,16,43,0,43,1973-7-16,-43
1973,7,17,106,0,106,1973-7-17,-106
1973,7,18,91,39,52,1973-7-18,-13
1973,7,19,19,15,4,1973-7-19,11
1973,7,20,14,14,0,1973-7-20,14
1973,7,21,31,0,31,1973-7-21,-31
1973,7,22,16,5,11,1973-7-22,-6
1973,7,23,0,0,0,1973-7-23,0
1973,7,24,43,43,0,1973-7-24,43
1973,7,25,182,5,177,1973-7-25,-172
1973,7,26,185,0,185,1973-7-26,-185
1973,7,27,164,0,164,1973-7-27,-164
1973,7,28,168,0,168,1973-7-28,-168
1973,7,29,174,0,174,1973-7-29,-174
1973,7,30,136,0,136,1973-7-30,-136
1973,7,31,155,0,155,1973-7-31,-155
1973,8,1,339,38,301,1973-8-1,-263
1973,8,2,234,5,229,1973-8-2,-224
1973,8,3,163,14,149,1973-8-3,-135
1973,8,4,247,53,194,1973-8-4,-141
1973,8,5,210,95,115,1973-8-5,-20
1973,8,6,246,144,102,1973-8-6,42
1973,8,7,371,257,114,1973-8-7,143
1973,8,8,432,319,113,1973-8-8,206
1973,8,9,266,185,81,1973-8-9,104
1973,8,10,205,152,53,1973-8-10,99
1973,8,11,117,113,4,1973-8-11,109
1973,8,12,2,0,2,1973-8-12,-2
1973,8,13,0,0,0,1973-8-13,0
1973,8,14,0,0,0,1973-8-14,0
1973,8,15,0,0,0,1973-8-15,0
1973,8,16,0,0,0,1973-8-16,0
1973,8,17,0,0,0,1973-8-17,0
1973,8,18,19,19,0,1973-8-18,19
1973,8,19,7,7,0,1973-8-19,7
1973,8,20,4,4,0,1973-8-20,4
1973,8,21,22,22,0,1973-8-21,22
1973,8,22,23,23,0,1973-8-22,23
1973,8,23,21,21,0,1973-8-23,21
1973,8,24,174,174,0,1973-8-24,174
1973,8,25,277,277,0,1973-8-25,277
1973,8,26,297,297,0,1973-8-26,297
1973,8,27,340,340,0,1973-8-27,340
1973,8,28,683,286,397,1973-8-28,-111
1973,8,29,1082,293,789,1973-8-29,-496
1973,8,30,1167,404,763,1973-8-30,-359
1973,8,31,1181,513,668,1973-8-31,-155
1973,9,1,1328,591,737,1973-9-1,-146
1973,9,2,1656,617,1039,1973-9-2,-422
1973,9,3,2202,981,1221,1973-9-3,-240
1973,9,4,2032,1094,938,1973-9-4,156
1973,9,5,1800,931,869,1973-9-5,62
1973,9,6,1539,748,791,1973-9-6,-43
1973,9,7,1320,660,660,1973-9-7,0
1973,9,8,1310,607,703,1973-9-8,-96
1973,9,9,1254,556,698,1973-9-9,-142
1973,9,10,878,383,495,1973-9-10,-112
1973,9,11,720,375,345,1973-9-11,30
1973,9,12,519,393,126,1973-9-12,267
1973,9,13,7,0,7,1973-9-13,-7
1973,9,14,22,0,22,1973-9-14,-22
1973,9,15,76,64,12,1973-9-15,52
1973,9,16,144,95,49,1973-9-16,46
1973,9,17,89,79,10,1973-9-17,69
1973,9,18,100,72,28,1973-9-18,44
1973,9,19,54,54,0,1973-9-19,54
1973,9,20,289,289,0,1973-9-20,289
1973,9,21,362,362,0,1973-9-21,362
1973,9,22,608,604,4,1973-9-22,600
1973,9,23,710,710,0,1973-9-23,710
1973,9,24,918,918,0,1973-9-24,918
1973,9,25,978,899,79,1973-9-25,820
1973,9,26,1062,937,125,1973-9-26,812
1973,9,27,1346,1062,284,1973-9-27,778
1973,9,28,1061,846,215,1973-9-28,631
1973,9,29,1060,915,145,1973-9-29,770
1973,9,30,1059,886,173,1973-9-30,713
1973,10,1,1185,985,200,1973-10-1,785
1973,10,2,996,806,190,1973-10-2,616
1973,10,3,544,410,134,1973-10-3,276
1973,10,4,412,313,99,1973-10-4,214
1973,10,5,345,275,70,1973-10-5,205
1973,10,6,281,273,8,1973-10-6,265
1973,10,7,260,246,14,1973-10-7,232
1973,10,8,187,141,46,1973-10-8,95
1973,10,9,234,184,50,1973-10-9,134
1973,10,10,4,0,4,1973-10-10,-4
1973,10,11,0,0,0,1973-10-11,0
1973,10,12,0,0,0,1973-10-12,0
1973,10,13,26,26,0,1973-10-13,26
1973,10,14,37,29,8,1973-10-14,21
1973,10,15,55,13,42,1973-10-15,-29
1973,10,16,69,4,65,1973-10-16,-61
1973,10,17,101,64,37,1973-10-17,27
1973,10,18,103,82,21,1973-10-18,61
1973,10,19,0,0,0,1973-10-19,0
1973,10,20,0,0,0,1973-10-20,0
1973,10,21,0,0,0,1973-10-21,0
1973,10,22,342,33,309,1973-10-22,-276
1973,10,23,836,62,774,1973-10-23,-712
1973,10,24,910,120,790,1973-10-24,-670
1973,10,25,961,236,725,1973-10-25,-489
1973,10,26,896,180,716,1973-10-26,-536
1973,10,27,1033,204,829,1973-10-27,-625
1973,10,28,958,236,722,1973-10-28,-486
1973,10,29,772,201,571,1973-10-29,-370
1973,10,30,623,160,463,1973-10-30,-303
1973,10,31,448,87,361,1973-10-31,-274
1973,11,1,396,67,329,1973-11-1,-262
1973,11,2,360,45,315,1973-11-2,-270
1973,11,3,67,40,27,1973-11-3,13
1973,11,4,21,16,5,1973-11-4,11
1973,11,5,41,41,0,1973-11-5,41
1973,11,6,0,0,0,1973-11-6,0
1973,11,7,0,0,0,1973-11-7,0
1973,11,8,0,0,0,1973-11-8,0
1973,11,9,0,0,0,1973-11-9,0
1973,11,10,0,0,0,1973-11-10,0
1973,11,11,1,0,1,1973-11-11,-1
1973,11,12,0,0,0,1973-11-12,0
1973,11,13,101,101,0,1973-11-13,101
1973,11,14,136,136,0,1973-11-14,136
1973,11,15,86,86,0,1973-11-15,86
1973,11,16,92,92,0,1973-11-16,92
1973,11,17,82,82,0,1973-11-17,82
1973,11,18,60,43,17,1973-11-18,26
1973,11,19,31,24,7,1973-11-19,17
1973,11,20,14,14,0,1973-11-20,14
1973,11,21,174,11,163,1973-11-21,-152
1973,11,22,525,10,515,1973-11-22,-505
1973,11,23,721,5,716,1973-11-23,-711
1973,11,24,605,2,603,1973-11-24,-601
1973,11,25,566,0,566,1973-11-25,-566
1973,11,26,719,56,663,1973-11-26,-607
1973,11,27,557,89,468,1973-11-27,-379
1973,11,28,498,105,393,1973-11-28,-288
1973,11,29,770,192,578,1973-11-29,-386
1973,11,30,656,155,501,1973-11-30,-346
1973,12,1,415,0,415,1973-12-1,-415
1973,12,2,172,0,172,1973-12-2,-172
1973,12,3,314,0,314,1973-12-3,-314
1973,12,4,4,4,0,1973-12-4,4
1973,12,5,0,0,0,1973-12-5,0
1973,12,6,0,0,0,1973-12-6,0
1973,12,7,0,0,0,1973-12-7,0
1973,12,8,71,71,0,1973-12-8,71
1973,12,9,48,48,0,1973-12-9,48
1973,12,10,43,43,0,1973-12-10,43
1973,12,11,37,37,0,1973-12-11,37
1973,12,12,26,26,0,1973-12-12,26
1973,12,13,14,14,0,1973-12-13,14
1973,12,14,23,23,0,1973-12-14,23
1973,12,15,93,93,0,1973-12-15,93
1973,12,16,249,110,139,1973-12-16,-29
1973,12,17,212,76,136,1973-12-17,-60
1973,12,18,190,68,122,1973-12-18,-54
1973,12,19,253,56,197,1973-12-19,-141
1973,12,20,333,45,288,1973-12-20,-243
1973,12,21,540,40,500,1973-12-21,-460
1973,12,22,658,40,618,1973-12-22,-578
1973,12,23,684,25,659,1973-12-23,-634
1973,12,24,729,19,710,1973-12-24,-691
1973,12,25,918,17,901,1973-12-25,-884
1973,12,26,762,17,745,1973-12-26,-728
1973,12,27,542,4,538,1973-12-27,-534
1973,12,28,462,0,462,1973-12-28,-462
1973,12,29,0,0,0,1973-12-29,0
1973,12,30,0,0,0,1973-12-30,0
1973,12,31,0,0,0,1973-12-31,0
1974,1,1,4,0,4,1974-1-1,-4
1974,1,2,64,0,64,1974-1-2,-64
1974,1,3,118,0,118,1974-1-3,-118
1974,1,4,40,0,40,1974-1-4,-40
1974,1,5,12,0,12,1974-1-5,-12
1974,1,6,3,0,3,1974-1-6,-3
1974,1,7,4,4,0,1974-1-7,4
1974,1,8,281,58,223,1974-1-8,-165
1974,1,9,244,71,173,1974-1-9,-102
1974,1,10,411,101,310,1974-1-10,-209
1974,1,11,412,76,336,1974-1-11,-260
1974,1,12,654,119,535,1974-1-12,-416
1974,1,13,592,132,460,1974-1-13,-328
1974,1,14,553,85,468,1974-1-14,-383
1974,1,15,652,178,474,1974-1-15,-296
1974,1,16,439,33,406,1974-1-16,-373
1974,1,17,418,28,390,1974-1-17,-362
1974,1,18,292,9,283,1974-1-18,-274
1974,1,19,285,39,246,1974-1-19,-207
1974,1,20,215,40,175,1974-1-20,-135
1974,1,21,147,53,94,1974-1-21,-41
1974,1,22,233,182,51,1974-1-22,131
1974,1,23,216,160,56,1974-1-23,104
1974,1,24,38,17,21,1974-1-24,-4
1974,1,25,0,0,0,1974-1-25,0
1974,1,26,6,0,6,1974-1-26,-6
1974,1,27,3,0,3,1974-1-27,-3
1974,1,28,6,0,6,1974-1-28,-6
1974,1,29,0,0,0,1974-1-29,0
1974,1,30,0,0,0,1974-1-30,0
1974,1,31,0,0,0,1974-1-31,0
1974,2,1,9,9,0,1974-2-1,9
1974,2,2,6,4,2,1974-2-2,2
1974,2,3,7,0,7,1974-2-3,-7
1974,2,4,0,0,0,1974-2-4,0
1974,2,5,0,0,0,1974-2-5,0
1974,2,6,0,0,0,1974-2-6,0
1974,2,7,38,38,0,1974-2-7,38
1974,2,8,56,24,32,1974-2-8,-8
1974,2,9,298,13,285,1974-2-9,-272
1974,2,10,301,15,286,1974-2-10,-271
1974,2,11,188,1,187,1974-2-11,-186
1974,2,12,174,0,174,1974-2-12,-174
1974,2,13,241,7,234,1974-2-13,-227
1974,2,14,244,0,244,1974-2-14,-244
1974,2,15,330,0,330,1974-2-15,-330
1974,2,16,474,0,474,1974-2-16,-474
1974,2,17,638,0,638,1974-2-17,-638
1974,2,18,650,0,650,1974-2-18,-650
1974,2,19,630,0,630,1974-2-19,-630
1974,2,20,490,0,490,1974-2-20,-490
1974,2,21,389,0,389,1974-2-21,-389
1974,2,22,559,0,559,1974-2-22,-559
1974,2,23,370,3,367,1974-2-23,-364
1974,2,24,427,7,420,1974-2-24,-413
1974,2,25,352,6,346,1974-2-25,-340
1974,2,26,47,47,0,1974-2-26,47
1974,2,27,97,94,3,1974-2-27,91
1974,2,28,63,63,0,1974-2-28,63
1974,3,1,43,43,0,1974-3-1,43
1974,3,2,10,10,0,1974-3-2,10
1974,3,3,0,0,0,1974-3-3,0
1974,3,4,142,140,2,1974-3-4,138
1974,3,5,89,89,0,1974-3-5,89
1974,3,6,107,107,0,1974-3-6,107
1974,3,7,38,38,0,1974-3-7,38
1974,3,8,15,15,0,1974-3-8,15
1974,3,9,25,25,0,1974-3-9,25
1974,3,10,115,115,0,1974-3-10,115
1974,3,11,237,200,37,1974-3-11,163
1974,3,12,271,231,40,1974-3-12,191
1974,3,13,212,199,13,1974-3-13,186
1974,3,14,184,0,184,1974-3-14,-184
1974,3,15,135,109,26,1974-3-15,83
1974,3,16,51,29,22,1974-3-16,7
1974,3,17,26,0,26,1974-3-17,-26
1974,3,18,152,0,152,1974-3-18,-152
1974,3,19,165,0,165,1974-3-19,-165
1974,3,20,127,0,127,1974-3-20,-127
1974,3,21,146,3,143,1974-3-21,-140
1974,3,22,172,39,133,1974-3-22,-94
1974,3,23,221,100,121,1974-3-23,-21
1974,3,24,189,67,122,1974-3-24,-55
1974,3,25,126,6,120,1974-3-25,-114
1974,3,26,129,0,129,1974-3-26,-129
1974,3,27,156,0,156,1974-3-27,-156
1974,3,28,143,8,135,1974-3-28,-127
1974,3,29,180,59,121,1974-3-29,-62
1974,3,30,247,85,162,1974-3-30,-77
1974,3,31,120,100,20,1974-3-31,80
1974,4,1,43,22,21,1974-4-1,1
1974,4,2,22,22,0,1974-4-2,22
1974,4,3,20,17,3,1974-4-3,14
1974,4,4,32,17,15,1974-4-4,2
1974,4,5,46,27,19,1974-4-5,8
1974,4,6,117,115,2,1974-4-6,113
1974,4,7,225,192,33,1974-4-7,159
1974,4,8,134,66,68,1974-4-8,-2
1974,4,9,197,7,190,1974-4-9,-183
1974,4,10,508,0,508,1974-4-10,-508
1974,4,11,1098,84,1014,1974-4-11,-930
1974,4,12,1172,0,1172,1974-4-12,-1172
1974,4,13,1097,0,1097,1974-4-13,-1097
1974,4,14,1269,0,1269,1974-4-14,-1269
1974,4,15,2125,2,2123,1974-4-15,-2121
1974,4,16,3091,19,3072,1974-4-16,-3053
1974,4,17,1901,0,1901,1974-4-17,-1901
1974,4,18,386,8,378,1974-4-18,-370
1974,4,19,378,6,372,1974-4-19,-366
1974,4,20,432,30,402,1974-4-20,-372
1974,4,21,417,23,394,1974-4-21,-371
1974,4,22,16,0,16,1974-4-22,-16
1974,4,23,11,0,11,1974-4-23,-11
1974,4,24,64,0,64,1974-4-24,-64
1974,4,25,138,0,138,1974-4-25,-138
1974,4,26,88,0,88,1974-4-26,-88
1974,4,27,58,3,55,1974-4-27,-52
1974,4,28,1,0,1,1974-4-28,-1
1974,4,29,169,13,156,1974-4-29,-143
1974,4,30,151,4,147,1974-4-30,-143
1974,5,1,936,21,915,1974-5-1,-894
1974,5,2,978,82,896,1974-5-2,-814
1974,5,3,1198,102,1096,1974-5-3,-994
1974,5,4,1104,118,986,1974-5-4,-868
1974,5,5,992,118,874,1974-5-5,-756
1974,5,6,1058,83,975,1974-5-6,-892
1974,5,7,951,24,927,1974-5-7,-903
1974,5,8,912,36,876,1974-5-8,-840
1974,5,9,659,0,659,1974-5-9,-659
1974,5,10,579,0,579,1974-5-10,-579
1974,5,11,501,0,501,1974-5-11,-501
1974,5,12,221,0,221,1974-5-12,-221
1974,5,13,166,0,166,1974-5-13,-166
1974,5,14,69,0,69,1974-5-14,-69
1974,5,15,76,16,60,1974-5-15,-44
1974,5,16,40,40,0,1974-5-16,40
1974,5,17,15,15,0,1974-5-17,15
1974,5,18,0,0,0,1974-5-18,0
1974,5,19,0,0,0,1974-5-19,0
1974,5,20,0,0,0,1974-5-20,0
1974,5,21,0,0,0,1974-5-21,0
1974,5,22,20,0,20,1974-5-22,-20
1974,5,23,10,3,7,1974-5-23,-4
1974,5,24,7,0,7,1974-5-24,-7
1974,5,25,0,0,0,1974-5-25,0
1974,5,26,50,25,25,1974-5-26,0
1974,5,27,236,0,236,1974-5-27,-236
1974,5,28,398,8,390,1974-5-28,-382
1974,5,29,282,0,282,1974-5-29,-282
1974,5,30,113,0,113,1974-5-30,-113
1974,5,31,299,0,299,1974-5-31,-299
1974,6,1,470,0,470,1974-6-1,-470
1974,6,2,474,0,474,1974-6-2,-474
1974,6,3,321,0,321,1974-6-3,-321
1974,6,4,242,10,232,1974-6-4,-222
1974,6,5,291,135,156,1974-6-5,-21
1974,6,6,413,212,201,1974-6-6,11
1974,6,7,309,129,180,1974-6-7,-51
1974,6,8,309,146,163,1974-6-8,-17
1974,6,9,358,254,104,1974-6-9,150
1974,6,10,325,198,127,1974-6-10,71
1974,6,11,509,332,177,1974-6-11,155
1974,6,12,391,335,56,1974-6-12,279
1974,6,13,720,343,377,1974-6-13,-34
1974,6,14,556,257,299,1974-6-14,-42
1974,6,15,469,198,271,1974-6-15,-73
1974,6,16,349,107,242,1974-6-16,-135
1974,6,17,270,46,224,1974-6-17,-178
1974,6,18,273,48,225,1974-6-18,-177
1974,6,19,144,0,144,1974-6-19,-144
1974,6,20,149,0,149,1974-6-20,-149
1974,6,21,69,0,69,1974-6-21,-69
1974,6,22,53,0,53,1974-6-22,-53
1974,6,23,20,0,20,1974-6-23,-20
1974,6,24,26,15,11,1974-6-24,4
1974,6,25,13,13,0,1974-6-25,13
1974,6,26,130,0,130,1974-6-26,-130
1974,6,27,79,0,79,1974-6-27,-79
1974,6,28,233,0,233,1974-6-28,-233
1974,6,29,346,0,346,1974-6-29,-346
1974,6,30,468,0,468,1974-6-30,-468
1974,7,1,846,0,846,1974-7-1,-846
1974,7,2,1058,0,1058,1974-7-2,-1058
1974,7,3,1676,0,1676,1974-7-3,-1676
1974,7,4,1794,0,1794,1974-7-4,-1794
1974,7,5,1598,0,1598,1974-7-5,-1598
1974,7,6,1985,0,1985,1974-7-6,-1985
1974,7,7,1203,0,1203,1974-7-7,-1203
1974,7,8,1363,2,1361,1974-7-8,-1359
1974,7,9,1468,0,1468,1974-7-9,-1468
1974,7,10,577,0,577,1974-7-10,-577
1974,7,11,539,2,537,1974-7-11,-535
1974,7,12,416,0,416,1974-7-12,-416
1974,7,13,513,0,513,1974-7-13,-513
1974,7,14,620,0,620,1974-7-14,-620
1974,7,15,628,0,628,1974-7-15,-628
1974,7,16,926,0,926,1974-7-16,-926
1974,7,17,958,0,958,1974-7-17,-958
1974,7,18,856,0,856,1974-7-18,-856
1974,7,19,779,0,779,1974-7-19,-779
1974,7,20,741,0,741,1974-7-20,-741
1974,7,21,661,0,661,1974-7-21,-661
1974,7,22,914,0,914,1974-7-22,-914
1974,7,23,822,0,822,1974-7-23,-822
1974,7,24,632,0,632,1974-7-24,-632
1974,7,25,647,0,647,1974-7-25,-647
1974,7,26,491,0,491,1974-7-26,-491
1974,7,27,280,0,280,1974-7-27,-280
1974,7,28,316,0,316,1974-7-28,-316
1974,7,29,225,0,225,1974-7-29,-225
1974,7,30,120,0,120,1974-7-30,-120
1974,7,31,113,0,113,1974-7-31,-113
1974,8,1,220,0,220,1974-8-1,-220
1974,8,2,139,0,139,1974-8-2,-139
1974,8,3,45,0,45,1974-8-3,-45
1974,8,4,315,0,315,1974-8-4,-315
1974,8,5,503,0,503,1974-8-5,-503
1974,8,6,569,0,569,1974-8-6,-569
1974,8,7,486,0,486,1974-8-7,-486
1974,8,8,480,0,480,1974-8-8,-480
1974,8,9,426,36,390,1974-8-9,-354
1974,8,10,454,35,419,1974-8-10,-384
1974,8,11,493,28,465,1974-8-11,-437
1974,8,12,847,28,819,1974-8-12,-791
1974,8,13,813,15,798,1974-8-13,-783
1974,8,14,923,21,902,1974-8-14,-881
1974,8,15,693,9,684,1974-8-15,-675
1974,8,16,822,120,702,1974-8-16,-582
1974,8,17,747,202,545,1974-8-17,-343
1974,8,18,680,162,518,1974-8-18,-356
1974,8,19,666,237,429,1974-8-19,-192
1974,8,20,432,216,216,1974-8-20,0
1974,8,21,396,136,260,1974-8-21,-124
1974,8,22,441,149,292,1974-8-22,-143
1974,8,23,416,98,318,1974-8-23,-220
1974,8,24,398,81,317,1974-8-24,-236
1974,8,25,363,83,280,1974-8-25,-197
1974,8,26,180,52,128,1974-8-26,-76
1974,8,27,61,61,0,1974-8-27,61
1974,8,28,65,65,0,1974-8-28,65
1974,8,29,63,63,0,1974-8-29,63
1974,8,30,47,47,0,1974-8-30,47
1974,8,31,215,67,148,1974-8-31,-81
1974,9,1,144,0,144,1974-9-1,-144
1974,9,2,125,0,125,1974-9-2,-125
1974,9,3,299,0,299,1974-9-3,-299
1974,9,4,283,6,277,1974-9-4,-271
1974,9,5,304,9,295,1974-9-5,-286
1974,9,6,310,9,301,1974-9-6,-292
1974,9,7,246,0,246,1974-9-7,-246
1974,9,8,255,0,255,1974-9-8,-255
1974,9,9,1264,832,432,1974-9-9,400
1974,9,10,1569,956,613,1974-9-10,343
1974,9,11,1655,1208,447,1974-9-11,761
1974,9,12,1611,1241,370,1974-9-12,871
1974,9,13,1238,1038,200,1974-9-13,838
1974,9,14,1091,975,116,1974-9-14,859
1974,9,15,774,718,56,1974-9-15,662
1974,9,16,1015,972,43,1974-9-16,929
1974,9,17,763,721,42,1974-9-17,679
1974,9,18,785,724,61,1974-9-18,663
1974,9,19,745,687,58,1974-9-19,629
1974,9,20,719,719,0,1974-9-20,719
1974,9,21,727,727,0,1974-9-21,727
1974,9,22,0,0,0,1974-9-22,0
1974,9,23,4,0,4,1974-9-23,-4
1974,9,24,39,39,0,1974-9-24,39
1974,9,25,84,84,0,1974-9-25,84
1974,9,26,69,66,3,1974-9-26,63
1974,9,27,168,168,0,1974-9-27,168
1974,9,28,141,119,22,1974-9-28,97
1974,9,29,468,115,353,1974-9-29,-238
1974,9,30,635,114,521,1974-9-30,-407
1974,10,1,652,148,504,1974-10-1,-356
1974,10,2,580,99,481,1974-10-2,-382
1974,10,3,536,96,440,1974-10-3,-344
1974,10,4,735,244,491,1974-10-4,-247
1974,10,5,839,354,485,1974-10-5,-131
1974,10,6,1248,746,502,1974-10-6,244
1974,10,7,1176,774,402,1974-10-7,372
1974,10,8,1423,935,488,1974-10-8,447
1974,10,9,1315,798,517,1974-10-9,281
1974,10,10,1400,984,416,1974-10-10,568
1974,10,11,1319,993,326,1974-10-11,667
1974,10,12,1608,1347,261,1974-10-12,1086
1974,10,13,1276,1087,189,1974-10-13,898
1974,10,14,1153,1037,116,1974-10-14,921
1974,10,15,772,772,0,1974-10-15,772
1974,10,16,641,641,0,1974-10-16,641
1974,10,17,541,541,0,1974-10-17,541
1974,10,18,129,129,0,1974-10-18,129
1974,10,19,17,17,0,1974-10-19,17
1974,10,20,65,65,0,1974-10-20,65
1974,10,21,166,166,0,1974-10-21,166
1974,10,22,166,166,0,1974-10-22,166
1974,10,23,9,0,9,1974-10-23,-9
1974,10,24,0,0,0,1974-10-24,0
1974,10,25,136,0,136,1974-10-25,-136
1974,10,26,154,15,139,1974-10-26,-124
1974,10,27,126,14,112,1974-10-27,-98
1974,10,28,135,21,114,1974-10-28,-93
1974,10,29,111,0,111,1974-10-29,-111
1974,10,30,195,0,195,1974-10-30,-195
1974,10,31,70,0,70,1974-10-31,-70
1974,11,1,203,161,42,1974-11-1,119
1974,11,2,222,147,75,1974-11-2,72
1974,11,3,314,268,46,1974-11-3,222
1974,11,4,128,102,26,1974-11-4,76
1974,11,5,152,58,94,1974-11-5,-36
1974,11,6,32,32,0,1974-11-6,32
1974,11,7,25,21,4,1974-11-7,17
1974,11,8,19,10,9,1974-11-8,1
1974,11,9,0,0,0,1974-11-9,0
1974,11,10,38,36,2,1974-11-10,34
1974,11,11,9,9,0,1974-11-11,9
1974,11,12,61,61,0,1974-11-12,61
1974,11,13,24,24,0,1974-11-13,24
1974,11,14,1,0,1,1974-11-14,-1
1974,11,15,551,551,0,1974-11-15,551
1974,11,16,659,659,0,1974-11-16,659
1974,11,17,618,614,4,1974-11-17,610
1974,11,18,669,669,0,1974-11-18,669
1974,11,19,686,686,0,1974-11-19,686
1974,11,20,614,614,0,1974-11-20,614
1974,11,21,751,751,0,1974-11-21,751
1974,11,22,557,557,0,1974-11-22,557
1974,11,23,702,702,0,1974-11-23,702
1974,11,24,529,529,0,1974-11-24,529
1974,11,25,586,586,0,1974-11-25,586
1974,11,26,572,572,0,1974-11-26,572
1974,11,27,490,490,0,1974-11-27,490
1974,11,28,46,46,0,1974-11-28,46
1974,11,29,19,19,0,1974-11-29,19
1974,11,30,8,8,0,1974-11-30,8
1974,12,1,0,0,0,1974-12-1,0
1974,12,2,0,0,0,1974-12-2,0
1974,12,3,0,0,0,1974-12-3,0
1974,12,4,0,0,0,1974-12-4,0
1974,12,5,21,21,0,1974-12-5,21
1974,12,6,3,3,0,1974-12-6,3
1974,12,7,3,3,0,1974-12-7,3
1974,12,8,0,0,0,1974-12-8,0
1974,12,9,0,0,0,1974-12-9,0
1974,12,10,0,0,0,1974-12-10,0
1974,12,11,139,139,0,1974-12-11,139
1974,12,12,420,420,0,1974-12-12,420
1974,12,13,543,543,0,1974-12-13,543
1974,12,14,696,696,0,1974-12-14,696
1974,12,15,549,549,0,1974-12-15,549
1974,12,16,686,686,0,1974-12-16,686
1974,12,17,520,520,0,1974-12-17,520
1974,12,18,582,582,0,1974-12-18,582
1974,12,19,581,556,25,1974-12-19,531
1974,12,20,592,564,28,1974-12-20,536
1974,12,21,465,465,0,1974-12-21,465
1974,12,22,532,532,0,1974-12-22,532
1974,12,23,453,453,0,1974-12-23,453
1974,12,24,425,425,0,1974-12-24,425
1974,12,25,67,67,0,1974-12-25,67
1974,12,26,61,61,0,1974-12-26,61
1974,12,27,24,24,0,1974-12-27,24
1974,12,28,82,82,0,1974-12-28,82
1974,12,29,63,41,22,1974-12-29,19
1974,12,30,163,17,146,1974-12-30,-129
1974,12,31,129,0,129,1974-12-31,-129
1975,1,1,294,103,191,1975-1-1,-88
1975,1,2,151,61,90,1975-1-2,-29
1975,1,3,232,124,108,1975-1-3,16
1975,1,4,116,52,64,1975-1-4,-12
1975,1,5,112,61,51,1975-1-5,10
1975,1,6,80,51,29,1975-1-6,22
1975,1,7,110,103,7,1975-1-7,96
1975,1,8,308,308,0,1975-1-8,308
1975,1,9,267,267,0,1975-1-9,267
1975,1,10,386,335,51,1975-1-10,284
1975,1,11,338,338,0,1975-1-11,338
1975,1,12,430,430,0,1975-1-12,430
1975,1,13,382,382,0,1975-1-13,382
1975,1,14,222,222,0,1975-1-14,222
1975,1,15,214,214,0,1975-1-15,214
1975,1,16,182,182,0,1975-1-16,182
1975,1,17,179,179,0,1975-1-17,179
1975,1,18,204,204,0,1975-1-18,204
1975,1,19,240,240,0,1975-1-19,240
1975,1,20,244,244,0,1975-1-20,244
1975,1,21,57,57,0,1975-1-21,57
1975,1,22,38,38,0,1975-1-22,38
1975,1,23,9,9,0,1975-1-23,9
1975,1,24,7,0,7,1975-1-24,-7
1975,1,25,6,6,0,1975-1-25,6
1975,1,26,2,2,0,1975-1-26,2
1975,1,27,0,0,0,1975-1-27,0
1975,1,28,0,0,0,1975-1-28,0
1975,1,29,6,0,6,1975-1-29,-6
1975,1,30,0,0,0,1975-1-30,0
1975,1,31,0,0,0,1975-1-31,0
1975,2,1,0,0,0,1975-2-1,0
1975,2,2,59,0,59,1975-2-2,-59
1975,2,3,103,0,103,1975-2-3,-103
1975,2,4,68,0,68,1975-2-4,-68
1975,2,5,76,53,23,1975-2-5,30
1975,2,6,139,114,25,1975-2-6,89
1975,2,7,297,283,14,1975-2-7,269
1975,2,8,300,298,2,1975-2-8,296
1975,2,9,256,256,0,1975-2-9,256
1975,2,10,266,266,0,1975-2-10,266
1975,2,11,153,153,0,1975-2-11,153
1975,2,12,175,175,0,1975-2-12,175
1975,2,13,151,151,0,1975-2-13,151
1975,2,14,157,157,0,1975-2-14,157
1975,2,15,0,0,0,1975-2-15,0
1975,2,16,0,0,0,1975-2-16,0
1975,2,17,0,0,0,1975-2-17,0
1975,2,18,0,0,0,1975-2-18,0
1975,2,19,0,0,0,1975-2-19,0
1975,2,20,3,3,0,1975-2-20,3
1975,2,21,2,2,0,1975-2-21,2
1975,2,22,0,0,0,1975-2-22,0
1975,2,23,2,0,2,1975-2-23,-2
1975,2,24,22,2,20,1975-2-24,-18
1975,2,25,18,0,18,1975-2-25,-18
1975,2,26,0,0,0,1975-2-26,0
1975,2,27,0,0,0,1975-2-27,0
1975,2,28,0,0,0,1975-2-28,0
1975,3,1,1,1,0,1975-3-1,1
1975,3,2,59,59,0,1975-3-2,59
1975,3,3,89,89,0,1975-3-3,89
1975,3,4,56,54,2,1975-3-4,52
1975,3,5,0,0,0,1975-3-5,0
1975,3,6,12,12,0,1975-3-6,12
1975,3,7,24,24,0,1975-3-7,24
1975,3,8,24,9,15,1975-3-8,-6
1975,3,9,52,12,40,1975-3-9,-28
1975,3,10,51,11,40,1975-3-10,-29
1975,3,11,30,0,30,1975-3-11,-30
1975,3,12,59,0,59,1975-3-12,-59
1975,3,13,126,0,126,1975-3-13,-126
1975,3,14,329,0,329,1975-3-14,-329
1975,3,15,103,0,103,1975-3-15,-103
1975,3,16,207,0,207,1975-3-16,-207
1975,3,17,382,0,382,1975-3-17,-382
1975,3,18,191,0,191,1975-3-18,-191
1975,3,19,127,3,124,1975-3-19,-121
1975,3,20,53,0,53,1975-3-20,-53
1975,3,21,0,0,0,1975-3-21,0
1975,3,22,0,0,0,1975-3-22,0
1975,3,23,0,0,0,1975-3-23,0
1975,3,24,0,0,0,1975-3-24,0
1975,3,25,0,0,0,1975-3-25,0
1975,3,26,8,8,0,1975-3-26,8
1975,3,27,3,3,0,1975-3-27,3
1975,3,28,0,0,0,1975-3-28,0
1975,3,29,0,0,0,1975-3-29,0
1975,3,30,0,0,0,1975-3-30,0
1975,3,31,0,0,0,1975-3-31,0
1975,4,1,0,0,0,1975-4-1,0
1975,4,2,0,0,0,1975-4-2,0
1975,4,3,17,17,0,1975-4-3,17
1975,4,4,0,0,0,1975-4-4,0
1975,4,5,0,0,0,1975-4-5,0
1975,4,6,0,0,0,1975-4-6,0
1975,4,7,16,16,0,1975-4-7,16
1975,4,8,12,12,0,1975-4-8,12
1975,4,9,38,36,2,1975-4-9,34
1975,4,10,2,2,0,1975-4-10,2
1975,4,11,5,5,0,1975-4-11,5
1975,4,12,0,0,0,1975-4-12,0
1975,4,13,0,0,0,1975-4-13,0
1975,4,14,0,0,0,1975-4-14,0
1975,4,15,0,0,0,1975-4-15,0
1975,4,16,0,0,0,1975-4-16,0
1975,4,17,0,0,0,1975-4-17,0
1975,4,18,0,0,0,1975-4-18,0
1975,4,19,0,0,0,1975-4-19,0
1975,4,20,0,0,0,1975-4-20,0
1975,4,21,0,0,0,1975-4-21,0
1975,4,22,0,0,0,1975-4-22,0
1975,4,23,9,9,0,1975-4-23,9
1975,4,24,22,22,0,1975-4-24,22
1975,4,25,0,0,0,1975-4-25,0
1975,4,26,0,0,0,1975-4-26,0
1975,4,27,154,154,0,1975-4-27,154
1975,4,28,125,125,0,1975-4-28,125
1975,4,29,93,93,0,1975-4-29,93
1975,4,30,25,7,18,1975-4-30,-11
1975,5,1,30,6,24,1975-5-1,-18
1975,5,2,205,1,204,1975-5-2,-203
1975,5,3,331,0,331,1975-5-3,-331
1975,5,4,439,4,435,1975-5-4,-431
1975,5,5,468,6,462,1975-5-5,-456
1975,5,6,264,0,264,1975-5-6,-264
1975,5,7,60,0,60,1975-5-7,-60
1975,5,8,0,0,0,1975-5-8,0
1975,5,9,0,0,0,1975-5-9,0
1975,5,10,4,0,4,1975-5-10,-4
1975,5,11,2,0,2,1975-5-11,-2
1975,5,12,4,0,4,1975-5-12,-4
1975,5,13,0,0,0,1975-5-13,0
1975,5,14,0,0,0,1975-5-14,0
1975,5,15,0,0,0,1975-5-15,0
1975,5,16,0,0,0,1975-5-16,0
1975,5,17,0,0,0,1975-5-17,0
1975,5,18,2,2,0,1975-5-18,2
1975,5,19,0,0,0,1975-5-19,0
1975,5,20,0,0,0,1975-5-20,0
1975,5,21,0,0,0,1975-5-21,0
1975,5,22,8,0,8,1975-5-22,-8
1975,5,23,6,0,6,1975-5-23,-6
1975,5,24,0,0,0,1975-5-24,0
1975,5,25,0,0,0,1975-5-25,0
1975,5,26,0,0,0,1975-5-26,0
1975,5,27,0,0,0,1975-5-27,0
1975,5,28,1,0,1,1975-5-28,-1
1975,5,29,0,0,0,1975-5-29,0
1975,5,30,0,0,0,1975-5-30,0
1975,5,31,33,0,33,1975-5-31,-33
1975,6,1,43,0,43,1975-6-1,-43
1975,6,2,33,0,33,1975-6-2,-33
1975,6,3,1,0,1,1975-6-3,-1
1975,6,4,5,0,5,1975-6-4,-5
1975,6,5,33,17,16,1975-6-5,1
1975,6,6,2,0,2,1975-6-6,-2
1975,6,7,0,0,0,1975-6-7,0
1975,6,8,0,0,0,1975-6-8,0
1975,6,9,0,0,0,1975-6-9,0
1975,6,10,0,0,0,1975-6-10,0
1975,6,11,2,2,0,1975-6-11,2
1975,6,12,3,3,0,1975-6-12,3
1975,6,13,0,0,0,1975-6-13,0
1975,6,14,11,11,0,1975-6-14,11
1975,6,15,26,26,0,1975-6-15,26
1975,6,16,98,98,0,1975-6-16,98
1975,6,17,241,241,0,1975-6-17,241
1975,6,18,190,190,0,1975-6-18,190
1975,6,19,20,20,0,1975-6-19,20
1975,6,20,0,0,0,1975-6-20,0
1975,6,21,0,0,0,1975-6-21,0
1975,6,22,0,0,0,1975-6-22,0
1975,6,23,46,0,46,1975-6-23,-46
1975,6,24,145,117,28,1975-6-24,89
1975,6,25,256,210,46,1975-6-25,164
1975,6,26,415,313,102,1975-6-26,211
1975,6,27,388,310,78,1975-6-27,232
1975,6,28,458,303,155,1975-6-28,148
1975,6,29,478,365,113,1975-6-29,252
1975,6,30,313,313,0,1975-6-30,313
1975,7,1,369,369,0,1975-7-1,369
1975,7,2,330,330,0,1975-7-2,330
1975,7,3,328,328,0,1975-7-3,328
1975,7,4,321,321,0,1975-7-4,321
1975,7,5,430,430,0,1975-7-5,430
1975,7,6,313,309,4,1975-7-6,305
1975,7,7,58,42,16,1975-7-7,26
1975,7,8,79,75,4,1975-7-8,71
1975,7,9,69,69,0,1975-7-9,69
1975,7,10,200,58,142,1975-7-10,-84
1975,7,11,239,72,167,1975-7-11,-95
1975,7,12,329,223,106,1975-7-12,117
1975,7,13,518,421,97,1975-7-13,324
1975,7,14,870,441,429,1975-7-14,12
1975,7,15,895,467,428,1975-7-15,39
1975,7,16,515,153,362,1975-7-16,-209
1975,7,17,307,0,307,1975-7-17,-307
1975,7,18,354,0,354,1975-7-18,-354
1975,7,19,297,0,297,1975-7-19,-297
1975,7,20,312,0,312,1975-7-20,-312
1975,7,21,367,107,260,1975-7-21,-153
1975,7,22,421,135,286,1975-7-22,-151
1975,7,23,354,176,178,1975-7-23,-2
1975,7,24,347,183,164,1975-7-24,19
1975,7,25,332,171,161,1975-7-25,10
1975,7,26,242,242,0,1975-7-26,242
1975,7,27,208,208,0,1975-7-27,208
1975,7,28,303,303,0,1975-7-28,303
1975,7,29,229,229,0,1975-7-29,229
1975,7,30,482,482,0,1975-7-30,482
1975,7,31,543,543,0,1975-7-31,543
1975,8,1,590,590,0,1975-8-1,590
1975,8,2,667,667,0,1975-8-2,667
1975,8,3,1599,1599,0,1975-8-3,1599
1975,8,4,1871,1871,0,1975-8-4,1871
1975,8,5,1738,1738,0,1975-8-5,1738
1975,8,6,1755,1755,0,1975-8-6,1755
1975,8,7,2126,2126,0,1975-8-7,2126
1975,8,8,2118,2118,0,1975-8-8,2118
1975,8,9,1613,1613,0,1975-8-9,1613
1975,8,10,1954,1954,0,1975-8-10,1954
1975,8,11,1412,1405,7,1975-8-11,1398
1975,8,12,998,996,2,1975-8-12,994
1975,8,13,898,891,7,1975-8-13,884
1975,8,14,784,784,0,1975-8-14,784
1975,8,15,405,392,13,1975-8-15,379
1975,8,16,103,68,35,1975-8-16,33
1975,8,17,82,0,82,1975-8-17,-82
1975,8,18,33,0,33,1975-8-18,-33
1975,8,19,12,5,7,1975-8-19,-2
1975,8,20,94,94,0,1975-8-20,94
1975,8,21,131,85,46,1975-8-21,39
1975,8,22,35,35,0,1975-8-22,35
1975,8,23,61,61,0,1975-8-23,61
1975,8,24,0,0,0,1975-8-24,0
1975,8,25,34,0,34,1975-8-25,-34
1975,8,26,182,2,180,1975-8-26,-178
1975,8,27,179,2,177,1975-8-27,-175
1975,8,28,127,5,122,1975-8-28,-117
1975,8,29,109,0,109,1975-8-29,-109
1975,8,30,47,0,47,1975-8-30,-47
1975,8,31,4,4,0,1975-8-31,4
1975,9,1,20,20,0,1975-9-1,20
1975,9,2,59,59,0,1975-9-2,59
1975,9,3,79,79,0,1975-9-3,79
1975,9,4,183,183,0,1975-9-4,183
1975,9,5,120,120,0,1975-9-5,120
1975,9,6,270,97,173,1975-9-6,-76
1975,9,7,149,46,103,1975-9-7,-57
1975,9,8,112,4,108,1975-9-8,-104
1975,9,9,112,0,112,1975-9-9,-112
1975,9,10,105,0,105,1975-9-10,-105
1975,9,11,80,0,80,1975-9-11,-80
1975,9,12,121,0,121,1975-9-12,-121
1975,9,13,108,0,108,1975-9-13,-108
1975,9,14,99,0,99,1975-9-14,-99
1975,9,15,106,0,106,1975-9-15,-106
1975,9,16,55,3,52,1975-9-16,-49
1975,9,17,43,14,29,1975-9-17,-15
1975,9,18,45,45,0,1975-9-18,45
1975,9,19,42,42,0,1975-9-19,42
1975,9,20,89,89,0,1975-9-20,89
1975,9,21,58,57,1,1975-9-21,56
1975,9,22,34,34,0,1975-9-22,34
1975,9,23,2,2,0,1975-9-23,2
1975,9,24,0,0,0,1975-9-24,0
1975,9,25,0,0,0,1975-9-25,0
1975,9,26,0,0,0,1975-9-26,0
1975,9,27,0,0,0,1975-9-27,0
1975,9,28,5,0,5,1975-9-28,-5
1975,9,29,0,0,0,1975-9-29,0
1975,9,30,125,125,0,1975-9-30,125
1975,10,1,137,137,0,1975-10-1,137
1975,10,2,118,118,0,1975-10-2,118
1975,10,3,146,146,0,1975-10-3,146
1975,10,4,125,125,0,1975-10-4,125
1975,10,5,125,125,0,1975-10-5,125
1975,10,6,136,136,0,1975-10-6,136
1975,10,7,113,113,0,1975-10-7,113
1975,10,8,139,127,12,1975-10-8,115
1975,10,9,116,116,0,1975-10-9,116
1975,10,10,107,107,0,1975-10-10,107
1975,10,11,105,105,0,1975-10-11,105
1975,10,12,98,98,0,1975-10-12,98
1975,10,13,193,193,0,1975-10-13,193
1975,10,14,343,343,0,1975-10-14,343
1975,10,15,374,374,0,1975-10-15,374
1975,10,16,267,267,0,1975-10-16,267
1975,10,17,251,251,0,1975-10-17,251
1975,10,18,249,249,0,1975-10-18,249
1975,10,19,178,178,0,1975-10-19,178
1975,10,20,175,175,0,1975-10-20,175
1975,10,21,46,46,0,1975-10-21,46
1975,10,22,0,0,0,1975-10-22,0
1975,10,23,0,0,0,1975-10-23,0
1975,10,24,0,0,0,1975-10-24,0
1975,10,25,0,0,0,1975-10-25,0
1975,10,26,0,0,0,1975-10-26,0
1975,10,27,0,0,0,1975-10-27,0
1975,10,28,0,0,0,1975-10-28,0
1975,10,29,0,0,0,1975-10-29,0
1975,10,30,0,0,0,1975-10-30,0
1975,10,31,0,0,0,1975-10-31,0
1975,11,1,0,0,0,1975-11-1,0
1975,11,2,0,0,0,1975-11-2,0
1975,11,3,12,0,12,1975-11-3,-12
1975,11,4,186,137,49,1975-11-4,88
1975,11,5,220,167,53,1975-11-5,114
1975,11,6,224,160,64,1975-11-6,96
1975,11,7,184,127,57,1975-11-7,70
1975,11,8,182,141,41,1975-11-8,100
1975,11,9,112,112,0,1975-11-9,112
1975,11,10,138,138,0,1975-11-10,138
1975,11,11,121,103,18,1975-11-11,85
1975,11,12,111,77,34,1975-11-12,43
1975,11,13,357,96,261,1975-11-13,-165
1975,11,14,257,107,150,1975-11-14,-43
1975,11,15,355,91,264,1975-11-15,-173
1975,11,16,433,68,365,1975-11-16,-297
1975,11,17,468,38,430,1975-11-17,-392
1975,11,18,543,103,440,1975-11-18,-337
1975,11,19,653,115,538,1975-11-19,-423
1975,11,20,699,283,416,1975-11-20,-133
1975,11,21,607,225,382,1975-11-21,-157
1975,11,22,436,65,371,1975-11-22,-306
1975,11,23,312,0,312,1975-11-23,-312
1975,11,24,256,0,256,1975-11-24,-256
1975,11,25,187,0,187,1975-11-25,-187
1975,11,26,0,0,0,1975-11-26,0
1975,11,27,0,0,0,1975-11-27,0
1975,11,28,0,0,0,1975-11-28,0
1975,11,29,0,0,0,1975-11-29,0
1975,11,30,0,0,0,1975-11-30,0
1975,12,1,0,0,0,1975-12-1,0
1975,12,2,129,129,0,1975-12-2,129
1975,12,3,157,157,0,1975-12-3,157
1975,12,4,117,117,0,1975-12-4,117
1975,12,5,102,102,0,1975-12-5,102
1975,12,6,133,133,0,1975-12-6,133
1975,12,7,90,90,0,1975-12-7,90
1975,12,8,66,66,0,1975-12-8,66
1975,12,9,33,33,0,1975-12-9,33
1975,12,10,0,0,0,1975-12-10,0
1975,12,11,0,0,0,1975-12-11,0
1975,12,12,0,0,0,1975-12-12,0
1975,12,13,8,8,0,1975-12-13,8
1975,12,14,37,0,37,1975-12-14,-37
1975,12,15,34,0,34,1975-12-15,-34
1975,12,16,17,0,17,1975-12-16,-17
1975,12,17,20,0,20,1975-12-17,-20
1975,12,18,6,0,6,1975-12-18,-6
1975,12,19,6,0,6,1975-12-19,-6
1975,12,20,0,0,0,1975-12-20,0
1975,12,21,0,0,0,1975-12-21,0
1975,12,22,0,0,0,1975-12-22,0
1975,12,23,0,0,0,1975-12-23,0
1975,12,24,53,0,53,1975-12-24,-53
1975,12,25,40,0,40,1975-12-25,-40
1975,12,26,13,0,13,1975-12-26,-13
1975,12,27,0,0,0,1975-12-27,0
1975,12,28,0,0,0,1975-12-28,0
1975,12,29,0,0,0,1975-12-29,0
1975,12,30,0,0,0,1975-12-30,0
1975,12,31,0,0,0,1975-12-31,0
1976,1,1,0,0,0,1976-1-1,0
1976,1,2,0,0,0,1976-1-2,0
1976,1,3,0,0,0,1976-1-3,0
1976,1,4,0,0,0,1976-1-4,0
1976,1,5,0,0,0,1976-1-5,0
1976,1,6,0,0,0,1976-1-6,0
1976,1,7,0,0,0,1976-1-7,0
1976,1,8,0,0,0,1976-1-8,0
1976,1,9,0,0,0,1976-1-9,0
1976,1,10,0,0,0,1976-1-10,0
1976,1,11,0,0,0,1976-1-11,0
1976,1,12,184,0,184,1976-1-12,-184
1976,1,13,438,0,438,1976-1-13,-438
1976,1,14,568,0,568,1976-1-14,-568
1976,1,15,457,0,457,1976-1-15,-457
1976,1,16,369,0,369,1976-1-16,-369
1976,1,17,304,0,304,1976-1-17,-304
1976,1,18,326,0,326,1976-1-18,-326
1976,1,19,214,0,214,1976-1-19,-214
1976,1,20,257,0,257,1976-1-20,-257
1976,1,21,134,0,134,1976-1-21,-134
1976,1,22,206,0,206,1976-1-22,-206
1976,1,23,95,0,95,1976-1-23,-95
1976,1,24,0,0,0,1976-1-24,0
1976,1,25,0,0,0,1976-1-25,0
1976,1,26,0,0,0,1976-1-26,0
1976,1,27,5,0,5,1976-1-27,-5
1976,1,28,0,0,0,1976-1-28,0
1976,1,29,5,0,5,1976-1-29,-5
1976,1,30,15,0,15,1976-1-30,-15
1976,1,31,2,0,2,1976-1-31,-2
1976,2,1,0,0,0,1976-2-1,0
1976,2,2,0,0,0,1976-2-2,0
1976,2,3,0,0,0,1976-2-3,0
1976,2,4,0,0,0,1976-2-4,0
1976,2,5,0,0,0,1976-2-5,0
1976,2,6,0,0,0,1976-2-6,0
1976,2,7,0,0,0,1976-2-7,0
1976,2,8,0,0,0,1976-2-8,0
1976,2,9,0,0,0,1976-2-9,0
1976,2,10,0,0,0,1976-2-10,0
1976,2,11,0,0,0,1976-2-11,0
1976,2,12,0,0,0,1976-2-12,0
1976,2,13,74,0,74,1976-2-13,-74
1976,2,14,47,0,47,1976-2-14,-47
1976,2,15,51,1,50,1976-2-15,-49
1976,2,16,27,0,27,1976-2-16,-27
1976,2,17,28,0,28,1976-2-17,-28
1976,2,18,21,0,21,1976-2-18,-21
1976,2,19,37,0,37,1976-2-19,-37
1976,2,20,24,0,24,1976-2-20,-24
1976,2,21,18,0,18,1976-2-21,-18
1976,2,22,0,0,0,1976-2-22,0
1976,2,23,0,0,0,1976-2-23,0
1976,2,24,0,0,0,1976-2-24,0
1976,2,25,0,0,0,1976-2-25,0
1976,2,26,0,0,0,1976-2-26,0
1976,2,27,0,0,0,1976-2-27,0
1976,2,28,0,0,0,1976-2-28,0
1976,2,29,0,0,0,1976-2-29,0
1976,3,1,0,0,0,1976-3-1,0
1976,3,2,0,0,0,1976-3-2,0
1976,3,3,0,0,0,1976-3-3,0
1976,3,4,0,0,0,1976-3-4,0
1976,3,5,0,0,0,1976-3-5,0
1976,3,6,30,0,30,1976-3-6,-30
1976,3,7,38,0,38,1976-3-7,-38
1976,3,8,19,0,19,1976-3-8,-19
1976,3,9,28,0,28,1976-3-9,-28
1976,3,10,44,0,44,1976-3-10,-44
1976,3,11,39,0,39,1976-3-11,-39
1976,3,12,43,0,43,1976-3-12,-43
1976,3,13,60,0,60,1976-3-13,-60
1976,3,14,54,0,54,1976-3-14,-54
1976,3,15,13,0,13,1976-3-15,-13
1976,3,16,6,6,0,1976-3-16,6
1976,3,17,254,233,21,1976-3-17,212
1976,3,18,365,347,18,1976-3-18,329
1976,3,19,435,393,42,1976-3-19,351
1976,3,20,518,496,22,1976-3-20,474
1976,3,21,694,684,10,1976-3-21,674
1976,3,22,614,614,0,1976-3-22,614
1976,3,23,626,626,0,1976-3-23,626
1976,3,24,921,587,334,1976-3-24,253
1976,3,25,715,0,715,1976-3-25,-715
1976,3,26,823,0,823,1976-3-26,-823
1976,3,27,966,32,934,1976-3-27,-902
1976,3,28,1011,74,937,1976-3-28,-863
1976,3,29,793,54,739,1976-3-29,-685
1976,3,30,701,15,686,1976-3-30,-671
1976,3,31,615,0,615,1976-3-31,-615
1976,4,1,695,0,695,1976-4-1,-695
1976,4,2,606,0,606,1976-4-2,-606
1976,4,3,586,0,586,1976-4-3,-586
1976,4,4,581,0,581,1976-4-4,-581
1976,4,5,556,0,556,1976-4-5,-556
1976,4,6,490,0,490,1976-4-6,-490
1976,4,7,0,0,0,1976-4-7,0
1976,4,8,0,0,0,1976-4-8,0
1976,4,9,286,286,0,1976-4-9,286
1976,4,10,284,284,0,1976-4-10,284
1976,4,11,269,262,7,1976-4-11,255
1976,4,12,295,295,0,1976-4-12,295
1976,4,13,276,276,0,1976-4-13,276
1976,4,14,438,438,0,1976-4-14,438
1976,4,15,417,417,0,1976-4-15,417
1976,4,16,413,413,0,1976-4-16,413
1976,4,17,396,384,12,1976-4-17,372
1976,4,18,441,399,42,1976-4-18,357
1976,4,19,403,377,26,1976-4-19,351
1976,4,20,388,366,22,1976-4-20,344
1976,4,21,328,120,208,1976-4-21,-88
1976,4,22,352,110,242,1976-4-22,-132
1976,4,23,330,117,213,1976-4-23,-96
1976,4,24,373,130,243,1976-4-24,-113
1976,4,25,297,112,185,1976-4-25,-73
1976,4,26,408,192,216,1976-4-26,-24
1976,4,27,222,42,180,1976-4-27,-138
1976,4,28,229,29,200,1976-4-28,-171
1976,4,29,325,0,325,1976-4-29,-325
1976,4,30,605,0,605,1976-4-30,-605
1976,5,1,472,0,472,1976-5-1,-472
1976,5,2,319,0,319,1976-5-2,-319
1976,5,3,203,16,187,1976-5-3,-171
1976,5,4,7,7,0,1976-5-4,7
1976,5,5,201,201,0,1976-5-5,201
1976,5,6,156,156,0,1976-5-6,156
1976,5,7,159,157,2,1976-5-7,155
1976,5,8,142,142,0,1976-5-8,142
1976,5,9,135,135,0,1976-5-9,135
1976,5,10,131,131,0,1976-5-10,131
1976,5,11,150,150,0,1976-5-11,150
1976,5,12,152,152,0,1976-5-12,152
1976,5,13,271,9,262,1976-5-13,-253
1976,5,14,168,10,158,1976-5-14,-148
1976,5,15,174,0,174,1976-5-15,-174
1976,5,16,153,0,153,1976-5-16,-153
1976,5,17,108,2,106,1976-5-17,-104
1976,5,18,24,0,24,1976-5-18,-24
1976,5,19,22,0,22,1976-5-19,-22
1976,5,20,18,0,18,1976-5-20,-18
1976,5,21,20,0,20,1976-5-21,-20
1976,5,22,25,0,25,1976-5-22,-25
1976,5,23,7,0,7,1976-5-23,-7
1976,5,24,5,0,5,1976-5-24,-5
1976,5,25,0,0,0,1976-5-25,0
1976,5,26,5,0,5,1976-5-26,-5
1976,5,27,0,0,0,1976-5-27,0
1976,5,28,0,0,0,1976-5-28,0
1976,5,29,0,0,0,1976-5-29,0
1976,5,30,0,0,0,1976-5-30,0
1976,5,31,0,0,0,1976-5-31,0
1976,6,1,0,0,0,1976-6-1,0
1976,6,2,0,0,0,1976-6-2,0
1976,6,3,0,0,0,1976-6-3,0
1976,6,4,0,0,0,1976-6-4,0
1976,6,5,0,0,0,1976-6-5,0
1976,6,6,0,0,0,1976-6-6,0
1976,6,7,0,0,0,1976-6-7,0
1976,6,8,30,0,30,1976-6-8,-30
1976,6,9,26,0,26,1976-6-9,-26
1976,6,10,4,0,4,1976-6-10,-4
1976,6,11,0,0,0,1976-6-11,0
1976,6,12,25,0,25,1976-6-12,-25
1976,6,13,4,0,4,1976-6-13,-4
1976,6,14,40,33,7,1976-6-14,26
1976,6,15,78,75,3,1976-6-15,72
1976,6,16,105,105,0,1976-6-16,105
1976,6,17,249,249,0,1976-6-17,249
1976,6,18,257,257,0,1976-6-18,257
1976,6,19,178,178,0,1976-6-19,178
1976,6,20,101,101,0,1976-6-20,101
1976,6,21,101,101,0,1976-6-21,101
1976,6,22,126,75,51,1976-6-22,24
1976,6,23,182,59,123,1976-6-23,-64
1976,6,24,135,5,130,1976-6-24,-125
1976,6,25,107,16,91,1976-6-25,-75
1976,6,26,113,0,113,1976-6-26,-113
1976,6,27,84,0,84,1976-6-27,-84
1976,6,28,118,3,115,1976-6-28,-112
1976,6,29,104,0,104,1976-6-29,-104
1976,6,30,122,0,122,1976-6-30,-122
1976,7,1,117,0,117,1976-7-1,-117
1976,7,2,64,0,64,1976-7-2,-64
1976,7,3,12,0,12,1976-7-3,-12
1976,7,4,20,20,0,1976-7-4,20
1976,7,5,14,14,0,1976-7-5,14
1976,7,6,30,24,6,1976-7-6,18
1976,7,7,8,8,0,1976-7-7,8
1976,7,8,0,0,0,1976-7-8,0
1976,7,9,0,0,0,1976-7-9,0
1976,7,10,0,0,0,1976-7-10,0
1976,7,11,0,0,0,1976-7-11,0
1976,7,12,0,0,0,1976-7-12,0
1976,7,13,0,0,0,1976-7-13,0
1976,7,14,0,0,0,1976-7-14,0
1976,7,15,0,0,0,1976-7-15,0
1976,7,16,0,0,0,1976-7-16,0
1976,7,17,0,0,0,1976-7-17,0
1976,7,18,0,0,0,1976-7-18,0
1976,7,19,0,0,0,1976-7-19,0
1976,7,20,0,0,0,1976-7-20,0
1976,7,21,0,0,0,1976-7-21,0
1976,7,22,0,0,0,1976-7-22,0
1976,7,23,0,0,0,1976-7-23,0
1976,7,24,0,0,0,1976-7-24,0
1976,7,25,0,0,0,1976-7-25,0
1976,7,26,0,0,0,1976-7-26,0
1976,7,27,0,0,0,1976-7-27,0
1976,7,28,0,0,0,1976-7-28,0
1976,7,29,0,0,0,1976-7-29,0
1976,7,30,0,0,0,1976-7-30,0
1976,7,31,6,6,0,1976-7-31,6
1976,8,1,457,457,0,1976-8-1,457
1976,8,2,559,559,0,1976-8-2,559
1976,8,3,528,528,0,1976-8-3,528
1976,8,4,589,589,0,1976-8-4,589
1976,8,5,584,584,0,1976-8-5,584
1976,8,6,573,573,0,1976-8-6,573
1976,8,7,539,539,0,1976-8-7,539
1976,8,8,613,613,0,1976-8-8,613
1976,8,9,544,537,7,1976-8-9,530
1976,8,10,596,596,0,1976-8-10,596
1976,8,11,558,558,0,1976-8-11,558
1976,8,12,495,488,7,1976-8-12,481
1976,8,13,519,519,0,1976-8-13,519
1976,8,14,20,20,0,1976-8-14,20
1976,8,15,11,0,11,1976-8-15,-11
1976,8,16,29,0,29,1976-8-16,-29
1976,8,17,107,0,107,1976-8-17,-107
1976,8,18,218,0,218,1976-8-18,-218
1976,8,19,194,0,194,1976-8-19,-194
1976,8,20,150,0,150,1976-8-20,-150
1976,8,21,64,0,64,1976-8-21,-64
1976,8,22,79,0,79,1976-8-22,-79
1976,8,23,59,0,59,1976-8-23,-59
1976,8,24,65,0,65,1976-8-24,-65
1976,8,25,31,0,31,1976-8-25,-31
1976,8,26,14,0,14,1976-8-26,-14
1976,8,27,2,1,1,1976-8-27,0
1976,8,28,117,117,0,1976-8-28,117
1976,8,29,225,225,0,1976-8-29,225
1976,8,30,204,204,0,1976-8-30,204
1976,8,31,270,270,0,1976-8-31,270
1976,9,1,351,351,0,1976-9-1,351
1976,9,2,363,363,0,1976-9-2,363
1976,9,3,234,234,0,1976-9-3,234
1976,9,4,272,272,0,1976-9-4,272
1976,9,5,219,219,0,1976-9-5,219
1976,9,6,219,219,0,1976-9-6,219
1976,9,7,218,218,0,1976-9-7,218
1976,9,8,235,235,0,1976-9-8,235
1976,9,9,262,246,16,1976-9-9,230
1976,9,10,347,184,163,1976-9-10,21
1976,9,11,299,0,299,1976-9-11,-299
1976,9,12,199,0,199,1976-9-12,-199
1976,9,13,107,0,107,1976-9-13,-107
1976,9,14,45,0,45,1976-9-14,-45
1976,9,15,36,0,36,1976-9-15,-36
1976,9,16,18,0,18,1976-9-16,-18
1976,9,17,34,0,34,1976-9-17,-34
1976,9,18,9,0,9,1976-9-18,-9
1976,9,19,36,15,21,1976-9-19,-6
1976,9,20,0,0,0,1976-9-20,0
1976,9,21,0,0,0,1976-9-21,0
1976,9,22,0,0,0,1976-9-22,0
1976,9,23,0,0,0,1976-9-23,0
1976,9,24,0,0,0,1976-9-24,0
1976,9,25,287,176,111,1976-9-25,65
1976,9,26,223,125,98,1976-9-26,27
1976,9,27,247,139,108,1976-9-27,31
1976,9,28,296,151,145,1976-9-28,6
1976,9,29,258,141,117,1976-9-29,24
1976,9,30,265,153,112,1976-9-30,41
1976,10,1,324,203,121,1976-10-1,82
1976,10,2,317,221,96,1976-10-2,125
1976,10,3,380,246,134,1976-10-3,112
1976,10,4,277,178,99,1976-10-4,79
1976,10,5,212,128,84,1976-10-5,44
1976,10,6,260,142,118,1976-10-6,24
1976,10,7,186,106,80,1976-10-7,26
1976,10,8,0,0,0,1976-10-8,0
1976,10,9,0,0,0,1976-10-9,0
1976,10,10,0,0,0,1976-10-10,0
1976,10,11,0,0,0,1976-10-11,0
1976,10,12,117,0,117,1976-10-12,-117
1976,10,13,68,0,68,1976-10-13,-68
1976,10,14,124,0,124,1976-10-14,-124
1976,10,15,190,0,190,1976-10-15,-190
1976,10,16,223,0,223,1976-10-16,-223
1976,10,17,232,0,232,1976-10-17,-232
1976,10,18,232,0,232,1976-10-18,-232
1976,10,19,122,0,122,1976-10-19,-122
1976,10,20,111,12,99,1976-10-20,-87
1976,10,21,65,0,65,1976-10-21,-65
1976,10,22,28,21,7,1976-10-22,14
1976,10,23,279,203,76,1976-10-23,127
1976,10,24,367,273,94,1976-10-24,179
1976,10,25,359,319,40,1976-10-25,279
1976,10,26,437,426,11,1976-10-26,415
1976,10,27,352,345,7,1976-10-27,338
1976,10,28,108,107,1,1976-10-28,106
1976,10,29,174,174,0,1976-10-29,174
1976,10,30,95,94,1,1976-10-30,93
1976,10,31,1,0,1,1976-10-31,-1
1976,11,1,3,0,3,1976-11-1,-3
1976,11,2,10,0,10,1976-11-2,-10
1976,11,3,0,0,0,1976-11-3,0
1976,11,4,0,0,0,1976-11-4,0
1976,11,5,0,0,0,1976-11-5,0
1976,11,6,0,0,0,1976-11-6,0
1976,11,7,0,0,0,1976-11-7,0
1976,11,8,0,0,0,1976-11-8,0
1976,11,9,0,0,0,1976-11-9,0
1976,11,10,0,0,0,1976-11-10,0
1976,11,11,0,0,0,1976-11-11,0
1976,11,12,0,0,0,1976-11-12,0
1976,11,13,0,0,0,1976-11-13,0
1976,11,14,0,0,0,1976-11-14,0
1976,11,15,7,7,0,1976-11-15,7
1976,11,16,0,0,0,1976-11-16,0
1976,11,17,207,207,0,1976-11-17,207
1976,11,18,244,244,0,1976-11-18,244
1976,11,19,225,225,0,1976-11-19,225
1976,11,20,218,218,0,1976-11-20,218
1976,11,21,223,223,0,1976-11-21,223
1976,11,22,229,229,0,1976-11-22,229
1976,11,23,183,183,0,1976-11-23,183
1976,11,24,210,210,0,1976-11-24,210
1976,11,25,175,175,0,1976-11-25,175
1976,11,26,188,188,0,1976-11-26,188
1976,11,27,205,205,0,1976-11-27,205
1976,11,28,191,191,0,1976-11-28,191
1976,11,29,241,241,0,1976-11-29,241
1976,11,30,0,0,0,1976-11-30,0
1976,12,1,0,0,0,1976-12-1,0
1976,12,2,0,0,0,1976-12-2,0
1976,12,3,0,0,0,1976-12-3,0
1976,12,4,0,0,0,1976-12-4,0
1976,12,5,0,0,0,1976-12-5,0
1976,12,6,6,6,0,1976-12-6,6
1976,12,7,7,7,0,1976-12-7,7
1976,12,8,99,99,0,1976-12-8,99
1976,12,9,130,130,0,1976-12-9,130
1976,12,10,234,234,0,1976-12-10,234
1976,12,11,263,263,0,1976-12-11,263
1976,12,12,292,292,0,1976-12-12,292
1976,12,13,228,228,0,1976-12-13,228
1976,12,14,419,360,59,1976-12-14,301
1976,12,15,480,358,122,1976-12-15,236
1976,12,16,471,385,86,1976-12-16,299
1976,12,17,548,476,72,1976-12-17,404
1976,12,18,193,144,49,1976-12-18,95
1976,12,19,193,147,46,1976-12-19,101
1976,12,20,161,161,0,1976-12-20,161
1976,12,21,143,143,0,1976-12-21,143
1976,12,22,149,149,0,1976-12-22,149
1976,12,23,135,135,0,1976-12-23,135
1976,12,24,373,150,223,1976-12-24,-73
1976,12,25,323,140,183,1976-12-25,-43
1976,12,26,402,107,295,1976-12-26,-188
1976,12,27,223,0,223,1976-12-27,-223
1976,12,28,203,0,203,1976-12-28,-203
1976,12,29,149,2,147,1976-12-29,-145
1976,12,30,129,0,129,1976-12-30,-129
1976,12,31,133,0,133,1976-12-31,-133
1977,1,1,126,0,126,1977-1-1,-126
1977,1,2,182,42,140,1977-1-2,-98
1977,1,3,238,140,98,1977-1-3,42
1977,1,4,322,182,140,1977-1-4,42
1977,1,5,322,238,84,1977-1-5,154
1977,1,6,154,84,70,1977-1-6,14
1977,1,7,14,14,0,1977-1-7,14
1977,1,8,14,14,0,1977-1-8,14
1977,1,9,0,0,0,1977-1-9,0
1977,1,10,0,0,0,1977-1-10,0
1977,1,11,0,0,0,1977-1-11,0
1977,1,12,112,0,112,1977-1-12,-112
1977,1,13,217,0,217,1977-1-13,-217
1977,1,14,294,0,294,1977-1-14,-294
1977,1,15,224,0,224,1977-1-15,-224
1977,1,16,322,0,322,1977-1-16,-322
1977,1,17,294,14,280,1977-1-17,-266
1977,1,18,280,42,238,1977-1-18,-196
1977,1,19,196,56,140,1977-1-19,-84
1977,1,20,0,0,0,1977-1-20,0
1977,1,21,154,154,0,1977-1-21,154
1977,1,22,126,126,0,1977-1-22,126
1977,1,23,126,126,0,1977-1-23,126
1977,1,24,168,154,14,1977-1-24,140
1977,1,25,154,140,14,1977-1-25,126
1977,1,26,182,182,0,1977-1-26,182
1977,1,27,70,56,14,1977-1-27,42
1977,1,28,70,0,70,1977-1-28,-70
1977,1,29,98,0,98,1977-1-29,-98
1977,1,30,42,0,42,1977-1-30,-42
1977,1,31,98,98,0,1977-1-31,98
1977,2,1,168,168,0,1977-2-1,168
1977,2,2,154,154,0,1977-2-2,154
1977,2,3,140,126,14,1977-2-3,112
1977,2,4,84,84,0,1977-2-4,84
1977,2,5,84,28,56,1977-2-5,-28
1977,2,6,84,14,70,1977-2-6,-56
1977,2,7,112,0,112,1977-2-7,-112
1977,2,8,196,56,140,1977-2-8,-84
1977,2,9,238,0,238,1977-2-9,-238
1977,2,10,196,0,196,1977-2-10,-196
1977,2,11,224,14,210,1977-2-11,-196
1977,2,12,546,140,406,1977-2-12,-266
1977,2,13,574,252,322,1977-2-13,-70
1977,2,14,602,196,406,1977-2-14,-210
1977,2,15,490,126,364,1977-2-15,-238
1977,2,16,602,196,406,1977-2-16,-210
1977,2,17,336,28,308,1977-2-17,-280
1977,2,18,420,42,378,1977-2-18,-336
1977,2,19,112,0,112,1977-2-19,-112
1977,2,20,168,0,168,1977-2-20,-168
1977,2,21,140,0,140,1977-2-21,-140
1977,2,22,56,0,56,1977-2-22,-56
1977,2,23,70,0,70,1977-2-23,-70
1977,2,24,112,0,112,1977-2-24,-112
1977,2,25,84,0,84,1977-2-25,-84
1977,2,26,56,0,56,1977-2-26,-56
1977,2,27,0,0,0,1977-2-27,0
1977,2,28,0,0,0,1977-2-28,0
1977,3,1,0,0,0,1977-3-1,0
1977,3,2,42,42,0,1977-3-2,42
1977,3,3,112,112,0,1977-3-3,112
1977,3,4,28,28,0,1977-3-4,28
1977,3,5,56,56,0,1977-3-5,56
1977,3,6,56,56,0,1977-3-6,56
1977,3,7,28,28,0,1977-3-7,28
1977,3,8,126,126,0,1977-3-8,126
1977,3,9,126,126,0,1977-3-9,126
1977,3,10,98,98,0,1977-3-10,98
1977,3,11,70,70,0,1977-3-11,70
1977,3,12,70,70,0,1977-3-12,70
1977,3,13,28,28,0,1977-3-13,28
1977,3,14,0,0,0,1977-3-14,0
1977,3,15,0,0,0,1977-3-15,0
1977,3,16,0,0,0,1977-3-16,0
1977,3,17,28,0,28,1977-3-17,-28
1977,3,18,0,0,0,1977-3-18,0
1977,3,19,0,0,0,1977-3-19,0
1977,3,20,0,0,0,1977-3-20,0
1977,3,21,0,0,0,1977-3-21,0
1977,3,22,42,0,42,1977-3-22,-42
1977,3,23,14,0,14,1977-3-23,-14
1977,3,24,0,0,0,1977-3-24,0
1977,3,25,28,28,0,1977-3-25,28
1977,3,26,14,14,0,1977-3-26,14
1977,3,27,42,42,0,1977-3-27,42
1977,3,28,42,42,0,1977-3-28,42
1977,3,29,56,56,0,1977-3-29,56
1977,3,30,14,14,0,1977-3-30,14
1977,3,31,14,14,0,1977-3-31,14
1977,4,1,14,14,0,1977-4-1,14
1977,4,2,56,56,0,1977-4-2,56
1977,4,3,28,28,0,1977-4-3,28
1977,4,4,0,0,0,1977-4-4,0
1977,4,5,14,14,0,1977-4-5,14
1977,4,6,14,14,0,1977-4-6,14
1977,4,7,0,0,0,1977-4-7,0
1977,4,8,0,0,0,1977-4-8,0
1977,4,9,0,0,0,1977-4-9,0
1977,4,10,0,0,0,1977-4-10,0
1977,4,11,0,0,0,1977-4-11,0
1977,4,12,238,14,224,1977-4-12,-210
1977,4,13,420,0,420,1977-4-13,-420
1977,4,14,518,0,518,1977-4-14,-518
1977,4,15,392,14,378,1977-4-15,-364
1977,4,16,364,0,364,1977-4-16,-364
1977,4,17,350,0,350,1977-4-17,-350
1977,4,18,217,0,217,1977-4-18,-217
1977,4,19,154,0,154,1977-4-19,-154
1977,4,20,140,0,140,1977-4-20,-140
1977,4,21,140,0,140,1977-4-21,-140
1977,4,22,140,0,140,1977-4-22,-140
1977,4,23,140,0,140,1977-4-23,-140
1977,4,24,42,0,42,1977-4-24,-42
1977,4,25,0,0,0,1977-4-25,0
1977,4,26,126,0,126,1977-4-26,-126
1977,4,27,28,0,28,1977-4-27,-28
1977,4,28,70,0,70,1977-4-28,-70
1977,4,29,56,0,56,1977-4-29,-56
1977,4,30,56,0,56,1977-4-30,-56
1977,5,1,42,28,14,1977-5-1,14
1977,5,2,126,126,0,1977-5-2,126
1977,5,3,322,308,14,1977-5-3,294
1977,5,4,490,490,0,1977-5-4,490
1977,5,5,182,182,0,1977-5-5,182
1977,5,6,84,84,0,1977-5-6,84
1977,5,7,56,56,0,1977-5-7,56
1977,5,8,84,70,14,1977-5-8,56
1977,5,9,224,84,140,1977-5-9,-56
1977,5,10,322,168,154,1977-5-10,14
1977,5,11,350,154,196,1977-5-11,-42
1977,5,12,196,98,98,1977-5-12,0
1977,5,13,70,0,70,1977-5-13,-70
1977,5,14,98,0,98,1977-5-14,-98
1977,5,15,70,14,56,1977-5-15,-42
1977,5,16,84,0,84,1977-5-16,-84
1977,5,17,56,0,56,1977-5-17,-56
1977,5,18,28,0,28,1977-5-18,-28
1977,5,19,28,0,28,1977-5-19,-28
1977,5,20,14,0,14,1977-5-20,-14
1977,5,21,28,28,0,1977-5-21,28
1977,5,22,14,14,0,1977-5-22,14
1977,5,23,0,0,0,1977-5-23,0
1977,5,24,0,0,0,1977-5-24,0
1977,5,25,28,28,0,1977-5-25,28
1977,5,26,14,14,0,1977-5-26,14
1977,5,27,0,0,0,1977-5-27,0
1977,5,28,28,14,14,1977-5-28,0
1977,5,29,140,126,14,1977-5-29,112
1977,5,30,532,504,28,1977-5-30,476
1977,5,31,378,322,56,1977-5-31,266
1977,6,1,490,420,70,1977-6-1,350
1977,6,2,406,238,168,1977-6-2,70
1977,6,3,574,238,336,1977-6-3,-98
1977,6,4,462,84,378,1977-6-4,-294
1977,6,5,476,84,392,1977-6-5,-308
1977,6,6,686,42,644,1977-6-6,-602
1977,6,7,686,70,616,1977-6-7,-546
1977,6,8,784,168,616,1977-6-8,-448
1977,6,9,476,0,476,1977-6-9,-476
1977,6,10,476,0,476,1977-6-10,-476
1977,6,11,350,0,350,1977-6-11,-350
1977,6,12,364,0,364,1977-6-12,-364
1977,6,13,280,0,280,1977-6-13,-280
1977,6,14,378,0,378,1977-6-14,-378
1977,6,15,168,0,168,1977-6-15,-168
1977,6,16,112,0,112,1977-6-16,-112
1977,6,17,154,0,154,1977-6-17,-154
1977,6,18,238,42,196,1977-6-18,-154
1977,6,19,112,42,70,1977-6-19,-28
1977,6,20,238,28,210,1977-6-20,-182
1977,6,21,406,56,350,1977-6-21,-294
1977,6,22,378,28,350,1977-6-22,-322
1977,6,23,476,56,420,1977-6-23,-364
1977,6,24,1218,910,308,1977-6-24,602
1977,6,25,1806,1442,364,1977-6-25,1078
1977,6,26,1470,1190,280,1977-6-26,910
1977,6,27,1834,1652,182,1977-6-27,1470
1977,6,28,1204,1050,154,1977-6-28,896
1977,6,29,1148,980,168,1977-6-29,812
1977,6,30,672,602,70,1977-6-30,532
1977,7,1,644,644,0,1977-7-1,644
1977,7,2,546,546,0,1977-7-2,546
1977,7,3,588,588,0,1977-7-3,588
1977,7,4,1020.6,768.6,252,1977-7-4,516.6
1977,7,5,602,518,84,1977-7-5,434
1977,7,6,462,378,84,1977-7-6,294
1977,7,7,308,224,84,1977-7-7,140
1977,7,8,196,126,70,1977-7-8,56
1977,7,9,224,140,84,1977-7-9,56
1977,7,10,70,0,70,1977-7-10,-70
1977,7,11,84,0,84,1977-7-11,-84
1977,7,12,42,0,42,1977-7-12,-42
1977,7,13,14,0,14,1977-7-13,-14
1977,7,14,0,0,0,1977-7-14,0
1977,7,15,0,0,0,1977-7-15,0
1977,7,16,0,0,0,1977-7-16,0
1977,7,17,0,0,0,1977-7-17,0
1977,7,18,0,0,0,1977-7-18,0
1977,7,19,28,14,14,1977-7-19,0
1977,7,20,147,147,0,1977-7-20,147
1977,7,21,161,161,0,1977-7-21,161
1977,7,22,154,126,28,1977-7-22,98
1977,7,23,140,98,42,1977-7-23,56
1977,7,24,189,133,56,1977-7-24,77
1977,7,25,182,140,42,1977-7-25,98
1977,7,26,210,140,70,1977-7-26,70
1977,7,27,140,126,14,1977-7-27,112
1977,7,28,126,126,0,1977-7-28,126
1977,7,29,42,42,0,1977-7-29,42
1977,7,30,14,14,0,1977-7-30,14
1977,7,31,28,14,14,1977-7-31,0
1977,8,1,154,140,14,1977-8-1,126
1977,8,2,154,154,0,1977-8-2,154
1977,8,3,266,266,0,1977-8-3,266
1977,8,4,434,434,0,1977-8-4,434
1977,8,5,630,630,0,1977-8-5,630
1977,8,6,448,448,0,1977-8-6,448
1977,8,7,392,392,0,1977-8-7,392
1977,8,8,364,364,0,1977-8-8,364
1977,8,9,392,378,14,1977-8-9,364
1977,8,10,196,168,28,1977-8-10,140
1977,8,11,252,224,28,1977-8-11,196
1977,8,12,154,154,0,1977-8-12,154
1977,8,13,266,266,0,1977-8-13,266
1977,8,14,420,420,0,1977-8-14,420
1977,8,15,336,336,0,1977-8-15,336
1977,8,16,126,126,0,1977-8-16,126
1977,8,17,98,84,14,1977-8-17,70
1977,8,18,154,140,14,1977-8-18,126
1977,8,19,140,126,14,1977-8-19,112
1977,8,20,350,350,0,1977-8-20,350
1977,8,21,462,392,70,1977-8-21,322
1977,8,22,406,266,140,1977-8-22,126
1977,8,23,56,0,56,1977-8-23,-56
1977,8,24,70,28,42,1977-8-24,-14
1977,8,25,266,84,182,1977-8-25,-98
1977,8,26,322,98,224,1977-8-26,-126
1977,8,27,308,70,238,1977-8-27,-168
1977,8,28,140,21,119,1977-8-28,-98
1977,8,29,182,42,140,1977-8-29,-98
1977,8,30,266,28,238,1977-8-30,-210
1977,8,31,266,168,98,1977-8-31,70
1977,9,1,196,196,0,1977-9-1,196
1977,9,2,196,196,0,1977-9-2,196
1977,9,3,364,364,0,1977-9-3,364
1977,9,4,182,182,0,1977-9-4,182
1977,9,5,196,196,0,1977-9-5,196
1977,9,6,308,308,0,1977-9-6,308
1977,9,7,126,126,0,1977-9-7,126
1977,9,8,252,252,0,1977-9-8,252
1977,9,9,1470,1470,0,1977-9-9,1470
1977,9,10,1218,1218,0,1977-9-10,1218
1977,9,11,1428,1428,0,1977-9-11,1428
1977,9,12,1456,1456,0,1977-9-12,1456
1977,9,13,1386,1386,0,1977-9-13,1386
1977,9,14,1176,1176,0,1977-9-14,1176
1977,9,15,952,952,0,1977-9-15,952
1977,9,16,1092,1092,0,1977-9-16,1092
1977,9,17,1204,1190,14,1977-9-17,1176
1977,9,18,1288,1190,98,1977-9-18,1092
1977,9,19,1652,1344,308,1977-9-19,1036
1977,9,20,1708,952,756,1977-9-20,196
1977,9,21,980,364,616,1977-9-21,-252
1977,9,22,588,56,532,1977-9-22,-476
1977,9,23,518,56,462,1977-9-23,-406
1977,9,24,462,70,392,1977-9-24,-322
1977,9,25,1120,784,336,1977-9-25,448
1977,9,26,882,532,350,1977-9-26,182
1977,9,27,1064,742,322,1977-9-27,420
1977,9,28,1246,742,504,1977-9-28,238
1977,9,29,1232,714,518,1977-9-29,196
1977,9,30,630,434,196,1977-9-30,238
1977,10,1,658,462,196,1977-10-1,266
1977,10,2,658,448,210,1977-10-2,238
1977,10,3,728,504,224,1977-10-3,280
1977,10,4,742,560,182,1977-10-4,378
1977,10,5,616,490,126,1977-10-5,364
1977,10,6,1610,1400,210,1977-10-6,1190
1977,10,7,700,588,112,1977-10-7,476
1977,10,8,630,518,112,1977-10-8,406
1977,10,9,630,574,56,1977-10-9,518
1977,10,10,616,602,14,1977-10-10,588
1977,10,11,588,588,0,1977-10-11,588
1977,10,12,770,770,0,1977-10-12,770
1977,10,13,826,826,0,1977-10-13,826
1977,10,14,840,840,0,1977-10-14,840
1977,10,15,728,728,0,1977-10-15,728
1977,10,16,672,672,0,1977-10-16,672
1977,10,17,574,574,0,1977-10-17,574
1977,10,18,462,434,28,1977-10-18,406
1977,10,19,784,448,336,1977-10-19,112
1977,10,20,644,322,322,1977-10-20,0
1977,10,21,812,378,434,1977-10-21,-56
1977,10,22,518,140,378,1977-10-22,-238
1977,10,23,392,0,392,1977-10-23,-392
1977,10,24,280,70,210,1977-10-24,-140
1977,10,25,252,56,196,1977-10-25,-140
1977,10,26,336,84,252,1977-10-26,-168
1977,10,27,168,168,0,1977-10-27,168
1977,10,28,224,112,112,1977-10-28,0
1977,10,29,490,266,224,1977-10-29,42
1977,10,30,392,252,140,1977-10-30,112
1977,10,31,602,350,252,1977-10-31,98
1977,11,1,462,280,182,1977-11-1,98
1977,11,2,280,140,140,1977-11-2,0
1977,11,3,378,210,168,1977-11-3,42
1977,11,4,238,56,182,1977-11-4,-126
1977,11,5,252,168,84,1977-11-5,84
1977,11,6,224,70,154,1977-11-6,-84
1977,11,7,392,280,112,1977-11-7,168
1977,11,8,154,84,70,1977-11-8,14
1977,11,9,70,14,56,1977-11-9,-42
1977,11,10,56,28,28,1977-11-10,0
1977,11,11,182,140,42,1977-11-11,98
1977,11,12,210,168,42,1977-11-12,126
1977,11,13,210,182,28,1977-11-13,154
1977,11,14,336,238,98,1977-11-14,140
1977,11,15,182,98,84,1977-11-15,14
1977,11,16,168,84,84,1977-11-16,0
1977,11,17,560,476,84,1977-11-17,392
1977,11,18,784,658,126,1977-11-18,532
1977,11,19,686,672,14,1977-11-19,658
1977,11,20,350,350,0,1977-11-20,350
1977,11,21,238,238,0,1977-11-21,238
1977,11,22,238,238,0,1977-11-22,238
1977,11,23,196,196,0,1977-11-23,196
1977,11,24,238,238,0,1977-11-24,238
1977,11,25,154,154,0,1977-11-25,154
1977,11,26,56,56,0,1977-11-26,56
1977,11,27,56,56,0,1977-11-27,56
1977,11,28,35,35,0,1977-11-28,35
1977,11,29,126,28,98,1977-11-29,-70
1977,11,30,609,21,588,1977-11-30,-567
1977,12,1,560,14,546,1977-12-1,-532
1977,12,2,504,28,476,1977-12-2,-448
1977,12,3,658,70,588,1977-12-3,-518
1977,12,4,644,182,462,1977-12-4,-280
1977,12,5,728,154,574,1977-12-5,-420
1977,12,6,896,280,616,1977-12-6,-336
1977,12,7,1162,560,602,1977-12-7,-42
1977,12,8,1344,350,994,1977-12-8,-644
1977,12,9,1316,196,1120,1977-12-9,-924
1977,12,10,1554,350,1204,1977-12-10,-854
1977,12,11,980,140,840,1977-12-11,-700
1977,12,12,756,154,602,1977-12-12,-448
1977,12,13,378,154,224,1977-12-13,-70
1977,12,14,196,98,98,1977-12-14,0
1977,12,15,266,98,168,1977-12-15,-70
1977,12,16,294,70,224,1977-12-16,-154
1977,12,17,329,273,56,1977-12-17,217
1977,12,18,336,294,42,1977-12-18,252
1977,12,19,336,322,14,1977-12-19,308
1977,12,20,252,238,14,1977-12-20,224
1977,12,21,259,252,7,1977-12-21,245
1977,12,22,238,224,14,1977-12-22,210
1977,12,23,280,266,14,1977-12-23,252
1977,12,24,490,364,126,1977-12-24,238
1977,12,25,462,280,182,1977-12-25,98
1977,12,26,441,280,161,1977-12-26,119
1977,12,27,497,294,203,1977-12-27,91
1977,12,28,805,308,497,1977-12-28,-189
1977,12,29,1225,434,791,1977-12-29,-357
1977,12,30,966,224,742,1977-12-30,-518
1977,12,31,826,182,644,1977-12-31,-462
1978,1,1,889,371,518,1978-1-1,-147
1978,1,2,1337,791,546,1978-1-2,245
1978,1,3,1309,812,497,1978-1-3,315
1978,1,4,1526,1197,329,1978-1-4,868
1978,1,5,1190,791,399,1978-1-5,392
1978,1,6,469,98,371,1978-1-6,-273
1978,1,7,546,112,434,1978-1-7,-322
1978,1,8,196,91,105,1978-1-8,-14
1978,1,9,84,56,28,1978-1-9,28
1978,1,10,63,56,7,1978-1-10,49
1978,1,11,161,126,35,1978-1-11,91
1978,1,12,182,133,49,1978-1-12,84
1978,1,13,168,119,49,1978-1-13,70
1978,1,14,196,119,77,1978-1-14,42
1978,1,15,266,196,70,1978-1-15,126
1978,1,16,189,126,63,1978-1-16,63
1978,1,17,238,161,77,1978-1-17,84
1978,1,18,84,63,21,1978-1-18,42
1978,1,19,35,7,28,1978-1-19,-21
1978,1,20,77,63,14,1978-1-20,49
1978,1,21,245,161,84,1978-1-21,77
1978,1,22,287,119,168,1978-1-22,-49
1978,1,23,357,217,140,1978-1-23,77
1978,1,24,448,280,168,1978-1-24,112
1978,1,25,448,406,42,1978-1-25,364
1978,1,26,840,392,448,1978-1-26,-56
1978,1,27,819,308,511,1978-1-27,-203
1978,1,28,1029,420,609,1978-1-28,-189
1978,1,29,1078,455,623,1978-1-29,-168
1978,1,30,1134,483,651,1978-1-30,-168
1978,1,31,1428,539,889,1978-1-31,-350
1978,2,1,1092,539,553,1978-2-1,-14
1978,2,2,1400,763,637,1978-2-2,126
1978,2,3,1981,1155,826,1978-2-3,329
1978,2,4,1834,1155,679,1978-2-4,476
1978,2,5,2002,1379,623,1978-2-5,756
1978,2,6,1582,1183,399,1978-2-6,784
1978,2,7,2534,2177,357,1978-2-7,1820
1978,2,8,2450,2303,147,1978-2-8,2156
1978,2,9,2289,2142,147,1978-2-9,1995
1978,2,10,2499,2373,126,1978-2-10,2247
1978,2,11,2919,2800,119,1978-2-11,2681
1978,2,12,3241,3010,231,1978-2-12,2779
1978,2,13,3143,2926,217,1978-2-13,2709
1978,2,14,3248,3136,112,1978-2-14,3024
1978,2,15,3241,3206,35,1978-2-15,3171
1978,2,16,1981,1918,63,1978-2-16,1855
1978,2,17,2114,2100,14,1978-2-17,2086
1978,2,18,826,791,35,1978-2-18,756
1978,2,19,1113,1078,35,1978-2-19,1043
1978,2,20,1442,1190,252,1978-2-20,938
1978,2,21,1064,784,280,1978-2-21,504
1978,2,22,1197,728,469,1978-2-22,259
1978,2,23,1393,847,546,1978-2-23,301
1978,2,24,1302,735,567,1978-2-24,168
1978,2,25,1582,966,616,1978-2-25,350
1978,2,26,1428,840,588,1978-2-26,252
1978,2,27,1134,602,532,1978-2-27,70
1978,2,28,1211,847,364,1978-2-28,483
1978,3,1,1190,798,392,1978-3-1,406
1978,3,2,1463,1099,364,1978-3-2,735
1978,3,3,1414,1120,294,1978-3-3,826
1978,3,4,2604,2275,329,1978-3-4,1946
1978,3,5,1449,1176,273,1978-3-5,903
1978,3,6,1323,1288,35,1978-3-6,1253
1978,3,7,1568,1540,28,1978-3-7,1512
1978,3,8,1764,1722,42,1978-3-8,1680
1978,3,9,2667,1988,679,1978-3-9,1309
1978,3,10,2653,1946,707,1978-3-10,1239
1978,3,11,2618,1904,714,1978-3-11,1190
1978,3,12,2163,1477,686,1978-3-12,791
1978,3,13,1666,1008,658,1978-3-13,350
1978,3,14,1666,1113,553,1978-3-14,560
1978,3,15,1463,952,511,1978-3-15,441
1978,3,16,1435,910,525,1978-3-16,385
1978,3,17,1435,798,637,1978-3-17,161
1978,3,18,1526,875,651,1978-3-18,224
1978,3,19,1148,623,525,1978-3-19,98
1978,3,20,525,203,322,1978-3-20,-119
1978,3,21,847,392,455,1978-3-21,-63
1978,3,22,980,469,511,1978-3-22,-42
1978,3,23,1043,455,588,1978-3-23,-133
1978,3,24,770,392,378,1978-3-24,14
1978,3,25,623,315,308,1978-3-25,7
1978,3,26,238,147,91,1978-3-26,56
1978,3,27,259,49,210,1978-3-27,-161
1978,3,28,392,35,357,1978-3-28,-322
1978,3,29,427,63,364,1978-3-29,-301
1978,3,30,455,133,322,1978-3-30,-189
1978,3,31,357,98,259,1978-3-31,-161
1978,4,1,819,616,203,1978-4-1,413
1978,4,2,1029,903,126,1978-4-2,777
1978,4,3,1113,1015,98,1978-4-3,917
1978,4,4,1106,966,140,1978-4-4,826
1978,4,5,1638,1386,252,1978-4-5,1134
1978,4,6,1456,1204,252,1978-4-6,952
1978,4,7,1442,1120,322,1978-4-7,798
1978,4,8,1750,1169,581,1978-4-8,588
1978,4,9,2219,1918,301,1978-4-9,1617
1978,4,10,1148,910,238,1978-4-10,672
1978,4,11,1540,1120,420,1978-4-11,700
1978,4,12,1225,987,238,1978-4-12,749
1978,4,13,3075.8,2613.8,462,1978-4-13,2151.8
1978,4,14,793.8,464.8,329,1978-4-14,135.8
1978,4,15,1094.8,870.8,224,1978-4-15,646.8
1978,4,16,973,756,217,1978-4-16,539
1978,4,17,889,644,245,1978-4-17,399
1978,4,18,1239,784,455,1978-4-18,329
1978,4,19,1225,742,483,1978-4-19,259
1978,4,20,1176,763,413,1978-4-20,350
1978,4,21,1414,938,476,1978-4-21,462
1978,4,22,1260,980,280,1978-4-22,700
1978,4,23,1526,1302,224,1978-4-23,1078
1978,4,24,959,749,210,1978-4-24,539
1978,4,25,2037,1799,238,1978-4-25,1561
1978,4,26,1820,1673,147,1978-4-26,1526
1978,4,27,2688,2555,133,1978-4-27,2422
1978,4,28,2562,2541,21,1978-4-28,2520
1978,4,29,2478,2471,7,1978-4-29,2464
1978,4,30,1925,1862,63,1978-4-30,1799
1978,5,1,1666,1400,266,1978-5-1,1134
1978,5,2,2975,2233,742,1978-5-2,1491
1978,5,3,2723,2058,665,1978-5-3,1393
1978,5,4,1841,1505,336,1978-5-4,1169
1978,5,5,1988,1778,210,1978-5-5,1568
1978,5,6,1890,1666,224,1978-5-6,1442
1978,5,7,1365,1253,112,1978-5-7,1141
1978,5,8,616,476,140,1978-5-8,336
1978,5,9,511,287,224,1978-5-9,63
1978,5,10,644,322,322,1978-5-10,0
1978,5,11,735,329,406,1978-5-11,-77
1978,5,12,917,525,392,1978-5-12,133
1978,5,13,1442,931,511,1978-5-13,420
1978,5,14,1148,672,476,1978-5-14,196
1978,5,15,1064,700,364,1978-5-15,336
1978,5,16,1043,665,378,1978-5-16,287
1978,5,17,1092,455,637,1978-5-17,-182
1978,5,18,917,434,483,1978-5-18,-49
1978,5,19,805,294,511,1978-5-19,-217
1978,5,20,751.8,240.8,511,1978-5-20,-270.2
1978,5,21,777,462,315,1978-5-21,147
1978,5,22,1715,1463,252,1978-5-22,1211
1978,5,23,1512,1344,168,1978-5-23,1176
1978,5,24,1372,1253,119,1978-5-24,1134
1978,5,25,1351,1288,63,1978-5-25,1225
1978,5,26,1659,1582,77,1978-5-26,1505
1978,5,27,1631,1554,77,1978-5-27,1477
1978,5,28,1414,1302,112,1978-5-28,1190
1978,5,29,1477,1260,217,1978-5-29,1043
1978,5,30,1596,1344,252,1978-5-30,1092
1978,5,31,1113,875,238,1978-5-31,637
1978,6,1,1099,756,343,1978-6-1,413
1978,6,2,1267,1008,259,1978-6-2,749
1978,6,3,732.2,557.2,175,1978-6-3,382.2
1978,6,4,427,266,161,1978-6-4,105
1978,6,5,343,189,154,1978-6-5,35
1978,6,6,266,77,189,1978-6-6,-112
1978,6,7,301,21,280,1978-6-7,-259
1978,6,8,280,35,245,1978-6-8,-210
1978,6,9,147,105,42,1978-6-9,63
1978,6,10,133,98,35,1978-6-10,63
1978,6,11,301,245,56,1978-6-11,189
1978,6,12,420,364,56,1978-6-12,308
1978,6,13,455,413,42,1978-6-13,371
1978,6,14,392,371,21,1978-6-14,350
1978,6,15,952,749,203,1978-6-15,546
1978,6,16,917,658,259,1978-6-16,399
1978,6,17,854,630,224,1978-6-17,406
1978,6,18,1309,987,322,1978-6-18,665
1978,6,19,1253,1148,105,1978-6-19,1043
1978,6,20,2443,1533,910,1978-6-20,623
1978,6,21,3052,1988,1064,1978-6-21,924
1978,6,22,2975,2002,973,1978-6-22,1029
1978,6,23,3045,2009,1036,1978-6-23,973
1978,6,24,2646,1505,1141,1978-6-24,364
1978,6,25,1995,931,1064,1978-6-25,-133
1978,6,26,2247,1253,994,1978-6-26,259
1978,6,27,1568,1008,560,1978-6-27,448
1978,6,28,1183,679,504,1978-6-28,175
1978,6,29,1141,560,581,1978-6-29,-21
1978,6,30,1134,735,399,1978-6-30,336
1978,7,1,1043,721,322,1978-7-1,399
1978,7,2,658,413,245,1978-7-2,168
1978,7,3,441,406,35,1978-7-3,371
1978,7,4,415.8,373.8,42,1978-7-4,331.8
1978,7,5,532,350,182,1978-7-5,168
1978,7,6,630,343,287,1978-7-6,56
1978,7,7,623,238,385,1978-7-7,-147
1978,7,8,1568,966,602,1978-7-8,364
1978,7,9,1778,1225,553,1978-7-9,672
1978,7,10,2058,1701,357,1978-7-10,1344
1978,7,11,2555,2079,476,1978-7-11,1603
1978,7,12,1918,1575,343,1978-7-12,1232
1978,7,13,1932,1652,280,1978-7-13,1372
1978,7,14,1659,1386,273,1978-7-14,1113
1978,7,15,1533,1344,189,1978-7-15,1155
1978,7,16,1421,1330,91,1978-7-16,1239
1978,7,17,1239,1162,77,1978-7-17,1085
1978,7,18,1064,980,84,1978-7-18,896
1978,7,19,994,889,105,1978-7-19,784
1978,7,20,854,756,98,1978-7-20,658
1978,7,21,462,224,238,1978-7-21,-14
1978,7,22,182,126,56,1978-7-22,70
1978,7,23,184.8,142.8,42,1978-7-23,100.8
1978,7,24,42,35,7,1978-7-24,28
1978,7,25,49,28,21,1978-7-25,7
1978,7,26,65.8,58.8,7,1978-7-26,51.8
1978,7,27,217,210,7,1978-7-27,203
1978,7,28,203,189,14,1978-7-28,175
1978,7,29,308,217,91,1978-7-29,126
1978,7,30,287,189,98,1978-7-30,91
1978,7,31,315,203,112,1978-7-31,91
1978,8,1,259,175,84,1978-8-1,91
1978,8,2,315,175,140,1978-8-2,35
1978,8,3,294,147,147,1978-8-3,0
1978,8,4,399,133,266,1978-8-4,-133
1978,8,5,420,119,301,1978-8-5,-182
1978,8,6,448,126,322,1978-8-6,-196
1978,8,7,695.8,42,653.8,1978-8-7,-611.8
1978,8,8,891.8,65.8,826,1978-8-8,-760.2
1978,8,9,742,105,637,1978-8-9,-532
1978,8,10,518,105,413,1978-8-10,-308
1978,8,11,457.8,100.8,357,1978-8-11,-256.2
1978,8,12,597.8,100.8,497,1978-8-12,-396.2
1978,8,13,1192.8,534.8,658,1978-8-13,-123.2
1978,8,14,602,252,350,1978-8-14,-98
1978,8,15,651,196,455,1978-8-15,-259
1978,8,16,553,175,378,1978-8-16,-203
1978,8,17,469,217,252,1978-8-17,-35
1978,8,18,567,273,294,1978-8-18,-21
1978,8,19,434,168,266,1978-8-19,-98
1978,8,20,439.6,170.8,268.8,1978-8-20,-98
1978,8,21,257.6,16.8,240.8,1978-8-21,-224
1978,8,22,329,56,273,1978-8-22,-217
1978,8,23,317.8,28,289.8,1978-8-23,-261.8
1978,8,24,308,21,287,1978-8-24,-266
1978,8,25,371,42,329,1978-8-25,-287
1978,8,26,345.8,140,205.8,1978-8-26,-65.8
1978,8,27,289.8,240.8,49,1978-8-27,191.8
1978,8,28,156.8,84,72.8,1978-8-28,11.2
1978,8,29,770,623,147,1978-8-29,476
1978,8,30,1015,749,266,1978-8-30,483
1978,8,31,1337,917,420,1978-8-31,497
1978,9,1,1713.6,1069.6,644,1978-9-1,425.6
1978,9,2,2177,1295,882,1978-9-2,413
1978,9,3,2373,1057,1316,1978-9-3,-259
1978,9,4,2317,952,1365,1978-9-4,-413
1978,9,5,2345,1036,1309,1978-9-5,-273
1978,9,6,2821,1148,1673,1978-9-6,-525
1978,9,7,2443,1008,1435,1978-9-7,-427
1978,9,8,1974,987,987,1978-9-8,0
1978,9,9,1995,1078,917,1978-9-9,161
1978,9,10,1491,784,707,1978-9-10,77
1978,9,11,1372,987,385,1978-9-11,602
1978,9,12,1351,1309,42,1978-9-12,1267
1978,9,13,1743,1617,126,1978-9-13,1491
1978,9,14,1876,1750,126,1978-9-14,1624
1978,9,15,2294.6,2023,271.6,1978-9-15,1751.4
1978,9,16,2275,1995,280,1978-9-16,1715
1978,9,17,2436,2058,378,1978-9-17,1680
1978,9,18,3031,2639,392,1978-9-18,2247
1978,9,19,2961,2709,252,1978-9-19,2457
1978,9,20,2989,2597,392,1978-9-20,2205
1978,9,21,1932,1512,420,1978-9-21,1092
1978,9,22,1974,1533,441,1978-9-22,1092
1978,9,23,2513,2044,469,1978-9-23,1575
1978,9,24,2317,1750,567,1978-9-24,1183
1978,9,25,1799,1078,721,1978-9-25,357
1978,9,26,1386,707,679,1978-9-26,28
1978,9,27,1022,672,350,1978-9-27,322
1978,9,28,1071,665,406,1978-9-28,259
1978,9,29,1099,595,504,1978-9-29,91
1978,9,30,793.8,462,331.8,1978-9-30,130.2
1978,10,1,749,378,371,1978-10-1,7
1978,10,2,938,343,595,1978-10-2,-252
1978,10,3,567,224,343,1978-10-3,-119
1978,10,4,784,364,420,1978-10-4,-56
1978,10,5,581,301,280,1978-10-5,21
1978,10,6,1092,574,518,1978-10-6,56
1978,10,7,1099,259,840,1978-10-7,-581
1978,10,8,1253,217,1036,1978-10-8,-819
1978,10,9,1547,231,1316,1978-10-9,-1085
1978,10,10,2261,581,1680,1978-10-10,-1099
1978,10,11,2128,581,1547,1978-10-11,-966
1978,10,12,1799,427,1372,1978-10-12,-945
1978,10,13,2135,707,1428,1978-10-13,-721
1978,10,14,1953,707,1246,1978-10-14,-539
1978,10,15,1918,924,994,1978-10-15,-70
1978,10,16,1995,980,1015,1978-10-16,-35
1978,10,17,2046.8,1073.8,973,1978-10-17,100.8
1978,10,18,2646,1456,1190,1978-10-18,266
1978,10,19,2366,1631,735,1978-10-19,896
1978,10,20,1736,1127,609,1978-10-20,518
1978,10,21,1519,945,574,1978-10-21,371
1978,10,22,1421,973,448,1978-10-22,525
1978,10,23,1120,686,434,1978-10-23,252
1978,10,24,1239,749,490,1978-10-24,259
1978,10,25,1288,714,574,1978-10-25,140
1978,10,26,1122.8,588,534.8,1978-10-26,53.2
1978,10,27,1337,686,651,1978-10-27,35
1978,10,28,1141,504,637,1978-10-28,-133
1978,10,29,1526,532,994,1978-10-29,-462
1978,10,30,987,259,728,1978-10-30,-469
1978,10,31,828.8,114.8,714,1978-10-31,-599.2
1978,11,1,925.4,155.4,770,1978-11-1,-614.6
1978,11,2,1239,203,1036,1978-11-2,-833
1978,11,3,1834,462,1372,1978-11-3,-910
1978,11,4,2506,756,1750,1978-11-4,-994
1978,11,5,2366,805,1561,1978-11-5,-756
1978,11,6,2093,672,1421,1978-11-6,-749
1978,11,7,1925,588,1337,1978-11-7,-749
1978,11,8,2002,679,1323,1978-11-8,-644
1978,11,9,2212,840,1372,1978-11-9,-532
1978,11,10,2102.8,968.8,1134,1978-11-10,-165.2
1978,11,11,2163,910,1253,1978-11-11,-343
1978,11,12,1939,966,973,1978-11-12,-7
1978,11,13,1484,980,504,1978-11-13,476
1978,11,14,1297.8,1052.8,245,1978-11-14,807.8
1978,11,15,952,525,427,1978-11-15,98
1978,11,16,842.8,224,618.8,1978-11-16,-394.8
1978,11,17,1120,224,896,1978-11-17,-672
1978,11,18,1302,434,868,1978-11-18,-434
1978,11,19,763,273,490,1978-11-19,-217
1978,11,20,651,189,462,1978-11-20,-273
1978,11,21,645.4,187.6,457.8,1978-11-21,-270.2
1978,11,22,652.4,322,330.4,1978-11-22,-8.4
1978,11,23,691.6,128.8,562.8,1978-11-23,-434
1978,11,24,474.6,170.8,303.8,1978-11-24,-133
1978,11,25,833,560,273,1978-11-25,287
1978,11,26,1176,917,259,1978-11-26,658
1978,11,27,1134,875,259,1978-11-27,616
1978,11,28,1582,1162,420,1978-11-28,742
1978,11,29,2359,1708,651,1978-11-29,1057
1978,11,30,1813,1330,483,1978-11-30,847
1978,12,1,1505,672,833,1978-12-1,-161
1978,12,2,1661.8,770,891.8,1978-12-2,-121.8
1978,12,3,1659,693,966,1978-12-3,-273
1978,12,4,1743,511,1232,1978-12-4,-721
1978,12,5,1771,553,1218,1978-12-5,-665
1978,12,6,1729,560,1169,1978-12-6,-609
1978,12,7,2436,567,1869,1978-12-7,-1302
1978,12,8,3556,1036,2520,1978-12-8,-1484
1978,12,9,3129,1099,2030,1978-12-9,-931
1978,12,10,3766,1470,2296,1978-12-10,-826
1978,12,11,4802,1729,3073,1978-12-11,-1344
1978,12,12,5292,1673,3619,1978-12-12,-1946
1978,12,13,4732,1232,3500,1978-12-13,-2268
1978,12,14,3108,686,2422,1978-12-14,-1736
1978,12,15,3264.8,1106,2158.8,1978-12-15,-1052.8
1978,12,16,3579.8,1402.8,2177,1978-12-16,-774.2
1978,12,17,2632,1330,1302,1978-12-17,28
1978,12,18,2520,1512,1008,1978-12-18,504
1978,12,19,1680,1400,280,1978-12-19,1120
1978,12,20,1456,1204,252,1978-12-20,952
1978,12,21,1447.6,1174.6,273,1978-12-21,901.6
1978,12,22,1108.8,910,198.8,1978-12-22,711.2
1978,12,23,805,602,203,1978-12-23,399
1978,12,24,1330,805,525,1978-12-24,280
1978,12,25,1274,672,602,1978-12-25,70
1978,12,26,1288,658,630,1978-12-26,28
1978,12,27,1218,546,672,1978-12-27,-126
1978,12,28,1407,224,1183,1978-12-28,-959
1978,12,29,1680,329,1351,1978-12-29,-1022
1978,12,30,2310,462,1848,1978-12-30,-1386
1978,12,31,2261,560,1701,1978-12-31,-1141
1979,1,1,2716,658,2058,1979-1-1,-1400
1979,1,2,2681,896,1785,1979-1-2,-889
1979,1,3,3703,868,2835,1979-1-3,-1967
1979,1,4,3122,686,2436,1979-1-4,-1750
1979,1,5,2709,791,1918,1979-1-5,-1127
1979,1,6,2513,917,1596,1979-1-6,-679
1979,1,7,2604,1113,1491,1979-1-7,-378
1979,1,8,1876,1169,707,1979-1-8,462
1979,1,9,2513,1743,770,1979-1-9,973
1979,1,10,2422,1785,637,1979-1-10,1148
1979,1,11,2499,1736,763,1979-1-11,973
1979,1,12,2415,1736,679,1979-1-12,1057
1979,1,13,2506,1505,1001,1979-1-13,504
1979,1,14,2704.8,1428,1276.8,1979-1-14,151.2
1979,1,15,3213,1197,2016,1979-1-15,-819
1979,1,16,2464,1218,1246,1979-1-16,-28
1979,1,17,2625,1211,1414,1979-1-17,-203
1979,1,18,2394,1176,1218,1979-1-18,-42
1979,1,19,2408,1036,1372,1979-1-19,-336
1979,1,20,2858.8,1570.8,1288,1979-1-20,282.8
1979,1,21,3108,1813,1295,1979-1-21,518
1979,1,22,3031,1617,1414,1979-1-22,203
1979,1,23,3136,1680,1456,1979-1-23,224
1979,1,24,3192,1498,1694,1979-1-24,-196
1979,1,25,2996,1309,1687,1979-1-25,-378
1979,1,26,2648.8,1281,1367.8,1979-1-26,-86.8
1979,1,27,2989,1400,1589,1979-1-27,-189
1979,1,28,3045,1575,1470,1979-1-28,105
1979,1,29,2800,1421,1379,1979-1-29,42
1979,1,30,1827,952,875,1979-1-30,77
1979,1,31,1610,658,952,1979-1-31,-294
1979,2,1,1624,651,973,1979-2-1,-322
1979,2,2,1589,609,980,1979-2-2,-371
1979,2,3,2030,742,1288,1979-2-3,-546
1979,2,4,1741.6,663.6,1078,1979-2-4,-414.4
1979,2,5,1764,665,1099,1979-2-5,-434
1979,2,6,2240,840,1400,1979-2-6,-560
1979,2,7,2030,784,1246,1979-2-7,-462
1979,2,8,1680,686,994,1979-2-8,-308
1979,2,9,1570.8,625.8,945,1979-2-9,-319.2
1979,2,10,1715,798,917,1979-2-10,-119
1979,2,11,1862,1001,861,1979-2-11,140
1979,2,12,2464,1645,819,1979-2-12,826
1979,2,13,2707.6,1953,754.6,1979-2-13,1198.4
1979,2,14,3724,2842,882,1979-2-14,1960
1979,2,15,2289,1484,805,1979-2-15,679
1979,2,16,1652,1232,420,1979-2-16,812
1979,2,17,2807,2352,455,1979-2-17,1897
1979,2,18,3402,2779,623,1979-2-18,2156
1979,2,19,4067,3283,784,1979-2-19,2499
1979,2,20,3535,2975,560,1979-2-20,2415
1979,2,21,3192,2744,448,1979-2-21,2296
1979,2,22,2835,2352,483,1979-2-22,1869
1979,2,23,2046.8,1465.8,581,1979-2-23,884.8
1979,2,24,2023,1400,623,1979-2-24,777
1979,2,25,1638,889,749,1979-2-25,140
1979,2,26,1316,231,1085,1979-2-26,-854
1979,2,27,1505,343,1162,1979-2-27,-819
1979,2,28,1036,203,833,1979-2-28,-630
1979,3,1,1078,343,735,1979-3-1,-392
1979,3,2,1274,532,742,1979-3-2,-210
1979,3,3,1386,448,938,1979-3-3,-490
1979,3,4,1239,483,756,1979-3-4,-273
1979,3,5,945,567,378,1979-3-5,189
1979,3,6,1064,413,651,1979-3-6,-238
1979,3,7,1309,553,756,1979-3-7,-203
1979,3,8,1414,588,826,1979-3-8,-238
1979,3,9,1526,987,539,1979-3-9,448
1979,3,10,1491,987,504,1979-3-10,483
1979,3,11,1211,798,413,1979-3-11,385
1979,3,12,1421,1169,252,1979-3-12,917
1979,3,13,1162,910,252,1979-3-13,658
1979,3,14,1302,910,392,1979-3-14,518
1979,3,15,1358,602,756,1979-3-15,-154
1979,3,16,1680,728,952,1979-3-16,-224
1979,3,17,1598.8,562.8,1036,1979-3-17,-473.2
1979,3,18,1610,700,910,1979-3-18,-210
1979,3,19,1482.6,726.6,756,1979-3-19,-29.4
1979,3,20,1514.8,618.8,896,1979-3-20,-277.2
1979,3,21,2255.4,1318.8,936.6,1979-3-21,382.2
1979,3,22,2276.4,1408.4,868,1979-3-22,540.4
1979,3,23,2091.6,1339.8,751.8,1979-3-23,588
1979,3,24,1897,1255.8,641.2,1979-3-24,614.6
1979,3,25,2240,1456,784,1979-3-25,672
1979,3,26,1631,1162,469,1979-3-26,693
1979,3,27,1687,728,959,1979-3-27,-231
1979,3,28,2086,770,1316,1979-3-28,-546
1979,3,29,1804.6,569.8,1234.8,1979-3-29,-665
1979,3,30,2056.6,497,1559.6,1979-3-30,-1062.6
1979,3,31,1939,455,1484,1979-3-31,-1029
1979,4,1,2247,280,1967,1979-4-1,-1687
1979,4,2,2051,77,1974,1979-4-2,-1897
1979,4,3,1659,49,1610,1979-4-3,-1561
1979,4,4,1594.6,51.8,1542.8,1979-4-4,-1491
1979,4,5,1575,70,1505,1979-4-5,-1435
1979,4,6,1743,161,1582,1979-4-6,-1421
1979,4,7,1631,189,1442,1979-4-7,-1253
1979,4,8,1337,203,1134,1979-4-8,-931
1979,4,9,1407,1316,91,1979-4-9,1225
1979,4,10,1330,1218,112,1979-4-10,1106
1979,4,11,1682.8,1542.8,140,1979-4-11,1402.8
1979,4,12,1822.8,1715,107.8,1979-4-12,1607.2
1979,4,13,1743,1477,266,1979-4-13,1211
1979,4,14,1792,1456,336,1979-4-14,1120
1979,4,15,1458.8,1206.8,252,1979-4-15,954.8
1979,4,16,1792,1561,231,1979-4-16,1330
1979,4,17,1848,1589,259,1979-4-17,1330
1979,4,18,1535.8,1274,261.8,1979-4-18,1012.2
1979,4,19,1218,945,273,1979-4-19,672
1979,4,20,1309,1113,196,1979-4-20,917
1979,4,21,1234.8,1150.8,84,1979-4-21,1066.8
1979,4,22,1864.8,1696.8,168,1979-4-22,1528.8
1979,4,23,1661.8,1113,548.8,1979-4-23,564.2
1979,4,24,1780.8,1288,492.8,1979-4-24,795.2
1979,4,25,2077.6,1596,481.6,1979-4-25,1114.4
1979,4,26,2928.8,2450,478.8,1979-4-26,1971.2
1979,4,27,2877,2324,553,1979-4-27,1771
1979,4,28,2814,2415,399,1979-4-28,2016
1979,4,29,2121,1848,273,1979-4-29,1575
1979,4,30,2576,2121,455,1979-4-30,1666
1979,5,1,2422,1995,427,1979-5-1,1568
1979,5,2,2177,1792,385,1979-5-2,1407
1979,5,3,1850.8,1493.8,357,1979-5-3,1136.8
1979,5,4,1712.2,1317.4,394.8,1979-5-4,922.6
1979,5,5,1591.8,1269.8,322,1979-5-5,947.8
1979,5,6,1974,1792,182,1979-5-6,1610
1979,5,7,2443,1995,448,1979-5-7,1547
1979,5,8,2884,2198,686,1979-5-8,1512
1979,5,9,1995,1596,399,1979-5-9,1197
1979,5,10,1848,1449,399,1979-5-10,1050
1979,5,11,1960,1673,287,1979-5-11,1386
1979,5,12,2037,1806,231,1979-5-12,1575
1979,5,13,2298.8,2053.8,245,1979-5-13,1808.8
1979,5,14,2849,2317,532,1979-5-14,1785
1979,5,15,3220,2506,714,1979-5-15,1792
1979,5,16,2261,1652,609,1979-5-16,1043
1979,5,17,1867.6,1122.8,744.8,1979-5-17,378
1979,5,18,1437.8,1113,324.8,1979-5-18,788.2
1979,5,19,1036,637,399,1979-5-19,238
1979,5,20,924,658,266,1979-5-20,392
1979,5,21,1029,644,385,1979-5-21,259
1979,5,22,826,469,357,1979-5-22,112
1979,5,23,1024.8,672,352.8,1979-5-23,319.2
1979,5,24,868,490,378,1979-5-24,112
1979,5,25,693,469,224,1979-5-25,245
1979,5,26,749,469,280,1979-5-26,189
1979,5,27,665,322,343,1979-5-27,-21
1979,5,28,763,546,217,1979-5-28,329
1979,5,29,784,658,126,1979-5-29,532
1979,5,30,1120,1043,77,1979-5-30,966
1979,5,31,2667,2163,504,1979-5-31,1659
1979,6,1,3507,2877,630,1979-6-1,2247
1979,6,2,3556,2835,721,1979-6-2,2114
1979,6,3,4193,3080,1113,1979-6-3,1967
1979,6,4,4312,3227,1085,1979-6-4,2142
1979,6,5,3640,2541,1099,1979-6-5,1442
1979,6,6,3927,2793,1134,1979-6-6,1659
1979,6,7,4151,2667,1484,1979-6-7,1183
1979,6,8,4333,2548,1785,1979-6-8,763
1979,6,9,5210.8,3089.8,2121,1979-6-9,968.8
1979,6,10,4753,2618,2135,1979-6-10,483
1979,6,11,4692.8,2604,2088.8,1979-6-11,515.2
1979,6,12,3962,2128,1834,1979-6-12,294
1979,6,13,3355.8,2039.8,1316,1979-6-13,723.8
1979,6,14,2856,2037,819,1979-6-14,1218
1979,6,15,1960,1225,735,1979-6-15,490
1979,6,16,1925,1274,651,1979-6-16,623
1979,6,17,1897,1106,791,1979-6-17,315
1979,6,18,2079,1442,637,1979-6-18,805
1979,6,19,910,616,294,1979-6-19,322
1979,6,20,1066.8,448,618.8,1979-6-20,-170.8
1979,6,21,1080.8,378,702.8,1979-6-21,-324.8
1979,6,22,866.6,226.8,639.8,1979-6-22,-413
1979,6,23,931,273,658,1979-6-23,-385
1979,6,24,800.8,205.8,595,1979-6-24,-389.2
1979,6,25,1134,595,539,1979-6-25,56
1979,6,26,1146.6,630,516.6,1979-6-26,113.4
1979,6,27,884.8,511,373.8,1979-6-27,137.2
1979,6,28,1261.4,681.8,579.6,1979-6-28,102.2
1979,6,29,1888.6,1204,684.6,1979-6-29,519.4
1979,6,30,2165.8,1512,653.8,1979-6-30,858.2
1979,7,1,2737,1757,980,1979-7-1,777
1979,7,2,3038,2135,903,1979-7-2,1232
1979,7,3,3136,2240,896,1979-7-3,1344
1979,7,4,2667,1792,875,1979-7-4,917
1979,7,5,2669.8,1794.8,875,1979-7-5,919.8
1979,7,6,2786,1946,840,1979-7-6,1106
1979,7,7,3117.8,1850.8,1267,1979-7-7,583.8
1979,7,8,2478,1631,847,1979-7-8,784
1979,7,9,2331,1519,812,1979-7-9,707
1979,7,10,2471,1589,882,1979-7-10,707
1979,7,11,1535.8,1283.8,252,1979-7-11,1031.8
1979,7,12,1519,1281,238,1979-7-12,1043
1979,7,13,1314.6,959,355.6,1979-7-13,603.4
1979,7,14,1176,784,392,1979-7-14,392
1979,7,15,1317.4,770,547.4,1979-7-15,222.6
1979,7,16,968.8,392,576.8,1979-7-16,-184.8
1979,7,17,1073.8,497,576.8,1979-7-17,-79.8
1979,7,18,805,434,371,1979-7-18,63
1979,7,19,999.6,478.8,520.8,1979-7-19,-42
1979,7,20,1260,798,462,1979-7-20,336
1979,7,21,1764,1127,637,1979-7-21,490
1979,7,22,1771,1330,441,1979-7-22,889
1979,7,23,1785,1302,483,1979-7-23,819
1979,7,24,1043,609,434,1979-7-24,175
1979,7,25,1484,686,798,1979-7-25,-112
1979,7,26,1568,749,819,1979-7-26,-70
1979,7,27,1141,504,637,1979-7-27,-133
1979,7,28,1246,434,812,1979-7-28,-378
1979,7,29,1799,609,1190,1979-7-29,-581
1979,7,30,1358,546,812,1979-7-30,-266
1979,7,31,1302,560,742,1979-7-31,-182
1979,8,1,826,392,434,1979-8-1,-42
1979,8,2,714,413,301,1979-8-2,112
1979,8,3,847,595,252,1979-8-3,343
1979,8,4,695.8,436.8,259,1979-8-4,177.8
1979,8,5,532,189,343,1979-8-5,-154
1979,8,6,707,322,385,1979-8-6,-63
1979,8,7,1505,1106,399,1979-8-7,707
1979,8,8,1393,1134,259,1979-8-8,875
1979,8,9,1554,1253,301,1979-8-9,952
1979,8,10,1129.8,875,254.8,1979-8-10,620.2
1979,8,11,1113,966,147,1979-8-11,819
1979,8,12,980,854,126,1979-8-12,728
1979,8,13,812,693,119,1979-8-13,574
1979,8,14,1526,560,966,1979-8-14,-406
1979,8,15,1393,455,938,1979-8-15,-483
1979,8,16,1589,525,1064,1979-8-16,-539
1979,8,17,1687,469,1218,1979-8-17,-749
1979,8,18,1519,560,959,1979-8-18,-399
1979,8,19,2450,1106,1344,1979-8-19,-238
1979,8,20,3626,2303,1323,1979-8-20,980
1979,8,21,3572.8,2072,1500.8,1979-8-21,571.2
1979,8,22,4319,2261,2058,1979-8-22,203
1979,8,23,3953.6,1729,2224.6,1979-8-23,-495.6
1979,8,24,3621.8,1801.8,1820,1979-8-24,-18.2
1979,8,25,3544.8,1960,1584.8,1979-8-25,375.2
1979,8,26,3521,2436,1085,1979-8-26,1351
1979,8,27,3229.8,2177,1052.8,1979-8-27,1124.2
1979,8,28,2837.8,1792,1045.8,1979-8-28,746.2
1979,8,29,2842,1722,1120,1979-8-29,602
1979,8,30,2191,1624,567,1979-8-30,1057
1979,8,31,1883,1386,497,1979-8-31,889
1979,9,1,1001,819,182,1979-9-1,637
1979,9,2,1076.6,854,222.6,1979-9-2,631.4
1979,9,3,1584.8,1218,366.8,1979-9-3,851.2
1979,9,4,2233,1792,441,1979-9-4,1351
1979,9,5,2037,1617,420,1979-9-5,1197
1979,9,6,2245.6,1871.8,373.8,1979-9-6,1498
1979,9,7,1939,1617,322,1979-9-7,1295
1979,9,8,1519,1351,168,1979-9-8,1183
1979,9,9,1528.8,1381.8,147,1979-9-9,1234.8
1979,9,10,2107,1673,434,1979-9-10,1239
1979,9,11,1995,1267,728,1979-9-11,539
1979,9,12,1575,917,658,1979-9-12,259
1979,9,13,1554,987,567,1979-9-13,420
1979,9,14,1708,1190,518,1979-9-14,672
1979,9,15,1632.4,1143.8,488.6,1979-9-15,655.2
1979,9,16,2688,2149,539,1979-9-16,1610
1979,9,17,3178,2597,581,1979-9-17,2016
1979,9,18,3201.8,2459.8,742,1979-9-18,1717.8
1979,9,19,3052,2002,1050,1979-9-19,952
1979,9,20,2459.8,1673,786.8,1979-9-20,886.2
1979,9,21,2303,1624,679,1979-9-21,945
1979,9,22,2107,1498,609,1979-9-22,889
1979,9,23,2366,1904,462,1979-9-23,1442
1979,9,24,3038,2324,714,1979-9-24,1610
1979,9,25,3017,2275,742,1979-9-25,1533
1979,9,26,3108,2331,777,1979-9-26,1554
1979,9,27,2401,1603,798,1979-9-27,805
1979,9,28,3129,2121,1008,1979-9-28,1113
1979,9,29,2814,2009,805,1979-9-29,1204
1979,9,30,3150,2359,791,1979-9-30,1568
1979,10,1,3161.2,2576,585.2,1979-10-1,1990.8
1979,10,2,2935.8,2599.8,336,1979-10-2,2263.8
1979,10,3,2891,2590,301,1979-10-3,2289
1979,10,4,1715,1407,308,1979-10-4,1099
1979,10,5,2438.8,1885.8,553,1979-10-5,1332.8
1979,10,6,1976.8,1668.8,308,1979-10-6,1360.8
1979,10,7,1773.8,1479.8,294,1979-10-7,1185.8
1979,10,8,2765,2373,392,1979-10-8,1981
1979,10,9,2697.8,2268,429.8,1979-10-9,1838.2
1979,10,10,3166.8,2660,506.8,1979-10-10,2153.2
1979,10,11,2975,2688,287,1979-10-11,2401
1979,10,12,2605.4,2326.8,278.6,1979-10-12,2048.2
1979,10,13,2800,2513,287,1979-10-13,2226
1979,10,14,3066,2800,266,1979-10-14,2534
1979,10,15,3341.8,3131.8,210,1979-10-15,2921.8
1979,10,16,2982,2688,294,1979-10-16,2394
1979,10,17,3158.4,2893.8,264.6,1979-10-17,2629.2
1979,10,18,3605,3059,546,1979-10-18,2513
1979,10,19,3255,2555,700,1979-10-19,1855
1979,10,20,3521,2737,784,1979-10-20,1953
1979,10,21,2830.8,2093,737.8,1979-10-21,1355.2
1979,10,22,2170,1456,714,1979-10-22,742
1979,10,23,1773.8,1010.8,763,1979-10-23,247.8
1979,10,24,1855,819,1036,1979-10-24,-217
1979,10,25,2214.8,744.8,1470,1979-10-25,-725.2
1979,10,26,2254,854,1400,1979-10-26,-546
1979,10,27,2242.8,1120,1122.8,1979-10-27,-2.8
1979,10,28,3157,1673,1484,1979-10-28,189
1979,10,29,2627.8,1682.8,945,1979-10-29,737.8
1979,10,30,3283,2471,812,1979-10-30,1659
1979,10,31,2581.6,2070.6,511,1979-10-31,1559.6
1979,11,1,2632,1939,693,1979-11-1,1246
1979,11,2,1813,1435,378,1979-11-2,1057
1979,11,3,1995,1491,504,1979-11-3,987
1979,11,4,2802.8,1885.8,917,1979-11-4,968.8
1979,11,5,3243.8,1512,1731.8,1979-11-5,-219.8
1979,11,6,5217.8,2058,3159.8,1979-11-6,-1101.8
1979,11,7,7441,2072,5369,1979-11-7,-3297
1979,11,8,6519.8,1647.8,4872,1979-11-8,-3224.2
1979,11,9,6729.8,2109.8,4620,1979-11-9,-2510.2
1979,11,10,7030.8,2408,4622.8,1979-11-10,-2214.8
1979,11,11,6762,2800,3962,1979-11-11,-1162
1979,11,12,5154.8,2193.8,2961,1979-11-12,-767.2
1979,11,13,4361,2070.6,2290.4,1979-11-13,-219.8
1979,11,14,3719.8,1997.8,1722,1979-11-14,275.8
1979,11,15,2718.8,1750,968.8,1979-11-15,781.2
1979,11,16,2588.6,1794.8,793.8,1979-11-16,1001
1979,11,17,2518.6,1489.6,1029,1979-11-17,460.6
1979,11,18,2403.8,1610,793.8,1979-11-18,816.2
1979,11,19,2732.8,1542.8,1190,1979-11-19,352.8
1979,11,20,1920.8,1066.8,854,1979-11-20,212.8
1979,11,21,1918,1022,896,1979-11-21,126
1979,11,22,1820,686,1134,1979-11-22,-448
1979,11,23,1463,637,826,1979-11-23,-189
1979,11,24,1589,777,812,1979-11-24,-35
1979,11,25,1253,623,630,1979-11-25,-7
1979,11,26,1106,532,574,1979-11-26,-42
1979,11,27,1092,392,700,1979-11-27,-308
1979,11,28,1069.6,310.8,758.8,1979-11-28,-448
1979,11,29,1085,294,791,1979-11-29,-497
1979,11,30,1267,308,959,1979-11-30,-651
1979,12,1,1232,294,938,1979-12-1,-644
1979,12,2,1603,336,1267,1979-12-2,-931
1979,12,3,-1,-1,-1,1979-12-3,0
1979,12,4,3521,336,3185,1979-12-4,-2849
1979,12,5,3283,217,3066,1979-12-5,-2849
1979,12,6,2242.8,168,2074.8,1979-12-6,-1906.8
1979,12,7,2319.8,478.8,1841,1979-12-7,-1362.2
1979,12,8,3178,889,2289,1979-12-8,-1400
1979,12,9,2808.4,693,2115.4,1979-12-9,-1422.4
1979,12,10,2331,602,1729,1979-12-10,-1127
1979,12,11,2457,658,1799,1979-12-11,-1141
1979,12,12,2513,735,1778,1979-12-12,-1043
1979,12,13,1974,581,1393,1979-12-13,-812
1979,12,14,2177,735,1442,1979-12-14,-707
1979,12,15,1211,595,616,1979-12-15,-21
1979,12,16,1610,756,854,1979-12-16,-98
1979,12,17,1848,1092,756,1979-12-17,336
1979,12,18,1771,1260,511,1979-12-18,749
1979,12,19,1764,1029,735,1979-12-19,294
1979,12,20,1666,483,1183,1979-12-20,-700
1979,12,21,1710.8,170.8,1540,1979-12-21,-1369.2
1979,12,22,1183,7,1176,1979-12-22,-1169
1979,12,23,1645,7,1638,1979-12-23,-1631
1979,12,24,1073.8,35,1038.8,1979-12-24,-1003.8
1979,12,25,1106,70,1036,1979-12-25,-966
1979,12,26,651,7,644,1979-12-26,-637
1979,12,27,833,35,798,1979-12-27,-763
1979,12,28,1134,63,1071,1979-12-28,-1008
1979,12,29,1218,63,1155,1979-12-29,-1092
1979,12,30,1253,98,1155,1979-12-30,-1057
1979,12,31,1827,588,1239,1979-12-31,-651
1980,1,1,1932,770,1162,1980-1-1,-392
1980,1,2,1736,728,1008,1980-1-2,-280
1980,1,3,1666,742,924,1980-1-3,-182
1980,1,4,1806,854,952,1980-1-4,-98
1980,1,5,2436,1414,1022,1980-1-5,392
1980,1,6,2464,1414,1050,1980-1-6,364
1980,1,7,2310,1274,1036,1980-1-7,238
1980,1,8,3423,1827,1596,1980-1-8,231
1980,1,9,2800,1694,1106,1980-1-9,588
1980,1,10,2646,1582,1064,1980-1-10,518
1980,1,11,2842,1778,1064,1980-1-11,714
1980,1,12,3052,2226,826,1980-1-12,1400
1980,1,13,2548,1638,910,1980-1-13,728
1980,1,14,1974,980,994,1980-1-14,-14
1980,1,15,1890,952,938,1980-1-15,14
1980,1,16,1792,812,980,1980-1-16,-168
1980,1,17,1484,644,840,1980-1-17,-196
1980,1,18,1120,490,630,1980-1-18,-140
1980,1,19,980,504,476,1980-1-19,28
1980,1,20,756,406,350,1980-1-20,56
1980,1,21,644,308,336,1980-1-21,-28
1980,1,22,840,266,574,1980-1-22,-308
1980,1,23,980,294,686,1980-1-23,-392
1980,1,24,1148,252,896,1980-1-24,-644
1980,1,25,1260,308,952,1980-1-25,-644
1980,1,26,2394,1232,1162,1980-1-26,70
1980,1,27,2464,1134,1330,1980-1-27,-196
1980,1,28,2268,1512,756,1980-1-28,756
1980,1,29,1666,1442,224,1980-1-29,1218
1980,1,30,2471,1932,539,1980-1-30,1393
1980,1,31,2198,1316,882,1980-1-31,434
1980,2,1,2646,1204,1442,1980-2-1,-238
1980,2,2,2590,1176,1414,1980-2-2,-238
1980,2,3,2562,1134,1428,1980-2-3,-294
1980,2,4,3122,1204,1918,1980-2-4,-714
1980,2,5,3402,1190,2212,1980-2-5,-1022
1980,2,6,3360,1120,2240,1980-2-6,-1120
1980,2,7,3234,1204,2030,1980-2-7,-826
1980,2,8,3094,1120,1974,1980-2-8,-854
1980,2,9,2772,728,2044,1980-2-9,-1316
1980,2,10,2884,1302,1582,1980-2-10,-280
1980,2,11,2506,1932,574,1980-2-11,1358
1980,2,12,2842,1722,1120,1980-2-12,602
1980,2,13,2618,1554,1064,1980-2-13,490
1980,2,14,2562,1526,1036,1980-2-14,490
1980,2,15,2212,1022,1190,1980-2-15,-168
1980,2,16,1512,994,518,1980-2-16,476
1980,2,17,1218,840,378,1980-2-17,462
1980,2,18,1204,784,420,1980-2-18,364
1980,2,19,1260,826,434,1980-2-19,392
1980,2,20,1316,742,574,1980-2-20,168
1980,2,21,1309,672,637,1980-2-21,35
1980,2,22,1260,546,714,1980-2-22,-168
1980,2,23,840,476,364,1980-2-23,112
1980,2,24,1190,448,742,1980-2-24,-294
1980,2,25,1414,546,868,1980-2-25,-322
1980,2,26,1771,756,1015,1980-2-26,-259
1980,2,27,1694,686,1008,1980-2-27,-322
1980,2,28,1680,714,966,1980-2-28,-252
1980,2,29,1204,462,742,1980-2-29,-280
1980,3,1,1372,392,980,1980-3-1,-588
1980,3,2,1484,294,1190,1980-3-2,-896
1980,3,3,924,238,686,1980-3-3,-448
1980,3,4,994,224,770,1980-3-4,-546
1980,3,5,1022,266,756,1980-3-5,-490
1980,3,6,1064,378,686,1980-3-6,-308
1980,3,7,980,238,742,1980-3-7,-504
1980,3,8,1400,448,952,1980-3-8,-504
1980,3,9,1036,196,840,1980-3-9,-644
1980,3,10,840,56,784,1980-3-10,-728
1980,3,11,616,56,560,1980-3-11,-504
1980,3,12,560,56,504,1980-3-12,-448
1980,3,13,623,77,546,1980-3-13,-469
1980,3,14,532,84,448,1980-3-14,-364
1980,3,15,266,56,210,1980-3-15,-154
1980,3,16,161,14,147,1980-3-16,-133
1980,3,17,112,0,112,1980-3-17,-112
1980,3,18,350,98,252,1980-3-18,-154
1980,3,19,756,168,588,1980-3-19,-420
1980,3,20,1204,574,630,1980-3-20,-56
1980,3,21,966,406,560,1980-3-21,-154
1980,3,22,882,448,434,1980-3-22,14
1980,3,23,1260,574,686,1980-3-23,-112
1980,3,24,1022,574,448,1980-3-24,126
1980,3,25,1274,728,546,1980-3-25,182
1980,3,26,1918,1330,588,1980-3-26,742
1980,3,27,2730,1876,854,1980-3-27,1022
1980,3,28,2513,1820,693,1980-3-28,1127
1980,3,29,2233,1596,637,1980-3-29,959
1980,3,30,2268,1666,602,1980-3-30,1064
1980,3,31,1792,1176,616,1980-3-31,560
1980,4,1,1820,1288,532,1980-4-1,756
1980,4,2,2548,2100,448,1980-4-2,1652
1980,4,3,1722,1400,322,1980-4-3,1078
1980,4,4,1988,1708,280,1980-4-4,1428
1980,4,5,2604,2282,322,1980-4-5,1960
1980,4,6,3892,3402,490,1980-4-6,2912
1980,4,7,4662,3430,1232,1980-4-7,2198
1980,4,8,5502,3752,1750,1980-4-8,2002
1980,4,9,5866,3808,2058,1980-4-9,1750
1980,4,10,5124,3444,1680,1980-4-10,1764
1980,4,11,5698,3248,2450,1980-4-11,798
1980,4,12,5320,2898,2422,1980-4-12,476
1980,4,13,4130,2156,1974,1980-4-13,182
1980,4,14,3262,1316,1946,1980-4-14,-630
1980,4,15,1918,322,1596,1980-4-15,-1274
1980,4,16,1358,210,1148,1980-4-16,-938
1980,4,17,1456,140,1316,1980-4-17,-1176
1980,4,18,1862,154,1708,1980-4-18,-1554
1980,4,19,2142,224,1918,1980-4-19,-1694
1980,4,20,2198,392,1806,1980-4-20,-1414
1980,4,21,1932,392,1540,1980-4-21,-1148
1980,4,22,1778,168,1610,1980-4-22,-1442
1980,4,23,1624,140,1484,1980-4-23,-1344
1980,4,24,1666,98,1568,1980-4-24,-1470
1980,4,25,1722,140,1582,1980-4-25,-1442
1980,4,26,2240,266,1974,1980-4-26,-1708
1980,4,27,2338,322,2016,1980-4-27,-1694
1980,4,28,1736,252,1484,1980-4-28,-1232
1980,4,29,2464,294,2170,1980-4-29,-1876
1980,4,30,2254,658,1596,1980-4-30,-938
1980,5,1,1988,658,1330,1980-5-1,-672
1980,5,2,3052,868,2184,1980-5-2,-1316
1980,5,3,2926,826,2100,1980-5-3,-1274
1980,5,4,2408,728,1680,1980-5-4,-952
1980,5,5,1876,658,1218,1980-5-5,-560
1980,5,6,2128,644,1484,1980-5-6,-840
1980,5,7,1736,602,1134,1980-5-7,-532
1980,5,8,2240,658,1582,1980-5-8,-924
1980,5,9,2058,532,1526,1980-5-9,-994
1980,5,10,1526,154,1372,1980-5-10,-1218
1980,5,11,1820,98,1722,1980-5-11,-1624
1980,5,12,1344,168,1176,1980-5-12,-1008
1980,5,13,1526,196,1330,1980-5-13,-1134
1980,5,14,1540,56,1484,1980-5-14,-1428
1980,5,15,1540,140,1400,1980-5-15,-1260
1980,5,16,1680,112,1568,1980-5-16,-1456
1980,5,17,1862,420,1442,1980-5-17,-1022
1980,5,18,2436,546,1890,1980-5-18,-1344
1980,5,19,3514,644,2870,1980-5-19,-2226
1980,5,20,4494,616,3878,1980-5-20,-3262
1980,5,21,5138,630,4508,1980-5-21,-3878
1980,5,22,5250,742,4508,1980-5-22,-3766
1980,5,23,4676,910,3766,1980-5-23,-2856
1980,5,24,4536,658,3878,1980-5-24,-3220
1980,5,25,4284,812,3472,1980-5-25,-2660
1980,5,26,4480,1050,3430,1980-5-26,-2380
1980,5,27,4004,896,3108,1980-5-27,-2212
1980,5,28,3948,616,3332,1980-5-28,-2716
1980,5,29,3500,560,2940,1980-5-29,-2380
1980,5,30,3276,560,2716,1980-5-30,-2156
1980,5,31,2618,434,2184,1980-5-31,-1750
1980,6,1,1876,364,1512,1980-6-1,-1148
1980,6,2,1708,308,1400,1980-6-2,-1092
1980,6,3,1890,196,1694,1980-6-3,-1498
1980,6,4,3024,378,2646,1980-6-4,-2268
1980,6,5,2786,798,1988,1980-6-5,-1190
1980,6,6,1568,658,910,1980-6-6,-252
1980,6,7,1386,462,924,1980-6-7,-462
1980,6,8,1162,280,882,1980-6-8,-602
1980,6,9,1344,364,980,1980-6-9,-616
1980,6,10,1428,294,1134,1980-6-10,-840
1980,6,11,1400,336,1064,1980-6-11,-728
1980,6,12,1022,322,700,1980-6-12,-378
1980,6,13,1050,308,742,1980-6-13,-434
1980,6,14,896,364,532,1980-6-14,-168
1980,6,15,1484,966,518,1980-6-15,448
1980,6,16,1386,714,672,1980-6-16,42
1980,6,17,1876,1022,854,1980-6-17,168
1980,6,18,1904,882,1022,1980-6-18,-140
1980,6,19,2618,756,1862,1980-6-19,-1106
1980,6,20,2548,560,1988,1980-6-20,-1428
1980,6,21,2422,350,2072,1980-6-21,-1722
1980,6,22,2688,490,2198,1980-6-22,-1708
1980,6,23,3122,588,2534,1980-6-23,-1946
1980,6,24,3220,854,2366,1980-6-24,-1512
1980,6,25,2828,574,2254,1980-6-25,-1680
1980,6,26,2492,378,2114,1980-6-26,-1736
1980,6,27,2380,532,1848,1980-6-27,-1316
1980,6,28,2527,686,1841,1980-6-28,-1155
1980,6,29,1568,378,1190,1980-6-29,-812
1980,6,30,1218,182,1036,1980-6-30,-854
1980,7,1,1330,154,1176,1980-7-1,-1022
1980,7,2,1120,168,952,1980-7-2,-784
1980,7,3,882,280,602,1980-7-3,-322
1980,7,4,868,350,518,1980-7-4,-168
1980,7,5,1204,812,392,1980-7-5,420
1980,7,6,1400,1036,364,1980-7-6,672
1980,7,7,1386,994,392,1980-7-7,602
1980,7,8,1512,1162,350,1980-7-8,812
1980,7,9,1519,1190,329,1980-7-9,861
1980,7,10,1456,868,588,1980-7-10,280
1980,7,11,1925,826,1099,1980-7-11,-273
1980,7,12,2345,784,1561,1980-7-12,-777
1980,7,13,2870,868,2002,1980-7-13,-1134
1980,7,14,2940,868,2072,1980-7-14,-1204
1980,7,15,2968,910,2058,1980-7-15,-1148
1980,7,16,3052,770,2282,1980-7-16,-1512
1980,7,17,3584,868,2716,1980-7-17,-1848
1980,7,18,3318,686,2632,1980-7-18,-1946
1980,7,19,3822,812,3010,1980-7-19,-2198
1980,7,20,3598,714,2884,1980-7-20,-2170
1980,7,21,3472,588,2884,1980-7-21,-2296
1980,7,22,2786,462,2324,1980-7-22,-1862
1980,7,23,2716,350,2366,1980-7-23,-2016
1980,7,24,2226,350,1876,1980-7-24,-1526
1980,7,25,2100,448,1652,1980-7-25,-1204
1980,7,26,1442,392,1050,1980-7-26,-658
1980,7,27,1302,518,784,1980-7-27,-266
1980,7,28,1190,462,728,1980-7-28,-266
1980,7,29,938,378,560,1980-7-29,-182
1980,7,30,462,224,238,1980-7-30,-14
1980,7,31,371,140,231,1980-7-31,-91
1980,8,1,266,112,154,1980-8-1,-42
1980,8,2,406,238,168,1980-8-2,70
1980,8,3,294,112,182,1980-8-3,-70
1980,8,4,287,126,161,1980-8-4,-35
1980,8,5,329,126,203,1980-8-5,-77
1980,8,6,483,252,231,1980-8-6,21
1980,8,7,686,322,364,1980-8-7,-42
1980,8,8,784,280,504,1980-8-8,-224
1980,8,9,868,406,462,1980-8-9,-56
1980,8,10,1547,735,812,1980-8-10,-77
1980,8,11,2184,1134,1050,1980-8-11,84
1980,8,12,2352,1428,924,1980-8-12,504
1980,8,13,1694,1232,462,1980-8-13,770
1980,8,14,1617,1183,434,1980-8-14,749
1980,8,15,1218,784,434,1980-8-15,350
1980,8,16,1610,1120,490,1980-8-16,630
1980,8,17,1764,1386,378,1980-8-17,1008
1980,8,18,1666,1386,280,1980-8-18,1106
1980,8,19,1813,1351,462,1980-8-19,889
1980,8,20,1477,1106,371,1980-8-20,735
1980,8,21,1498,1330,168,1980-8-21,1162
1980,8,22,1554,1400,154,1980-8-22,1246
1980,8,23,1526,1288,238,1980-8-23,1050
1980,8,24,1456,1372,84,1980-8-24,1288
1980,8,25,1344,1204,140,1980-8-25,1064
1980,8,26,1148,882,266,1980-8-26,616
1980,8,27,1736,672,1064,1980-8-27,-392
1980,8,28,1820,490,1330,1980-8-28,-840
1980,8,29,2674,980,1694,1980-8-29,-714
1980,8,30,3514,1484,2030,1980-8-30,-546
1980,8,31,3535,1575,1960,1980-8-31,-385
1980,9,1,3514,1764,1750,1980-9-1,14
1980,9,2,3850,2198,1652,1980-9-2,546
1980,9,3,3773,2233,1540,1980-9-3,693
1980,9,4,3318,2100,1218,1980-9-4,882
1980,9,5,3206,2044,1162,1980-9-5,882
1980,9,6,2492,1610,882,1980-9-6,728
1980,9,7,2240,1484,756,1980-9-7,728
1980,9,8,1960,1484,476,1980-9-8,1008
1980,9,9,1708,1540,168,1980-9-9,1372
1980,9,10,1841,1582,259,1980-9-10,1323
1980,9,11,1582,1050,532,1980-9-11,518
1980,9,12,1589,1001,588,1980-9-12,413
1980,9,13,1358,882,476,1980-9-13,406
1980,9,14,1204,728,476,1980-9-14,252
1980,9,15,1106,616,490,1980-9-15,126
1980,9,16,882,546,336,1980-9-16,210
1980,9,17,931,490,441,1980-9-17,49
1980,9,18,1008,462,546,1980-9-18,-84
1980,9,19,1414,714,700,1980-9-19,14
1980,9,20,1414,490,924,1980-9-20,-434
1980,9,21,1407,504,903,1980-9-21,-399
1980,9,22,1652,728,924,1980-9-22,-196
1980,9,23,1848,1064,784,1980-9-23,280
1980,9,24,1862,1050,812,1980-9-24,238
1980,9,25,2401,1260,1141,1980-9-25,119
1980,9,26,2058,1302,756,1980-9-26,546
1980,9,27,2856,1876,980,1980-9-27,896
1980,9,28,2870,1946,924,1980-9-28,1022
1980,9,29,1386,938,448,1980-9-29,490
1980,9,30,1113,826,287,1980-9-30,539
1980,10,1,1155,882,273,1980-10-1,609
1980,10,2,1183,812,371,1980-10-2,441
1980,10,3,854,420,434,1980-10-3,-14
1980,10,4,1008,700,308,1980-10-4,392
1980,10,5,1071,763,308,1980-10-5,455
1980,10,6,1491,1232,259,1980-10-6,973
1980,10,7,2289,1358,931,1980-10-7,427
1980,10,8,3444,1680,1764,1980-10-8,-84
1980,10,9,3262,1386,1876,1980-10-9,-490
1980,10,10,2688,1134,1554,1980-10-10,-420
1980,10,11,2842,1330,1512,1980-10-11,-182
1980,10,12,3780,1652,2128,1980-10-12,-476
1980,10,13,3710,2296,1414,1980-10-13,882
1980,10,14,3556,2128,1428,1980-10-14,700
1980,10,15,3388,2030,1358,1980-10-15,672
1980,10,16,3374,1568,1806,1980-10-16,-238
1980,10,17,2051,518,1533,1980-10-17,-1015
1980,10,18,1967,224,1743,1980-10-18,-1519
1980,10,19,3605,280,3325,1980-10-19,-3045
1980,10,20,3626,294,3332,1980-10-20,-3038
1980,10,21,3024,350,2674,1980-10-21,-2324
1980,10,22,3108,672,2436,1980-10-22,-1764
1980,10,23,2436,378,2058,1980-10-23,-1680
1980,10,24,2534,574,1960,1980-10-24,-1386
1980,10,25,2212,728,1484,1980-10-25,-756
1980,10,26,1568,364,1204,1980-10-26,-840
1980,10,27,1561,490,1071,1980-10-27,-581
1980,10,28,1827,791,1036,1980-10-28,-245
1980,10,29,1505,1183,322,1980-10-29,861
1980,10,30,3542,3052,490,1980-10-30,2562
1980,10,31,2884,2408,476,1980-10-31,1932
1980,11,1,3248,2590,658,1980-11-1,1932
1980,11,2,4116,3332,784,1980-11-2,2548
1980,11,3,3990,3010,980,1980-11-3,2030
1980,11,4,3815,3416,399,1980-11-4,3017
1980,11,5,4004,2758,1246,1980-11-5,1512
1980,11,6,5152,2604,2548,1980-11-6,56
1980,11,7,5355,2352,3003,1980-11-7,-651
1980,11,8,5922,2380,3542,1980-11-8,-1162
1980,11,9,5754,2114,3640,1980-11-9,-1526
1980,11,10,4928,1400,3528,1980-11-10,-2128
1980,11,11,5068,1106,3962,1980-11-11,-2856
1980,11,12,4480,784,3696,1980-11-12,-2912
1980,11,13,3178,168,3010,1980-11-13,-2842
1980,11,14,2842,238,2604,1980-11-14,-2366
1980,11,15,3332,434,2898,1980-11-15,-2464
1980,11,16,3570,476,3094,1980-11-16,-2618
1980,11,17,2730,1036,1694,1980-11-17,-658
1980,11,18,1624,1190,434,1980-11-18,756
1980,11,19,1680,1232,448,1980-11-19,784
1980,11,20,1386,966,420,1980-11-20,546
1980,11,21,1414,896,518,1980-11-21,378
1980,11,22,1190,756,434,1980-11-22,322
1980,11,23,1036,616,420,1980-11-23,196
1980,11,24,1176,574,602,1980-11-24,-28
1980,11,25,1064,602,462,1980-11-25,140
1980,11,26,1386,798,588,1980-11-26,210
1980,11,27,1834,966,868,1980-11-27,98
1980,11,28,2016,1050,966,1980-11-28,84
1980,11,29,2198,1162,1036,1980-11-29,126
1980,11,30,3010,1848,1162,1980-11-30,686
1980,12,1,2576,1414,1162,1980-12-1,252
1980,12,2,2674,1414,1260,1980-12-2,154
1980,12,3,2478,1246,1232,1980-12-3,14
1980,12,4,2310,1134,1176,1980-12-4,-42
1980,12,5,1414,378,1036,1980-12-5,-658
1980,12,6,1414,252,1162,1980-12-6,-910
1980,12,7,1008,126,882,1980-12-7,-756
1980,12,8,1190,266,924,1980-12-8,-658
1980,12,9,588,140,448,1980-12-9,-308
1980,12,10,686,364,322,1980-12-10,42
1980,12,11,1078,756,322,1980-12-11,434
1980,12,12,1820,1442,378,1980-12-12,1064
1980,12,13,1792,1512,280,1980-12-13,1232
1980,12,14,1512,1218,294,1980-12-14,924
1980,12,15,1834,1358,476,1980-12-15,882
1980,12,16,1666,1344,322,1980-12-16,1022
1980,12,17,1316,952,364,1980-12-17,588
1980,12,18,2072,1176,896,1980-12-18,280
1980,12,19,1358,672,686,1980-12-19,-14
1980,12,20,1694,658,1036,1980-12-20,-378
1980,12,21,1652,882,770,1980-12-21,112
1980,12,22,1652,840,812,1980-12-22,28
1980,12,23,2170,868,1302,1980-12-23,-434
1980,12,24,3752,1176,2576,1980-12-24,-1400
1980,12,25,4074,1554,2520,1980-12-25,-966
1980,12,26,3500,1176,2324,1980-12-26,-1148
1980,12,27,3528,1260,2268,1980-12-27,-1008
1980,12,28,3500,1526,1974,1980-12-28,-448
1980,12,29,3122,1316,1806,1980-12-29,-490
1980,12,30,2254,868,1386,1980-12-30,-518
1980,12,31,2394,1148,1246,1980-12-31,-98
1981,1,1,1736,756,980,1981-1-1,-224
1981,1,2,1568,686,882,1981-1-2,-196
1981,1,3,1414,714,700,1981-1-3,14
1981,1,4,1204,714,490,1981-1-4,224
1981,1,5,854,602,252,1981-1-5,350
1981,1,6,1008,840,168,1981-1-6,672
1981,1,7,756,560,196,1981-1-7,364
1981,1,8,1358,742,616,1981-1-8,126
1981,1,9,1414,602,812,1981-1-9,-210
1981,1,10,1274,532,742,1981-1-10,-210
1981,1,11,1218,518,700,1981-1-11,-182
1981,1,12,1204,420,784,1981-1-12,-364
1981,1,13,700,364,336,1981-1-13,28
1981,1,14,1162,588,574,1981-1-14,14
1981,1,15,1372,644,728,1981-1-15,-84
1981,1,16,770,406,364,1981-1-16,42
1981,1,17,882,350,532,1981-1-17,-182
1981,1,18,770,322,448,1981-1-18,-126
1981,1,19,658,364,294,1981-1-19,70
1981,1,20,1176,350,826,1981-1-20,-476
1981,1,21,714,280,434,1981-1-21,-154
1981,1,22,714,210,504,1981-1-22,-294
1981,1,23,714,210,504,1981-1-23,-294
1981,1,24,574,140,434,1981-1-24,-294
1981,1,25,700,196,504,1981-1-25,-308
1981,1,26,1470,238,1232,1981-1-26,-994
1981,1,27,2254,812,1442,1981-1-27,-630
1981,1,28,2359,686,1673,1981-1-28,-987
1981,1,29,2002,686,1316,1981-1-29,-630
1981,1,30,2591.4,1064,1527.4,1981-1-30,-463.4
1981,1,31,2114,924,1190,1981-1-31,-266
1981,2,1,1876,784,1092,1981-2-1,-308
1981,2,2,1835.4,840,995.4,1981-2-2,-155.4
1981,2,3,1988,924,1064,1981-2-3,-140
1981,2,4,1918,1162,756,1981-2-4,406
1981,2,5,2702,2016,686,1981-2-5,1330
1981,2,6,1960,1316,644,1981-2-6,672
1981,2,7,2856,1666,1190,1981-2-7,476
1981,2,8,2933,1841,1092,1981-2-8,749
1981,2,9,2464,1652,812,1981-2-9,840
1981,2,10,2408,2142,266,1981-2-10,1876
1981,2,11,2324,2156,168,1981-2-11,1988
1981,2,12,2254,1974,280,1981-2-12,1694
1981,2,13,2114,1946,168,1981-2-13,1778
1981,2,14,2128,1932,196,1981-2-14,1736
1981,2,15,2072,1806,266,1981-2-15,1540
1981,2,16,2184,1960,224,1981-2-16,1736
1981,2,17,1960,1750,210,1981-2-17,1540
1981,2,18,1666,1512,154,1981-2-18,1358
1981,2,19,1610,1344,266,1981-2-19,1078
1981,2,20,1694,1218,476,1981-2-20,742
1981,2,21,1526,1050,476,1981-2-21,574
1981,2,22,1582,798,784,1981-2-22,14
1981,2,23,1442,266,1176,1981-2-23,-910
1981,2,24,2702,266,2436,1981-2-24,-2170
1981,2,25,2744,154,2590,1981-2-25,-2436
1981,2,26,2961,161,2800,1981-2-26,-2639
1981,2,27,3374,140,3234,1981-2-27,-3094
1981,2,28,2786,56,2730,1981-2-28,-2674
1981,3,1,2436,168,2268,1981-3-1,-2100
1981,3,2,3304,420,2884,1981-3-2,-2464
1981,3,3,3416,518,2898,1981-3-3,-2380
1981,3,4,3542,742,2800,1981-3-4,-2058
1981,3,5,3374,826,2548,1981-3-5,-1722
1981,3,6,3178,686,2492,1981-3-6,-1806
1981,3,7,2408,644,1764,1981-3-7,-1120
1981,3,8,2282,784,1498,1981-3-8,-714
1981,3,9,2044,1008,1036,1981-3-9,-28
1981,3,10,2016,1022,994,1981-3-10,28
1981,3,11,1862,1092,770,1981-3-11,322
1981,3,12,1764,1106,658,1981-3-12,448
1981,3,13,1820,1190,630,1981-3-13,560
1981,3,14,2415,1659,756,1981-3-14,903
1981,3,15,2163,1827,336,1981-3-15,1491
1981,3,16,2254,1946,308,1981-3-16,1638
1981,3,17,1512,1400,112,1981-3-17,1288
1981,3,18,1176,1120,56,1981-3-18,1064
1981,3,19,1694,1694,0,1981-3-19,1694
1981,3,20,1988,1876,112,1981-3-20,1764
1981,3,21,2324,2044,280,1981-3-21,1764
1981,3,22,2310,2128,182,1981-3-22,1946
1981,3,23,2534,2324,210,1981-3-23,2114
1981,3,24,2702,2464,238,1981-3-24,2226
1981,3,25,2870,2492,378,1981-3-25,2114
1981,3,26,1960,1568,392,1981-3-26,1176
1981,3,27,1883,1477,406,1981-3-27,1071
1981,3,28,2940,1876,1064,1981-3-28,812
1981,3,29,2800,1638,1162,1981-3-29,476
1981,3,30,2002,812,1190,1981-3-30,-378
1981,3,31,1834,700,1134,1981-3-31,-434
1981,4,1,1834,868,966,1981-4-1,-98
1981,4,2,1974,1008,966,1981-4-2,42
1981,4,3,1946,1400,546,1981-4-3,854
1981,4,4,2478,2408,70,1981-4-4,2338
1981,4,5,2632,2576,56,1981-4-5,2520
1981,4,6,2604,2548,56,1981-4-6,2492
1981,4,7,2730,2590,140,1981-4-7,2450
1981,4,8,2842,2716,126,1981-4-8,2590
1981,4,9,3808,3710,98,1981-4-9,3612
1981,4,10,4522,4466,56,1981-4-10,4410
1981,4,11,4382,4298,84,1981-4-11,4214
1981,4,12,3906,3836,70,1981-4-12,3766
1981,4,13,3668,3514,154,1981-4-13,3360
1981,4,14,3332,2926,406,1981-4-14,2520
1981,4,15,3108,2562,546,1981-4-15,2016
1981,4,16,3052,2492,560,1981-4-16,1932
1981,4,17,2562,2002,560,1981-4-17,1442
1981,4,18,2856,2156,700,1981-4-18,1456
1981,4,19,2450,1778,672,1981-4-19,1106
1981,4,20,2450,1806,644,1981-4-20,1162
1981,4,21,714,336,378,1981-4-21,-42
1981,4,22,560,168,392,1981-4-22,-224
1981,4,23,98,42,56,1981-4-23,-14
1981,4,24,784,784,0,1981-4-24,784
1981,4,25,952,952,0,1981-4-25,952
1981,4,26,840,812,28,1981-4-26,784
1981,4,27,714,700,14,1981-4-27,686
1981,4,28,616,602,14,1981-4-28,588
1981,4,29,910,868,42,1981-4-29,826
1981,4,30,1176,1092,84,1981-4-30,1008
1981,5,1,1470,1302,168,1981-5-1,1134
1981,5,2,1694,1498,196,1981-5-2,1302
1981,5,3,2065,1519,546,1981-5-3,973
1981,5,4,1715,1456,259,1981-5-4,1197
1981,5,5,2240,1974,266,1981-5-5,1708
1981,5,6,2408,2142,266,1981-5-6,1876
1981,5,7,2828,2506,322,1981-5-7,2184
1981,5,8,2520,2170,350,1981-5-8,1820
1981,5,9,2660,2366,294,1981-5-9,2072
1981,5,10,2044,1778,266,1981-5-10,1512
1981,5,11,2856,2604,252,1981-5-11,2352
1981,5,12,3388,3122,266,1981-5-12,2856
1981,5,13,2898,2240,658,1981-5-13,1582
1981,5,14,3206,2590,616,1981-5-14,1974
1981,5,15,2898,2142,756,1981-5-15,1386
1981,5,16,2828,1834,994,1981-5-16,840
1981,5,17,2548,1680,868,1981-5-17,812
1981,5,18,2114,1246,868,1981-5-18,378
1981,5,19,2086,1106,980,1981-5-19,126
1981,5,20,1414,574,840,1981-5-20,-266
1981,5,21,1764,826,938,1981-5-21,-112
1981,5,22,1883,1022,861,1981-5-22,161
1981,5,23,1498,756,742,1981-5-23,14
1981,5,24,1589,546,1043,1981-5-24,-497
1981,5,25,1477,581,896,1981-5-25,-315
1981,5,26,1722,924,798,1981-5-26,126
1981,5,27,1498,994,504,1981-5-27,490
1981,5,28,1442,924,518,1981-5-28,406
1981,5,29,1372,882,490,1981-5-29,392
1981,5,30,1393,931,462,1981-5-30,469
1981,5,31,1036,658,378,1981-5-31,280
1981,6,1,616,350,266,1981-6-1,84
1981,6,2,490,238,252,1981-6-2,-14
1981,6,3,462,196,266,1981-6-3,-70
1981,6,4,420,126,294,1981-6-4,-168
1981,6,5,490,224,266,1981-6-5,-42
1981,6,6,406,266,140,1981-6-6,126
1981,6,7,504,336,168,1981-6-7,168
1981,6,8,406,280,126,1981-6-8,154
1981,6,9,406,168,238,1981-6-9,-70
1981,6,10,742,196,546,1981-6-10,-350
1981,6,11,1050,224,826,1981-6-11,-602
1981,6,12,1120,154,966,1981-6-12,-812
1981,6,13,1358,252,1106,1981-6-13,-854
1981,6,14,1274,224,1050,1981-6-14,-826
1981,6,15,1498,266,1232,1981-6-15,-966
1981,6,16,1330,252,1078,1981-6-16,-826
1981,6,17,1680,238,1442,1981-6-17,-1204
1981,6,18,1792,280,1512,1981-6-18,-1232
1981,6,19,1190,70,1120,1981-6-19,-1050
1981,6,20,1344,658,686,1981-6-20,-28
1981,6,21,1904,1204,700,1981-6-21,504
1981,6,22,2674,1974,700,1981-6-22,1274
1981,6,23,2338,1960,378,1981-6-23,1582
1981,6,24,1918,1764,154,1981-6-24,1610
1981,6,25,1960,1274,686,1981-6-25,588
1981,6,26,2513,1400,1113,1981-6-26,287
1981,6,27,3276,1414,1862,1981-6-27,-448
1981,6,28,2926,1134,1792,1981-6-28,-658
1981,6,29,2800,952,1848,1981-6-29,-896
1981,6,30,2646,672,1974,1981-6-30,-1302
1981,7,1,1610,154,1456,1981-7-1,-1302
1981,7,2,1806,154,1652,1981-7-2,-1498
1981,7,3,1694,196,1498,1981-7-3,-1302
1981,7,4,1260,168,1092,1981-7-4,-924
1981,7,5,1232,140,1092,1981-7-5,-952
1981,7,6,994,98,896,1981-7-6,-798
1981,7,7,427,154,273,1981-7-7,-119
1981,7,8,1029,112,917,1981-7-8,-805
1981,7,9,1568,140,1428,1981-7-9,-1288
1981,7,10,1428,126,1302,1981-7-10,-1176
1981,7,11,1834,350,1484,1981-7-11,-1134
1981,7,12,2198,420,1778,1981-7-12,-1358
1981,7,13,1960,532,1428,1981-7-13,-896
1981,7,14,1890,602,1288,1981-7-14,-686
1981,7,15,1708,434,1274,1981-7-15,-840
1981,7,16,1785,336,1449,1981-7-16,-1113
1981,7,17,3444,490,2954,1981-7-17,-2464
1981,7,18,4494,616,3878,1981-7-18,-3262
1981,7,19,5901,917,4984,1981-7-19,-4067
1981,7,20,4872,1274,3598,1981-7-20,-2324
1981,7,21,4424,1358,3066,1981-7-21,-1708
1981,7,22,6790,1358,5432,1981-7-22,-4074
1981,7,23,6692,1260,5432,1981-7-23,-4172
1981,7,24,7154,1288,5866,1981-7-24,-4578
1981,7,25,7133,1428,5705,1981-7-25,-4277
1981,7,26,6979,1274,5705,1981-7-26,-4431
1981,7,27,6076,756,5320,1981-7-27,-4564
1981,7,28,5138,490,4648,1981-7-28,-4158
1981,7,29,3794,378,3416,1981-7-29,-3038
1981,7,30,2401,357,2044,1981-7-30,-1687
1981,7,31,2429,553,1876,1981-7-31,-1323
1981,8,1,2786,630,2156,1981-8-1,-1526
1981,8,2,2464,728,1736,1981-8-2,-1008
1981,8,3,1932,994,938,1981-8-3,56
1981,8,4,1526,1372,154,1981-8-4,1218
1981,8,5,1358,1148,210,1981-8-5,938
1981,8,6,1078,910,168,1981-8-6,742
1981,8,7,910,798,112,1981-8-7,686
1981,8,8,798,700,98,1981-8-8,602
1981,8,9,826,672,154,1981-8-9,518
1981,8,10,910,672,238,1981-8-10,434
1981,8,11,840,588,252,1981-8-11,336
1981,8,12,1036,588,448,1981-8-12,140
1981,8,13,686,406,280,1981-8-13,126
1981,8,14,434,280,154,1981-8-14,126
1981,8,15,476,42,434,1981-8-15,-392
1981,8,16,616,28,588,1981-8-16,-560
1981,8,17,693,35,658,1981-8-17,-623
1981,8,18,1022,56,966,1981-8-18,-910
1981,8,19,1498,154,1344,1981-8-19,-1190
1981,8,20,1456,224,1232,1981-8-20,-1008
1981,8,21,1344,238,1106,1981-8-21,-868
1981,8,22,1400,448,952,1981-8-22,-504
1981,8,23,2086,1162,924,1981-8-23,238
1981,8,24,2800,1834,966,1981-8-24,868
1981,8,25,2688,1680,1008,1981-8-25,672
1981,8,26,3514,1680,1834,1981-8-26,-154
1981,8,27,3822,1498,2324,1981-8-27,-826
1981,8,28,3864,1778,2086,1981-8-28,-308
1981,8,29,4312,1428,2884,1981-8-29,-1456
1981,8,30,4494,1596,2898,1981-8-30,-1302
1981,8,31,3388,1218,2170,1981-8-31,-952
1981,9,1,2912,966,1946,1981-9-1,-980
1981,9,2,3108,952,2156,1981-9-2,-1204
1981,9,3,2828,826,2002,1981-9-3,-1176
1981,9,4,2926,994,1932,1981-9-4,-938
1981,9,5,4172,2128,2044,1981-9-5,84
1981,9,6,4270,2296,1974,1981-9-6,322
1981,9,7,4438,2478,1960,1981-9-7,518
1981,9,8,3920,2618,1302,1981-9-8,1316
1981,9,9,3710,2576,1134,1981-9-9,1442
1981,9,10,3206,2268,938,1981-9-10,1330
1981,9,11,3248,2632,616,1981-9-11,2016
1981,9,12,2660,2198,462,1981-9-12,1736
1981,9,13,2415,2212,203,1981-9-13,2009
1981,9,14,2604,2506,98,1981-9-14,2408
1981,9,15,2548,2156,392,1981-9-15,1764
1981,9,16,2254,1988,266,1981-9-16,1722
1981,9,17,2534,1960,574,1981-9-17,1386
1981,9,18,2653,2030,623,1981-9-18,1407
1981,9,19,2387,1827,560,1981-9-19,1267
1981,9,20,2324,1848,476,1981-9-20,1372
1981,9,21,2170,1617,553,1981-9-21,1064
1981,9,22,1771,1141,630,1981-9-22,511
1981,9,23,1288,630,658,1981-9-23,-28
1981,9,24,1043,322,721,1981-9-24,-399
1981,9,25,1295,399,896,1981-9-25,-497
1981,9,26,1218,392,826,1981-9-26,-434
1981,9,27,1477,665,812,1981-9-27,-147
1981,9,28,1848,966,882,1981-9-28,84
1981,9,29,1918,1092,826,1981-9-29,266
1981,9,30,2016,1036,980,1981-9-30,56
1981,10,1,1918,1113,805,1981-10-1,308
1981,10,2,1610,1022,588,1981-10-2,434
1981,10,3,1407,784,623,1981-10-3,161
1981,10,4,1351,756,595,1981-10-4,161
1981,10,5,1239,623,616,1981-10-5,7
1981,10,6,1575,798,777,1981-10-6,21
1981,10,7,2107,1155,952,1981-10-7,203
1981,10,8,3199,1393,1806,1981-10-8,-413
1981,10,9,3423,1071,2352,1981-10-9,-1281
1981,10,10,2590,455,2135,1981-10-10,-1680
1981,10,11,3409,322,3087,1981-10-11,-2765
1981,10,12,4480,476,4004,1981-10-12,-3528
1981,10,13,5194,406,4788,1981-10-13,-4382
1981,10,14,6134.8,406,5728.8,1981-10-14,-5322.8
1981,10,15,7378,546,6832,1981-10-15,-6286
1981,10,16,7271.6,509.6,6762,1981-10-16,-6252.4
1981,10,17,6657,322,6335,1981-10-17,-6013
1981,10,18,6134.8,268.8,5866,1981-10-18,-5597.2
1981,10,19,5210.8,226.8,4984,1981-10-19,-4757.2
1981,10,20,4902.8,394.8,4508,1981-10-20,-4113.2
1981,10,21,3934,224,3710,1981-10-21,-3486
1981,10,22,2662.8,322,2340.8,1981-10-22,-2018.8
1981,10,23,3108,294,2814,1981-10-23,-2520
1981,10,24,2634.8,700,1934.8,1981-10-24,-1234.8
1981,10,25,1218,742,476,1981-10-25,266
1981,10,26,868,546,322,1981-10-26,224
1981,10,27,940.8,730.8,210,1981-10-27,520.8
1981,10,28,1064,770,294,1981-10-28,476
1981,10,29,1640.8,716.8,924,1981-10-29,-207.2
1981,10,30,2452.8,952,1500.8,1981-10-30,-548.8
1981,10,31,2716,1078,1638,1981-10-31,-560
1981,11,1,3248,1050,2198,1981-11-1,-1148
1981,11,2,3990,910,3080,1981-11-2,-2170
1981,11,3,4186,938,3248,1981-11-3,-2310
1981,11,4,4781,770,4011,1981-11-4,-3241
1981,11,5,3829,903,2926,1981-11-5,-2023
1981,11,6,2954,644,2310,1981-11-6,-1666
1981,11,7,2681,567,2114,1981-11-7,-1547
1981,11,8,2674,602,2072,1981-11-8,-1470
1981,11,9,2282,686,1596,1981-11-9,-910
1981,11,10,2233,847,1386,1981-11-10,-539
1981,11,11,2226,1120,1106,1981-11-11,14
1981,11,12,2331,1309,1022,1981-11-12,287
1981,11,13,2858.8,1512,1346.8,1981-11-13,165.2
1981,11,14,2823.8,1694,1129.8,1981-11-14,564.2
1981,11,15,2368.8,1400,968.8,1981-11-15,431.2
1981,11,16,2324,1736,588,1981-11-16,1148
1981,11,17,1113,644,469,1981-11-17,175
1981,11,18,945,252,693,1981-11-18,-441
1981,11,19,987,350,637,1981-11-19,-287
1981,11,20,1295,448,847,1981-11-20,-399
1981,11,21,1449,406,1043,1981-11-21,-637
1981,11,22,1232,364,868,1981-11-22,-504
1981,11,23,518,266,252,1981-11-23,14
1981,11,24,700,294,406,1981-11-24,-112
1981,11,25,1190,210,980,1981-11-25,-770
1981,11,26,1078,196,882,1981-11-26,-686
1981,11,27,1491,315,1176,1981-11-27,-861
1981,11,28,1582,546,1036,1981-11-28,-490
1981,11,29,2184,854,1330,1981-11-29,-476
1981,11,30,2660,1414,1246,1981-11-30,168
1981,12,1,2422,1526,896,1981-12-1,630
1981,12,2,2758,1792,966,1981-12-2,826
1981,12,3,3640,2128,1512,1981-12-3,616
1981,12,4,2849,1652,1197,1981-12-4,455
1981,12,5,3626,2226,1400,1981-12-5,826
1981,12,6,4109,2450,1659,1981-12-6,791
1981,12,7,4452,2786,1666,1981-12-7,1120
1981,12,8,4767,3073,1694,1981-12-8,1379
1981,12,9,6111,3647,2464,1981-12-9,1183
1981,12,10,6237,3745,2492,1981-12-10,1253
1981,12,11,5796,3444,2352,1981-12-11,1092
1981,12,12,4921,2653,2268,1981-12-12,385
1981,12,13,4032,1820,2212,1981-12-13,-392
1981,12,14,3220,1134,2086,1981-12-14,-952
1981,12,15,1960,378,1582,1981-12-15,-1204
1981,12,16,1638,182,1456,1981-12-16,-1274
1981,12,17,1162,196,966,1981-12-17,-770
1981,12,18,1120,280,840,1981-12-18,-560
1981,12,19,672,238,434,1981-12-19,-196
1981,12,20,672,294,378,1981-12-20,-84
1981,12,21,812,364,448,1981-12-21,-84
1981,12,22,1022,350,672,1981-12-22,-322
1981,12,23,952,434,518,1981-12-23,-84
1981,12,24,882,490,392,1981-12-24,98
1981,12,25,875,518,357,1981-12-25,161
1981,12,26,952,504,448,1981-12-26,56
1981,12,27,1064,406,658,1981-12-27,-252
1981,12,28,1575,798,777,1981-12-28,21
1981,12,29,1568,854,714,1981-12-29,140
1981,12,30,1281,728,553,1981-12-30,175
1981,12,31,1120,518,602,1981-12-31,-84
1982,1,1,1288,756,532,1982-1-1,224
1982,1,2,1162,448,714,1982-1-2,-266
1982,1,3,980,532,448,1982-1-3,84
1982,1,4,924,448,476,1982-1-4,-28
1982,1,5,714,294,420,1982-1-5,-126
1982,1,6,910,462,448,1982-1-6,14
1982,1,7,994,546,448,1982-1-7,98
1982,1,8,1232,714,518,1982-1-8,196
1982,1,9,1148,574,574,1982-1-9,0
1982,1,10,1302,658,644,1982-1-10,14
1982,1,11,616,0,616,1982-1-11,-616
1982,1,12,826,0,826,1982-1-12,-826
1982,1,13,966,14,952,1982-1-13,-938
1982,1,14,980,196,784,1982-1-14,-588
1982,1,15,1022,364,658,1982-1-15,-294
1982,1,16,966,490,476,1982-1-16,14
1982,1,17,1106,588,518,1982-1-17,70
1982,1,18,1540,644,896,1982-1-18,-252
1982,1,19,2170,728,1442,1982-1-19,-714
1982,1,20,1806,658,1148,1982-1-20,-490
1982,1,21,2030,616,1414,1982-1-21,-798
1982,1,22,1932,910,1022,1982-1-22,-112
1982,1,23,826,294,532,1982-1-23,-238
1982,1,24,560,350,210,1982-1-24,140
1982,1,25,1288,1092,196,1982-1-25,896
1982,1,26,1610,1078,532,1982-1-26,546
1982,1,27,2058,1204,854,1982-1-27,350
1982,1,28,3430,1652,1778,1982-1-28,-126
1982,1,29,4032,1400,2632,1982-1-29,-1232
1982,1,30,4788,1708,3080,1982-1-30,-1372
1982,1,31,4634,1820,2814,1982-1-31,-994
1982,2,1,5054,1778,3276,1982-2-1,-1498
1982,2,2,4200,1554,2646,1982-2-2,-1092
1982,2,3,5222,1512,3710,1982-2-3,-2198
1982,2,4,5096,798,4298,1982-2-4,-3500
1982,2,5,5530,868,4662,1982-2-5,-3794
1982,2,6,6258,966,5292,1982-2-6,-4326
1982,2,7,5362,924,4438,1982-2-7,-3514
1982,2,8,6062,1344,4718,1982-2-8,-3374
1982,2,9,4508,672,3836,1982-2-9,-3164
1982,2,10,4116,602,3514,1982-2-10,-2912
1982,2,11,4312,826,3486,1982-2-11,-2660
1982,2,12,4284,1162,3122,1982-2-12,-1960
1982,2,13,5264,2128,3136,1982-2-13,-1008
1982,2,14,4844,1624,3220,1982-2-14,-1596
1982,2,15,4284,1750,2534,1982-2-15,-784
1982,2,16,3206,1540,1666,1982-2-16,-126
1982,2,17,2310,2114,196,1982-2-17,1918
1982,2,18,2184,2114,70,1982-2-18,2044
1982,2,19,2352,2016,336,1982-2-19,1680
1982,2,20,2688,2212,476,1982-2-20,1736
1982,2,21,2338,1722,616,1982-2-21,1106
1982,2,22,2156,1484,672,1982-2-22,812
1982,2,23,2072,1330,742,1982-2-23,588
1982,2,24,1722,882,840,1982-2-24,42
1982,2,25,2282,1400,882,1982-2-25,518
1982,2,26,2702,1414,1288,1982-2-26,126
1982,2,27,3724,1344,2380,1982-2-27,-1036
1982,2,28,3864,1526,2338,1982-2-28,-812
1982,3,1,3794,1386,2408,1982-3-1,-1022
1982,3,2,3920,1288,2632,1982-3-2,-1344
1982,3,3,3276,980,2296,1982-3-3,-1316
1982,3,4,3332,1232,2100,1982-3-4,-868
1982,3,5,4508,1890,2618,1982-3-5,-728
1982,3,6,3430,1400,2030,1982-3-6,-630
1982,3,7,3150,1218,1932,1982-3-7,-714
1982,3,8,2716,882,1834,1982-3-8,-952
1982,3,9,1820,798,1022,1982-3-9,-224
1982,3,10,2296,1344,952,1982-3-10,392
1982,3,11,1694,1260,434,1982-3-11,826
1982,3,12,2492,1904,588,1982-3-12,1316
1982,3,13,2772,1554,1218,1982-3-13,336
1982,3,14,3234,1946,1288,1982-3-14,658
1982,3,15,3500,2086,1414,1982-3-15,672
1982,3,16,4130,2170,1960,1982-3-16,210
1982,3,17,4788,2674,2114,1982-3-17,560
1982,3,18,5446,2800,2646,1982-3-18,154
1982,3,19,5208,2366,2842,1982-3-19,-476
1982,3,20,4634,2100,2534,1982-3-20,-434
1982,3,21,4270,1960,2310,1982-3-21,-350
1982,3,22,4872,2380,2492,1982-3-22,-112
1982,3,23,4424,2478,1946,1982-3-23,532
1982,3,24,3654,2576,1078,1982-3-24,1498
1982,3,25,4242,2730,1512,1982-3-25,1218
1982,3,26,3318,2450,868,1982-3-26,1582
1982,3,27,3864,2800,1064,1982-3-27,1736
1982,3,28,3332,2450,882,1982-3-28,1568
1982,3,29,3094,2184,910,1982-3-29,1274
1982,3,30,3066,2030,1036,1982-3-30,994
1982,3,31,2380,1862,518,1982-3-31,1344
1982,4,1,2268,1848,420,1982-4-1,1428
1982,4,2,2506,2016,490,1982-4-2,1526
1982,4,3,2702,1526,1176,1982-4-3,350
1982,4,4,1778,1036,742,1982-4-4,294
1982,4,5,868,378,490,1982-4-5,-112
1982,4,6,1344,658,686,1982-4-6,-28
1982,4,7,1484,756,728,1982-4-7,28
1982,4,8,1624,1106,518,1982-4-8,588
1982,4,9,1596,770,826,1982-4-9,-56
1982,4,10,2170,980,1190,1982-4-10,-210
1982,4,11,2198,1148,1050,1982-4-11,98
1982,4,12,1960,1162,798,1982-4-12,364
1982,4,13,2618,1792,826,1982-4-13,966
1982,4,14,2212,1400,812,1982-4-14,588
1982,4,15,1973,1273,699,1982-4-15,574
1982,4,16,2016,1204,812,1982-4-16,392
1982,4,17,1750,826,924,1982-4-17,-98
1982,4,18,1932,882,1050,1982-4-18,-168
1982,4,19,1862,980,882,1982-4-19,98
1982,4,20,2338,1358,980,1982-4-20,378
1982,4,21,1862,1372,490,1982-4-21,882
1982,4,22,1484,1232,252,1982-4-22,980
1982,4,23,2184,2002,182,1982-4-23,1820
1982,4,24,2786,2562,224,1982-4-24,2338
1982,4,25,2688,2352,336,1982-4-25,2016
1982,4,26,2282,1960,322,1982-4-26,1638
1982,4,27,2240,1848,392,1982-4-27,1456
1982,4,28,1848,1400,448,1982-4-28,952
1982,4,29,1484,1176,308,1982-4-29,868
1982,4,30,1498,938,560,1982-4-30,378
1982,5,1,1470,686,784,1982-5-1,-98
1982,5,2,798,84,714,1982-5-2,-630
1982,5,3,1456,28,1428,1982-5-3,-1400
1982,5,4,1316,294,1022,1982-5-4,-728
1982,5,5,1778,322,1456,1982-5-5,-1134
1982,5,6,1442,168,1274,1982-5-6,-1106
1982,5,7,1512,252,1260,1982-5-7,-1008
1982,5,8,1414,196,1218,1982-5-8,-1022
1982,5,9,1036,182,854,1982-5-9,-672
1982,5,10,1064,350,714,1982-5-10,-364
1982,5,11,1288,392,896,1982-5-11,-504
1982,5,12,1652,518,1134,1982-5-12,-616
1982,5,13,980,364,616,1982-5-13,-252
1982,5,14,910,448,462,1982-5-14,-14
1982,5,15,854,392,462,1982-5-15,-70
1982,5,16,1246,630,616,1982-5-16,14
1982,5,17,1344,756,588,1982-5-17,168
1982,5,18,1428,938,490,1982-5-18,448
1982,5,19,1484,980,504,1982-5-19,476
1982,5,20,2114,1666,448,1982-5-20,1218
1982,5,21,1806,1428,378,1982-5-21,1050
1982,5,22,1876,1442,434,1982-5-22,1008
1982,5,23,1470,1120,350,1982-5-23,770
1982,5,24,994,812,182,1982-5-24,630
1982,5,25,1050,868,182,1982-5-25,686
1982,5,26,1162,686,476,1982-5-26,210
1982,5,27,1484,574,910,1982-5-27,-336
1982,5,28,2100,392,1708,1982-5-28,-1316
1982,5,29,1610,28,1582,1982-5-29,-1554
1982,5,30,1344,28,1316,1982-5-30,-1288
1982,5,31,1610,154,1456,1982-5-31,-1302
1982,6,1,868,336,532,1982-6-1,-196
1982,6,2,1708,434,1274,1982-6-2,-840
1982,6,3,2072,308,1764,1982-6-3,-1456
1982,6,4,2156,252,1904,1982-6-4,-1652
1982,6,5,2044,266,1778,1982-6-5,-1512
1982,6,6,2114,406,1708,1982-6-6,-1302
1982,6,7,2086,308,1778,1982-6-7,-1470
1982,6,8,2044,252,1792,1982-6-8,-1540
1982,6,9,2422,364,2058,1982-6-9,-1694
1982,6,10,2954,868,2086,1982-6-10,-1218
1982,6,11,3878,1442,2436,1982-6-11,-994
1982,6,12,5782,3626,2156,1982-6-12,1470
1982,6,13,7378,4998,2380,1982-6-13,2618
1982,6,14,6356,4928,1428,1982-6-14,3500
1982,6,15,5390,4396,994,1982-6-15,3402
1982,6,16,4886,4018,868,1982-6-16,3150
1982,6,17,4326,3584,742,1982-6-17,2842
1982,6,18,4606,3990,616,1982-6-18,3374
1982,6,19,4354,3878,476,1982-6-19,3402
1982,6,20,4410,4186,224,1982-6-20,3962
1982,6,21,4438,4158,280,1982-6-21,3878
1982,6,22,3696,3402,294,1982-6-22,3108
1982,6,23,3780,3276,504,1982-6-23,2772
1982,6,24,3332,2856,476,1982-6-24,2380
1982,6,25,2478,1778,700,1982-6-25,1078
1982,6,26,1428,1022,406,1982-6-26,616
1982,6,27,518,294,224,1982-6-27,70
1982,6,28,224,98,126,1982-6-28,-28
1982,6,29,182,42,140,1982-6-29,-98
1982,6,30,210,56,154,1982-6-30,-98
1982,7,1,224,84,140,1982-7-1,-56
1982,7,2,168,84,84,1982-7-2,0
1982,7,3,84,42,42,1982-7-3,0
1982,7,4,210,28,182,1982-7-4,-154
1982,7,5,182,0,182,1982-7-5,-182
1982,7,6,252,14,238,1982-7-6,-224
1982,7,7,336,182,154,1982-7-7,28
1982,7,8,1078,994,84,1982-7-8,910
1982,7,9,2912,2534,378,1982-7-9,2156
1982,7,10,4648,4116,532,1982-7-10,3584
1982,7,11,4578,3612,966,1982-7-11,2646
1982,7,12,5614,4536,1078,1982-7-12,3458
1982,7,13,4564,3318,1246,1982-7-13,2072
1982,7,14,5306,4256,1050,1982-7-14,3206
1982,7,15,5572,4410,1162,1982-7-15,3248
1982,7,16,4536,3598,938,1982-7-16,2660
1982,7,17,4872,3836,1036,1982-7-17,2800
1982,7,18,4382,3486,896,1982-7-18,2590
1982,7,19,3472,2814,658,1982-7-19,2156
1982,7,20,2618,2114,504,1982-7-20,1610
1982,7,21,1162,672,490,1982-7-21,182
1982,7,22,378,224,154,1982-7-22,70
1982,7,23,280,140,140,1982-7-23,0
1982,7,24,182,98,84,1982-7-24,14
1982,7,25,126,98,28,1982-7-25,70
1982,7,26,112,42,70,1982-7-26,-28
1982,7,27,98,84,14,1982-7-27,70
1982,7,28,84,84,0,1982-7-28,84
1982,7,29,126,98,28,1982-7-29,70
1982,7,30,490,168,322,1982-7-30,-154
1982,7,31,532,154,378,1982-7-31,-224
1982,8,1,546,84,462,1982-8-1,-378
1982,8,2,770,70,700,1982-8-2,-630
1982,8,3,1330,490,840,1982-8-3,-350
1982,8,4,1736,952,784,1982-8-4,168
1982,8,5,2646,2086,560,1982-8-5,1526
1982,8,6,2464,1974,490,1982-8-6,1484
1982,8,7,3094,2492,602,1982-8-7,1890
1982,8,8,2842,2324,518,1982-8-8,1806
1982,8,9,2254,1848,406,1982-8-9,1442
1982,8,10,1862,1484,378,1982-8-10,1106
1982,8,11,1904,1316,588,1982-8-11,728
1982,8,12,1162,854,308,1982-8-12,546
1982,8,13,1358,854,504,1982-8-13,350
1982,8,14,1596,770,826,1982-8-14,-56
1982,8,15,1498,434,1064,1982-8-15,-630
1982,8,16,1456,196,1260,1982-8-16,-1064
1982,8,17,1722,280,1442,1982-8-17,-1162
1982,8,18,2688,560,2128,1982-8-18,-1568
1982,8,19,2226,322,1904,1982-8-19,-1582
1982,8,20,2282,364,1918,1982-8-20,-1554
1982,8,21,1540,322,1218,1982-8-21,-896
1982,8,22,1498,798,700,1982-8-22,98
1982,8,23,1722,1050,672,1982-8-23,378
1982,8,24,1764,1190,574,1982-8-24,616
1982,8,25,1918,1358,560,1982-8-25,798
1982,8,26,3318,2576,742,1982-8-26,1834
1982,8,27,3598,2660,938,1982-8-27,1722
1982,8,28,2926,2016,910,1982-8-28,1106
1982,8,29,3024,1974,1050,1982-8-29,924
1982,8,30,2898,2296,602,1982-8-30,1694
1982,8,31,2380,1792,588,1982-8-31,1204
1982,9,1,2044,1442,602,1982-9-1,840
1982,9,2,1694,1106,588,1982-9-2,518
1982,9,3,1624,994,630,1982-9-3,364
1982,9,4,2142,1400,742,1982-9-4,658
1982,9,5,2590,1372,1218,1982-9-5,154
1982,9,6,2044,924,1120,1982-9-6,-196
1982,9,7,1848,826,1022,1982-9-7,-196
1982,9,8,1624,728,896,1982-9-8,-168
1982,9,9,1582,658,924,1982-9-9,-266
1982,9,10,1246,350,896,1982-9-10,-546
1982,9,11,1400,322,1078,1982-9-11,-756
1982,9,12,1246,182,1064,1982-9-12,-882
1982,9,13,4340,140,4200,1982-9-13,-4060
1982,9,14,1820,504,1316,1982-9-14,-812
1982,9,15,1848,658,1190,1982-9-15,-532
1982,9,16,2016,882,1134,1982-9-16,-252
1982,9,17,1512,714,798,1982-9-17,-84
1982,9,18,1092,644,448,1982-9-18,196
1982,9,19,1176,770,406,1982-9-19,364
1982,9,20,1162,756,406,1982-9-20,350
1982,9,21,1050,630,420,1982-9-21,210
1982,9,22,1064,630,434,1982-9-22,196
1982,9,23,1134,672,462,1982-9-23,210
1982,9,24,1652,574,1078,1982-9-24,-504
1982,9,25,1778,798,980,1982-9-25,-182
1982,9,26,1722,798,924,1982-9-26,-126
1982,9,27,1722,966,756,1982-9-27,210
1982,9,28,1834,1050,784,1982-9-28,266
1982,9,29,2618,1540,1078,1982-9-29,462
1982,9,30,2730,1540,1190,1982-9-30,350
1982,10,1,3010,1568,1442,1982-10-1,126
1982,10,2,3542,1666,1876,1982-10-2,-210
1982,10,3,2982,1470,1512,1982-10-3,-42
1982,10,4,2982,1708,1274,1982-10-4,434
1982,10,5,2408,1638,770,1982-10-5,868
1982,10,6,1204,1036,168,1982-10-6,868
1982,10,7,434,280,154,1982-10-7,126
1982,10,8,322,196,126,1982-10-8,70
1982,10,9,406,266,140,1982-10-9,126
1982,10,10,546,364,182,1982-10-10,182
1982,10,11,546,406,140,1982-10-11,266
1982,10,12,812,504,308,1982-10-12,196
1982,10,13,1064,560,504,1982-10-13,56
1982,10,14,952,504,448,1982-10-14,56
1982,10,15,910,462,448,1982-10-15,14
1982,10,16,854,308,546,1982-10-16,-238
1982,10,17,560,126,434,1982-10-17,-308
1982,10,18,672,112,560,1982-10-18,-448
1982,10,19,1190,112,1078,1982-10-19,-966
1982,10,20,1260,70,1190,1982-10-20,-1120
1982,10,21,1988,406,1582,1982-10-21,-1176
1982,10,22,2058,448,1610,1982-10-22,-1162
1982,10,23,2086,616,1470,1982-10-23,-854
1982,10,24,1918,742,1176,1982-10-24,-434
1982,10,25,1792,784,1008,1982-10-25,-224
1982,10,26,2114,840,1274,1982-10-26,-434
1982,10,27,2310,714,1596,1982-10-27,-882
1982,10,28,1988,518,1470,1982-10-28,-952
1982,10,29,1624,490,1134,1982-10-29,-644
1982,10,30,1582,518,1064,1982-10-30,-546
1982,10,31,1610,588,1022,1982-10-31,-434
1982,11,1,1568,1050,518,1982-11-1,532
1982,11,2,1414,742,672,1982-11-2,70
1982,11,3,630,546,84,1982-11-3,462
1982,11,4,728,532,196,1982-11-4,336
1982,11,5,476,336,140,1982-11-5,196
1982,11,6,574,462,112,1982-11-6,350
1982,11,7,756,546,210,1982-11-7,336
1982,11,8,1400,560,840,1982-11-8,-280
1982,11,9,1498,392,1106,1982-11-9,-714
1982,11,10,1722,350,1372,1982-11-10,-1022
1982,11,11,1708,280,1428,1982-11-11,-1148
1982,11,12,1750,140,1610,1982-11-12,-1470
1982,11,13,1820,154,1666,1982-11-13,-1512
1982,11,14,1988,112,1876,1982-11-14,-1764
1982,11,15,1918,168,1750,1982-11-15,-1582
1982,11,16,1526,0,1526,1982-11-16,-1526
1982,11,17,1890,14,1876,1982-11-17,-1862
1982,11,18,2044,294,1750,1982-11-18,-1456
1982,11,19,2324,350,1974,1982-11-19,-1624
1982,11,20,2940,378,2562,1982-11-20,-2184
1982,11,21,3038,392,2646,1982-11-21,-2254
1982,11,22,3262,700,2562,1982-11-22,-1862
1982,11,23,4200,1260,2940,1982-11-23,-1680
1982,11,24,3206,518,2688,1982-11-24,-2170
1982,11,25,2926,462,2464,1982-11-25,-2002
1982,11,26,1162,294,868,1982-11-26,-574
1982,11,27,1358,224,1134,1982-11-27,-910
1982,11,28,1736,266,1470,1982-11-28,-1204
1982,11,29,2086,336,1750,1982-11-29,-1414
1982,11,30,1890,518,1372,1982-11-30,-854
1982,12,1,2618,574,2044,1982-12-1,-1470
1982,12,2,1778,560,1218,1982-12-2,-658
1982,12,3,1988,854,1134,1982-12-3,-280
1982,12,4,1988,798,1190,1982-12-4,-392
1982,12,5,3010,994,2016,1982-12-5,-1022
1982,12,6,3794,1274,2520,1982-12-6,-1246
1982,12,7,5180,2520,2660,1982-12-7,-140
1982,12,8,4788,2730,2058,1982-12-8,672
1982,12,9,4228,2184,2044,1982-12-9,140
1982,12,10,4746,2436,2310,1982-12-10,126
1982,12,11,5740,2156,3584,1982-12-11,-1428
1982,12,12,4788,1708,3080,1982-12-12,-1372
1982,12,13,3556,952,2604,1982-12-13,-1652
1982,12,14,2968,574,2394,1982-12-14,-1820
1982,12,15,2632,588,2044,1982-12-15,-1456
1982,12,16,2758,602,2156,1982-12-16,-1554
1982,12,17,2576,602,1974,1982-12-17,-1372
1982,12,18,2436,812,1624,1982-12-18,-812
1982,12,19,1526,630,896,1982-12-19,-266
1982,12,20,1316,560,756,1982-12-20,-196
1982,12,21,1302,56,1246,1982-12-21,-1190
1982,12,22,1358,42,1316,1982-12-22,-1274
1982,12,23,1806,56,1750,1982-12-23,-1694
1982,12,24,1974,84,1890,1982-12-24,-1806
1982,12,25,1666,224,1442,1982-12-25,-1218
1982,12,26,2226,378,1848,1982-12-26,-1470
1982,12,27,2520,742,1778,1982-12-27,-1036
1982,12,28,2212,924,1288,1982-12-28,-364
1982,12,29,1974,840,1134,1982-12-29,-294
1982,12,30,1260,490,770,1982-12-30,-280
1982,12,31,1218,420,798,1982-12-31,-378
1983,1,1,868,420,448,1983-1-1,-28
1983,1,2,728,392,336,1983-1-2,56
1983,1,3,840,434,406,1983-1-3,28
1983,1,4,686,350,336,1983-1-4,14
1983,1,5,980,350,630,1983-1-5,-280
1983,1,6,1414,364,1050,1983-1-6,-686
1983,1,7,1792,434,1358,1983-1-7,-924
1983,1,8,1596,336,1260,1983-1-8,-924
1983,1,9,1358,210,1148,1983-1-9,-938
1983,1,10,1386,28,1358,1983-1-10,-1330
1983,1,11,672,42,630,1983-1-11,-588
1983,1,12,952,378,574,1983-1-12,-196
1983,1,13,1470,658,812,1983-1-13,-154
1983,1,14,1092,616,476,1983-1-14,140
1983,1,15,1428,728,700,1983-1-15,28
1983,1,16,1540,812,728,1983-1-16,84
1983,1,17,1526,784,742,1983-1-17,42
1983,1,18,1652,826,826,1983-1-18,0
1983,1,19,1484,700,784,1983-1-19,-84
1983,1,20,1358,644,714,1983-1-20,-70
1983,1,21,1092,532,560,1983-1-21,-28
1983,1,22,980,448,532,1983-1-22,-84
1983,1,23,756,434,322,1983-1-23,112
1983,1,24,980,644,336,1983-1-24,308
1983,1,25,742,518,224,1983-1-25,294
1983,1,26,1148,770,378,1983-1-26,392
1983,1,27,1162,700,462,1983-1-27,238
1983,1,28,1134,616,518,1983-1-28,98
1983,1,29,1358,630,728,1983-1-29,-98
1983,1,30,1554,588,966,1983-1-30,-378
1983,1,31,1918,560,1358,1983-1-31,-798
1983,2,1,2352,546,1806,1983-2-1,-1260
1983,2,2,2086,364,1722,1983-2-2,-1358
1983,2,3,1708,364,1344,1983-2-3,-980
1983,2,4,1918,238,1680,1983-2-4,-1442
1983,2,5,2030,154,1876,1983-2-5,-1722
1983,2,6,2142,14,2128,1983-2-6,-2114
1983,2,7,1596,0,1596,1983-2-7,-1596
1983,2,8,1736,0,1736,1983-2-8,-1736
1983,2,9,1190,28,1162,1983-2-9,-1134
1983,2,10,714,42,672,1983-2-10,-630
1983,2,11,532,28,504,1983-2-11,-476
1983,2,12,224,28,196,1983-2-12,-168
1983,2,13,112,28,84,1983-2-13,-56
1983,2,14,28,28,0,1983-2-14,28
1983,2,15,42,28,14,1983-2-15,14
1983,2,16,56,14,42,1983-2-16,-28
1983,2,17,238,0,238,1983-2-17,-238
1983,2,18,392,0,392,1983-2-18,-392
1983,2,19,350,0,350,1983-2-19,-350
1983,2,20,280,28,252,1983-2-20,-224
1983,2,21,350,112,238,1983-2-21,-126
1983,2,22,322,126,196,1983-2-22,-70
1983,2,23,518,280,238,1983-2-23,42
1983,2,24,1008,420,588,1983-2-24,-168
1983,2,25,938,392,546,1983-2-25,-154
1983,2,26,1120,350,770,1983-2-26,-420
1983,2,27,1302,266,1036,1983-2-27,-770
1983,2,28,1526,252,1274,1983-2-28,-1022
1983,3,1,1582,182,1400,1983-3-1,-1218
1983,3,2,1666,168,1498,1983-3-2,-1330
1983,3,3,1526,154,1372,1983-3-3,-1218
1983,3,4,1582,112,1470,1983-3-4,-1358
1983,3,5,1596,84,1512,1983-3-5,-1428
1983,3,6,1218,14,1204,1983-3-6,-1190
1983,3,7,1204,0,1204,1983-3-7,-1204
1983,3,8,952,0,952,1983-3-8,-952
1983,3,9,1050,28,1022,1983-3-9,-994
1983,3,10,924,28,896,1983-3-10,-868
1983,3,11,574,14,560,1983-3-11,-546
1983,3,12,196,0,196,1983-3-12,-196
1983,3,13,28,0,28,1983-3-13,-28
1983,3,14,308,42,266,1983-3-14,-224
1983,3,15,504,42,462,1983-3-15,-420
1983,3,16,952,56,896,1983-3-16,-840
1983,3,17,1120,28,1092,1983-3-17,-1064
1983,3,18,1134,42,1092,1983-3-18,-1050
1983,3,19,1120,14,1106,1983-3-19,-1092
1983,3,20,1358,0,1358,1983-3-20,-1358
1983,3,21,1204,0,1204,1983-3-21,-1204
1983,3,22,1162,0,1162,1983-3-22,-1162
1983,3,23,994,0,994,1983-3-23,-994
1983,3,24,1050,42,1008,1983-3-24,-966
1983,3,25,574,42,532,1983-3-25,-490
1983,3,26,938,210,728,1983-3-26,-518
1983,3,27,490,154,336,1983-3-27,-182
1983,3,28,238,0,238,1983-3-28,-238
1983,3,29,210,0,210,1983-3-29,-210
1983,3,30,308,0,308,1983-3-30,-308
1983,3,31,322,0,322,1983-3-31,-322
1983,4,1,364,0,364,1983-4-1,-364
1983,4,2,448,0,448,1983-4-2,-448
1983,4,3,504,0,504,1983-4-3,-504
1983,4,4,336,0,336,1983-4-4,-336
1983,4,5,868,0,868,1983-4-5,-868
1983,4,6,350,0,350,1983-4-6,-350
1983,4,7,504,0,504,1983-4-7,-504
1983,4,8,490,0,490,1983-4-8,-490
1983,4,9,504,0,504,1983-4-9,-504
1983,4,10,588,0,588,1983-4-10,-588
1983,4,11,658,0,658,1983-4-11,-658
1983,4,12,364,0,364,1983-4-12,-364
1983,4,13,462,70,392,1983-4-13,-322
1983,4,14,308,28,280,1983-4-14,-252
1983,4,15,350,182,168,1983-4-15,14
1983,4,16,490,280,210,1983-4-16,70
1983,4,17,630,168,462,1983-4-17,-294
1983,4,18,1106,238,868,1983-4-18,-630
1983,4,19,1274,70,1204,1983-4-19,-1134
1983,4,20,1512,98,1414,1983-4-20,-1316
1983,4,21,1344,84,1260,1983-4-21,-1176
1983,4,22,1330,70,1260,1983-4-22,-1190
1983,4,23,1512,154,1358,1983-4-23,-1204
1983,4,24,2968,182,2786,1983-4-24,-2604
1983,4,25,1890,308,1582,1983-4-25,-1274
1983,4,26,1652,294,1358,1983-4-26,-1064
1983,4,27,1358,252,1106,1983-4-27,-854
1983,4,28,1512,112,1400,1983-4-28,-1288
1983,4,29,1722,140,1582,1983-4-29,-1442
1983,4,30,1904,112,1792,1983-4-30,-1680
1983,5,1,1512,84,1428,1983-5-1,-1344
1983,5,2,1960,98,1862,1983-5-2,-1764
1983,5,3,1358,42,1316,1983-5-3,-1274
1983,5,4,1274,28,1246,1983-5-4,-1218
1983,5,5,1330,56,1274,1983-5-5,-1218
1983,5,6,910,28,882,1983-5-6,-854
1983,5,7,1176,28,1148,1983-5-7,-1120
1983,5,8,1372,140,1232,1983-5-8,-1092
1983,5,9,1526,154,1372,1983-5-9,-1218
1983,5,10,1736,154,1582,1983-5-10,-1428
1983,5,11,2926,56,2870,1983-5-11,-2814
1983,5,12,3682,252,3430,1983-5-12,-3178
1983,5,13,3220,182,3038,1983-5-13,-2856
1983,5,14,4564,266,4298,1983-5-14,-4032
1983,5,15,2156,196,1960,1983-5-15,-1764
1983,5,16,1568,196,1372,1983-5-16,-1176
1983,5,17,1918,588,1330,1983-5-17,-742
1983,5,18,1246,448,798,1983-5-18,-350
1983,5,19,2058,994,1064,1983-5-19,-70
1983,5,20,1638,994,644,1983-5-20,350
1983,5,21,2030,1344,686,1983-5-21,658
1983,5,22,1596,1064,532,1983-5-22,532
1983,5,23,1736,966,770,1983-5-23,196
1983,5,24,1232,560,672,1983-5-24,-112
1983,5,25,1260,518,742,1983-5-25,-224
1983,5,26,952,406,546,1983-5-26,-140
1983,5,27,882,420,462,1983-5-27,-42
1983,5,28,924,476,448,1983-5-28,28
1983,5,29,966,294,672,1983-5-29,-378
1983,5,30,1358,14,1344,1983-5-30,-1330
1983,5,31,1764,0,1764,1983-5-31,-1764
1983,6,1,1358,0,1358,1983-6-1,-1358
1983,6,2,1106,0,1106,1983-6-2,-1106
1983,6,3,1162,0,1162,1983-6-3,-1162
1983,6,4,1834,0,1834,1983-6-4,-1834
1983,6,5,2814,0,2814,1983-6-5,-2814
1983,6,6,3640,0,3640,1983-6-6,-3640
1983,6,7,3808,0,3808,1983-6-7,-3808
1983,6,8,3164,0,3164,1983-6-8,-3164
1983,6,9,3556,0,3556,1983-6-9,-3556
1983,6,10,2674,14,2660,1983-6-10,-2646
1983,6,11,1974,0,1974,1983-6-11,-1974
1983,6,12,896,0,896,1983-6-12,-896
1983,6,13,1022,308,714,1983-6-13,-406
1983,6,14,882,336,546,1983-6-14,-210
1983,6,15,798,308,490,1983-6-15,-182
1983,6,16,868,420,448,1983-6-16,-28
1983,6,17,672,392,280,1983-6-17,112
1983,6,18,714,462,252,1983-6-18,210
1983,6,19,980,756,224,1983-6-19,532
1983,6,20,1134,770,364,1983-6-20,406
1983,6,21,994,574,420,1983-6-21,154
1983,6,22,1232,868,364,1983-6-22,504
1983,6,23,1302,966,336,1983-6-23,630
1983,6,24,1372,1078,294,1983-6-24,784
1983,6,25,1232,896,336,1983-6-25,560
1983,6,26,1596,854,742,1983-6-26,112
1983,6,27,1428,952,476,1983-6-27,476
1983,6,28,1274,672,602,1983-6-28,70
1983,6,29,1036,406,630,1983-6-29,-224
1983,6,30,812,140,672,1983-6-30,-532
1983,7,1,812,154,658,1983-7-1,-504
1983,7,2,798,126,672,1983-7-2,-546
1983,7,3,1064,0,1064,1983-7-3,-1064
1983,7,4,994,0,994,1983-7-4,-994
1983,7,5,938,0,938,1983-7-5,-938
1983,7,6,1344,0,1344,1983-7-6,-1344
1983,7,7,1274,0,1274,1983-7-7,-1274
1983,7,8,1442,0,1442,1983-7-8,-1442
1983,7,9,1330,14,1316,1983-7-9,-1302
1983,7,10,994,0,994,1983-7-10,-994
1983,7,11,1526,42,1484,1983-7-11,-1442
1983,7,12,1232,28,1204,1983-7-12,-1176
1983,7,13,1120,210,910,1983-7-13,-700
1983,7,14,1148,434,714,1983-7-14,-280
1983,7,15,882,392,490,1983-7-15,-98
1983,7,16,770,406,364,1983-7-16,42
1983,7,17,826,406,420,1983-7-17,-14
1983,7,18,784,392,392,1983-7-18,0
1983,7,19,434,238,196,1983-7-19,42
1983,7,20,532,322,210,1983-7-20,112
1983,7,21,756,448,308,1983-7-21,140
1983,7,22,1162,616,546,1983-7-22,70
1983,7,23,1232,532,700,1983-7-23,-168
1983,7,24,966,518,448,1983-7-24,70
1983,7,25,1260,616,644,1983-7-25,-28
1983,7,26,1064,462,602,1983-7-26,-140
1983,7,27,728,238,490,1983-7-27,-252
1983,7,28,1358,98,1260,1983-7-28,-1162
1983,7,29,1582,14,1568,1983-7-29,-1554
1983,7,30,1890,84,1806,1983-7-30,-1722
1983,7,31,2016,112,1904,1983-7-31,-1792
1983,8,1,1694,196,1498,1983-8-1,-1302
1983,8,2,1596,196,1400,1983-8-2,-1204
1983,8,3,1484,56,1428,1983-8-3,-1372
1983,8,4,1288,56,1232,1983-8-4,-1176
1983,8,5,1036,28,1008,1983-8-5,-980
1983,8,6,1078,56,1022,1983-8-6,-966
1983,8,7,1120,28,1092,1983-8-7,-1064
1983,8,8,1358,28,1330,1983-8-8,-1302
1983,8,9,3556,0,3556,1983-8-9,-3556
1983,8,10,1414,98,1316,1983-8-10,-1218
1983,8,11,1316,112,1204,1983-8-11,-1092
1983,8,12,1344,168,1176,1983-8-12,-1008
1983,8,13,854,140,714,1983-8-13,-574
1983,8,14,742,112,630,1983-8-14,-518
1983,8,15,924,154,770,1983-8-15,-616
1983,8,16,616,98,518,1983-8-16,-420
1983,8,17,770,252,518,1983-8-17,-266
1983,8,18,462,224,238,1983-8-18,-14
1983,8,19,266,112,154,1983-8-19,-42
1983,8,20,154,140,14,1983-8-20,126
1983,8,21,154,98,56,1983-8-21,42
1983,8,22,154,98,56,1983-8-22,42
1983,8,23,182,98,84,1983-8-23,14
1983,8,24,364,154,210,1983-8-24,-56
1983,8,25,252,28,224,1983-8-25,-196
1983,8,26,294,14,280,1983-8-26,-266
1983,8,27,364,28,336,1983-8-27,-308
1983,8,28,378,0,378,1983-8-28,-378
1983,8,29,308,0,308,1983-8-29,-308
1983,8,30,406,126,280,1983-8-30,-154
1983,8,31,294,70,224,1983-8-31,-154
1983,9,1,560,98,462,1983-9-1,-364
1983,9,2,658,112,546,1983-9-2,-434
1983,9,3,392,112,280,1983-9-3,-168
1983,9,4,644,182,462,1983-9-4,-280
1983,9,5,672,266,406,1983-9-5,-140
1983,9,6,588,308,280,1983-9-6,28
1983,9,7,504,280,224,1983-9-7,56
1983,9,8,588,336,252,1983-9-8,84
1983,9,9,588,322,266,1983-9-9,56
1983,9,10,364,154,210,1983-9-10,-56
1983,9,11,168,70,98,1983-9-11,-28
1983,9,12,168,42,126,1983-9-12,-84
1983,9,13,196,42,154,1983-9-13,-112
1983,9,14,280,0,280,1983-9-14,-280
1983,9,15,336,14,322,1983-9-15,-308
1983,9,16,336,0,336,1983-9-16,-336
1983,9,17,448,0,448,1983-9-17,-448
1983,9,18,434,28,406,1983-9-18,-378
1983,9,19,266,14,252,1983-9-19,-238
1983,9,20,252,14,238,1983-9-20,-224
1983,9,21,210,42,168,1983-9-21,-126
1983,9,22,504,0,504,1983-9-22,-504
1983,9,23,1008,0,1008,1983-9-23,-1008
1983,9,24,1120,14,1106,1983-9-24,-1092
1983,9,25,1134,42,1092,1983-9-25,-1050
1983,9,26,1232,14,1218,1983-9-26,-1204
1983,9,27,1302,0,1302,1983-9-27,-1302
1983,9,28,1050,0,1050,1983-9-28,-1050
1983,9,29,1260,28,1232,1983-9-29,-1204
1983,9,30,952,14,938,1983-9-30,-924
1983,10,1,924,14,910,1983-10-1,-896
1983,10,2,1400,532,868,1983-10-2,-336
1983,10,3,2688,1736,952,1983-10-3,784
1983,10,4,1960,1666,294,1983-10-4,1372
1983,10,5,1540,1526,14,1983-10-5,1512
1983,10,6,1470,1260,210,1983-10-6,1050
1983,10,7,1456,1190,266,1983-10-7,924
1983,10,8,1526,1288,238,1983-10-8,1050
1983,10,9,1358,1190,168,1983-10-9,1022
1983,10,10,1288,1106,182,1983-10-10,924
1983,10,11,1470,826,644,1983-10-11,182
1983,10,12,1456,840,616,1983-10-12,224
1983,10,13,1442,952,490,1983-10-13,462
1983,10,14,1148,896,252,1983-10-14,644
1983,10,15,1456,1246,210,1983-10-15,1036
1983,10,16,1358,1120,238,1983-10-16,882
1983,10,17,1246,1036,210,1983-10-17,826
1983,10,18,1120,910,210,1983-10-18,700
1983,10,19,882,742,140,1983-10-19,602
1983,10,20,112,0,112,1983-10-20,-112
1983,10,21,98,28,70,1983-10-21,-42
1983,10,22,28,0,28,1983-10-22,-28
1983,10,23,28,0,28,1983-10-23,-28
1983,10,24,84,0,84,1983-10-24,-84
1983,10,25,140,0,140,1983-10-25,-140
1983,10,26,70,0,70,1983-10-26,-70
1983,10,27,84,0,84,1983-10-27,-84
1983,10,28,70,0,70,1983-10-28,-70
1983,10,29,28,0,28,1983-10-29,-28
1983,10,30,42,0,42,1983-10-30,-42
1983,10,31,56,0,56,1983-10-31,-56
1983,11,1,56,14,42,1983-11-1,-28
1983,11,2,434,126,308,1983-11-2,-182
1983,11,3,350,98,252,1983-11-3,-154
1983,11,4,504,126,378,1983-11-4,-252
1983,11,5,560,140,420,1983-11-5,-280
1983,11,6,560,168,392,1983-11-6,-224
1983,11,7,546,126,420,1983-11-7,-294
1983,11,8,476,154,322,1983-11-8,-168
1983,11,9,322,112,210,1983-11-9,-98
1983,11,10,364,70,294,1983-11-10,-224
1983,11,11,252,56,196,1983-11-11,-140
1983,11,12,252,56,196,1983-11-12,-140
1983,11,13,126,14,112,1983-11-13,-98
1983,11,14,196,0,196,1983-11-14,-196
1983,11,15,84,0,84,1983-11-15,-84
1983,11,16,280,14,266,1983-11-16,-252
1983,11,17,140,0,140,1983-11-17,-140
1983,11,18,196,0,196,1983-11-18,-196
1983,11,19,112,0,112,1983-11-19,-112
1983,11,20,28,0,28,1983-11-20,-28
1983,11,21,0,0,0,1983-11-21,0
1983,11,22,0,0,0,1983-11-22,0
1983,11,23,0,0,0,1983-11-23,0
1983,11,24,0,0,0,1983-11-24,0
1983,11,25,0,0,0,1983-11-25,0
1983,11,26,0,0,0,1983-11-26,0
1983,11,27,14,14,0,1983-11-27,14
1983,11,28,98,98,0,1983-11-28,98
1983,11,29,70,70,0,1983-11-29,70
1983,11,30,84,84,0,1983-11-30,84
1983,12,1,112,98,14,1983-12-1,84
1983,12,2,84,84,0,1983-12-2,84
1983,12,3,42,42,0,1983-12-3,42
1983,12,4,98,56,42,1983-12-4,14
1983,12,5,1554,14,1540,1983-12-5,-1526
1983,12,6,280,28,252,1983-12-6,-224
1983,12,7,350,0,350,1983-12-7,-350
1983,12,8,420,84,336,1983-12-8,-252
1983,12,9,644,308,336,1983-12-9,-28
1983,12,10,728,392,336,1983-12-10,56
1983,12,11,476,266,210,1983-12-11,56
1983,12,12,406,224,182,1983-12-12,42
1983,12,13,392,168,224,1983-12-13,-56
1983,12,14,280,98,182,1983-12-14,-84
1983,12,15,266,98,168,1983-12-15,-70
1983,12,16,252,70,182,1983-12-16,-112
1983,12,17,490,70,420,1983-12-17,-350
1983,12,18,378,42,336,1983-12-18,-294
1983,12,19,322,28,294,1983-12-19,-266
1983,12,20,238,14,224,1983-12-20,-210
1983,12,21,280,28,252,1983-12-21,-224
1983,12,22,280,0,280,1983-12-22,-280
1983,12,23,182,14,168,1983-12-23,-154
1983,12,24,168,42,126,1983-12-24,-84
1983,12,25,182,84,98,1983-12-25,-14
1983,12,26,70,56,14,1983-12-26,42
1983,12,27,14,14,0,1983-12-27,14
1983,12,28,14,14,0,1983-12-28,14
1983,12,29,42,42,0,1983-12-29,42
1983,12,30,56,56,0,1983-12-30,56
1983,12,31,0,0,0,1983-12-31,0
1984,1,1,14,14,0,1984-1-1,14
1984,1,2,84,84,0,1984-1-2,84
1984,1,3,126,98,28,1984-1-3,70
1984,1,4,224,224,0,1984-1-4,224
1984,1,5,406,350,56,1984-1-5,294
1984,1,6,182,56,126,1984-1-6,-70
1984,1,7,210,14,196,1984-1-7,-182
1984,1,8,252,0,252,1984-1-8,-252
1984,1,9,672,0,672,1984-1-9,-672
1984,1,10,420,0,420,1984-1-10,-420
1984,1,11,728,0,728,1984-1-11,-728
1984,1,12,812,0,812,1984-1-12,-812
1984,1,13,784,0,784,1984-1-13,-784
1984,1,14,1064,0,1064,1984-1-14,-1064
1984,1,15,924,0,924,1984-1-15,-924
1984,1,16,756,0,756,1984-1-16,-756
1984,1,17,924,0,924,1984-1-17,-924
1984,1,18,812,0,812,1984-1-18,-812
1984,1,19,770,0,770,1984-1-19,-770
1984,1,20,896,112,784,1984-1-20,-672
1984,1,21,1386,280,1106,1984-1-21,-826
1984,1,22,1428,896,532,1984-1-22,364
1984,1,23,1610,1190,420,1984-1-23,770
1984,1,24,2604,2366,238,1984-1-24,2128
1984,1,25,2562,2338,224,1984-1-25,2114
1984,1,26,3612,3318,294,1984-1-26,3024
1984,1,27,4186,4046,140,1984-1-27,3906
1984,1,28,4592,4592,0,1984-1-28,4592
1984,1,29,5362,5334,28,1984-1-29,5306
1984,1,30,5656,5642,14,1984-1-30,5628
1984,1,31,4984,4844,140,1984-1-31,4704
1984,2,1,4732,4550,182,1984-2-1,4368
1984,2,2,3822,3738,84,1984-2-2,3654
1984,2,3,3836,3206,630,1984-2-3,2576
1984,2,4,1722,924,798,1984-2-4,126
1984,2,5,1064,112,952,1984-2-5,-840
1984,2,6,1190,126,1064,1984-2-6,-938
1984,2,7,1274,140,1134,1984-2-7,-994
1984,2,8,1358,126,1232,1984-2-8,-1106
1984,2,9,2170,70,2100,1984-2-9,-2030
1984,2,10,2254,84,2170,1984-2-10,-2086
1984,2,11,2562,42,2520,1984-2-11,-2478
1984,2,12,1750,14,1736,1984-2-12,-1722
1984,2,13,1470,0,1470,1984-2-13,-1470
1984,2,14,1414,42,1372,1984-2-14,-1330
1984,2,15,644,28,616,1984-2-15,-588
1984,2,16,518,14,504,1984-2-16,-490
1984,2,17,1134,728,406,1984-2-17,322
1984,2,18,2226,2002,224,1984-2-18,1778
1984,2,19,2786,2744,42,1984-2-19,2702
1984,2,20,2520,2478,42,1984-2-20,2436
1984,2,21,2646,2548,98,1984-2-21,2450
1984,2,22,2492,1890,602,1984-2-22,1288
1984,2,23,3220,2226,994,1984-2-23,1232
1984,2,24,2730,1792,938,1984-2-24,854
1984,2,25,2982,1890,1092,1984-2-25,798
1984,2,26,2534,1722,812,1984-2-26,910
1984,2,27,2072,1526,546,1984-2-27,980
1984,2,28,2366,1568,798,1984-2-28,770
1984,2,29,1582,966,616,1984-2-29,350
1984,3,1,1092,364,728,1984-3-1,-364
1984,3,2,1120,336,784,1984-3-2,-448
1984,3,3,686,84,602,1984-3-3,-518
1984,3,4,588,28,560,1984-3-4,-532
1984,3,5,672,14,658,1984-3-5,-644
1984,3,6,518,0,518,1984-3-6,-518
1984,3,7,532,14,518,1984-3-7,-504
1984,3,8,686,14,672,1984-3-8,-658
1984,3,9,742,14,728,1984-3-9,-714
1984,3,10,532,0,532,1984-3-10,-532
1984,3,11,490,0,490,1984-3-11,-490
1984,3,12,574,0,574,1984-3-12,-574
1984,3,13,882,0,882,1984-3-13,-882
1984,3,14,1582,308,1274,1984-3-14,-966
1984,3,15,1414,224,1190,1984-3-15,-966
1984,3,16,2660,1344,1316,1984-3-16,28
1984,3,17,1260,532,728,1984-3-17,-196
1984,3,18,1050,658,392,1984-3-18,266
1984,3,19,896,616,280,1984-3-19,336
1984,3,20,714,546,168,1984-3-20,378
1984,3,21,798,574,224,1984-3-21,350
1984,3,22,826,616,210,1984-3-22,406
1984,3,23,658,420,238,1984-3-23,182
1984,3,24,532,336,196,1984-3-24,140
1984,3,25,532,224,308,1984-3-25,-84
1984,3,26,826,252,574,1984-3-26,-322
1984,3,27,1554,238,1316,1984-3-27,-1078
1984,3,28,1904,224,1680,1984-3-28,-1456
1984,3,29,1820,210,1610,1984-3-29,-1400
1984,3,30,2030,224,1806,1984-3-30,-1582
1984,3,31,1862,210,1652,1984-3-31,-1442
1984,4,1,1876,182,1694,1984-4-1,-1512
1984,4,2,1582,98,1484,1984-4-2,-1386
1984,4,3,1218,70,1148,1984-4-3,-1078
1984,4,4,1190,70,1120,1984-4-4,-1050
1984,4,5,1162,56,1106,1984-4-5,-1050
1984,4,6,1050,70,980,1984-4-6,-910
1984,4,7,924,42,882,1984-4-7,-840
1984,4,8,280,42,238,1984-4-8,-196
1984,4,9,42,28,14,1984-4-9,14
1984,4,10,28,14,14,1984-4-10,0
1984,4,11,210,182,28,1984-4-11,154
1984,4,12,588,574,14,1984-4-12,560
1984,4,13,742,742,0,1984-4-13,742
1984,4,14,1008,938,70,1984-4-14,868
1984,4,15,1092,924,168,1984-4-15,756
1984,4,16,1344,980,364,1984-4-16,616
1984,4,17,1288,910,378,1984-4-17,532
1984,4,18,1260,924,336,1984-4-18,588
1984,4,19,1232,882,350,1984-4-19,532
1984,4,20,1218,840,378,1984-4-20,462
1984,4,21,1652,1064,588,1984-4-21,476
1984,4,22,1890,266,1624,1984-4-22,-1358
1984,4,23,2870,0,2870,1984-4-23,-2870
1984,4,24,3374,0,3374,1984-4-24,-3374
1984,4,25,3318,14,3304,1984-4-25,-3290
1984,4,26,3864,28,3836,1984-4-26,-3808
1984,4,27,3724,14,3710,1984-4-27,-3696
1984,4,28,3878,14,3864,1984-4-28,-3850
1984,4,29,4004,0,4004,1984-4-29,-4004
1984,4,30,3794,0,3794,1984-4-30,-3794
1984,5,1,3570,0,3570,1984-5-1,-3570
1984,5,2,2828,0,2828,1984-5-2,-2828
1984,5,3,2296,0,2296,1984-5-3,-2296
1984,5,4,1078,0,1078,1984-5-4,-1078
1984,5,5,1162,98,1064,1984-5-5,-966
1984,5,6,1120,1064,56,1984-5-6,1008
1984,5,7,1694,1694,0,1984-5-7,1694
1984,5,8,2562,2520,42,1984-5-8,2478
1984,5,9,2492,2464,28,1984-5-9,2436
1984,5,10,2674,2548,126,1984-5-10,2422
1984,5,11,2450,2380,70,1984-5-11,2310
1984,5,12,2450,2394,56,1984-5-12,2338
1984,5,13,2324,2156,168,1984-5-13,1988
1984,5,14,2226,2030,196,1984-5-14,1834
1984,5,15,1946,1652,294,1984-5-15,1358
1984,5,16,1260,1050,210,1984-5-16,840
1984,5,17,1344,1106,238,1984-5-17,868
1984,5,18,1470,896,574,1984-5-18,322
1984,5,19,1330,210,1120,1984-5-19,-910
1984,5,20,1316,0,1316,1984-5-20,-1316
1984,5,21,1204,0,1204,1984-5-21,-1204
1984,5,22,1162,0,1162,1984-5-22,-1162
1984,5,23,980,0,980,1984-5-23,-980
1984,5,24,840,14,826,1984-5-24,-812
1984,5,25,1008,0,1008,1984-5-25,-1008
1984,5,26,1036,14,1022,1984-5-26,-1008
1984,5,27,980,42,938,1984-5-27,-896
1984,5,28,882,28,854,1984-5-28,-826
1984,5,29,994,14,980,1984-5-29,-966
1984,5,30,742,0,742,1984-5-30,-742
1984,5,31,770,0,770,1984-5-31,-770
1984,6,1,602,0,602,1984-6-1,-602
1984,6,2,770,210,560,1984-6-2,-350
1984,6,3,616,224,392,1984-6-3,-168
1984,6,4,532,168,364,1984-6-4,-196
1984,6,5,574,182,392,1984-6-5,-210
1984,6,6,476,196,280,1984-6-6,-84
1984,6,7,392,182,210,1984-6-7,-28
1984,6,8,168,154,14,1984-6-8,140
1984,6,9,154,112,42,1984-6-9,70
1984,6,10,154,98,56,1984-6-10,42
1984,6,11,154,70,84,1984-6-11,-14
1984,6,12,210,42,168,1984-6-12,-126
1984,6,13,238,0,238,1984-6-13,-238
1984,6,14,658,28,630,1984-6-14,-602
1984,6,15,714,42,672,1984-6-15,-630
1984,6,16,910,84,826,1984-6-16,-742
1984,6,17,854,70,784,1984-6-17,-714
1984,6,18,840,70,770,1984-6-18,-700
1984,6,19,700,28,672,1984-6-19,-644
1984,6,20,644,28,616,1984-6-20,-588
1984,6,21,574,14,560,1984-6-21,-546
1984,6,22,798,14,784,1984-6-22,-770
1984,6,23,770,0,770,1984-6-23,-770
1984,6,24,728,0,728,1984-6-24,-728
1984,6,25,826,0,826,1984-6-25,-826
1984,6,26,784,154,630,1984-6-26,-476
1984,6,27,868,182,686,1984-6-27,-504
1984,6,28,742,308,434,1984-6-28,-126
1984,6,29,630,378,252,1984-6-29,126
1984,6,30,588,448,140,1984-6-30,308
1984,7,1,406,350,56,1984-7-1,294
1984,7,2,378,336,42,1984-7-2,294
1984,7,3,728,574,154,1984-7-3,420
1984,7,4,784,490,294,1984-7-4,196
1984,7,5,630,308,322,1984-7-5,-14
1984,7,6,518,266,252,1984-7-6,14
1984,7,7,546,252,294,1984-7-7,-42
1984,7,8,378,112,266,1984-7-8,-154
1984,7,9,406,98,308,1984-7-9,-210
1984,7,10,532,70,462,1984-7-10,-392
1984,7,11,462,0,462,1984-7-11,-462
1984,7,12,560,0,560,1984-7-12,-560
1984,7,13,238,0,238,1984-7-13,-238
1984,7,14,182,14,168,1984-7-14,-154
1984,7,15,210,0,210,1984-7-15,-210
1984,7,16,154,0,154,1984-7-16,-154
1984,7,17,126,14,112,1984-7-17,-98
1984,7,18,210,0,210,1984-7-18,-210
1984,7,19,84,42,42,1984-7-19,0
1984,7,20,154,56,98,1984-7-20,-42
1984,7,21,98,0,98,1984-7-21,-98
1984,7,22,224,0,224,1984-7-22,-224
1984,7,23,224,14,210,1984-7-23,-196
1984,7,24,224,14,210,1984-7-24,-196
1984,7,25,168,14,154,1984-7-25,-140
1984,7,26,84,0,84,1984-7-26,-84
1984,7,27,84,42,42,1984-7-27,0
1984,7,28,28,0,28,1984-7-28,-28
1984,7,29,28,0,28,1984-7-29,-28
1984,7,30,42,14,28,1984-7-30,-14
1984,7,31,70,28,42,1984-7-31,-14
1984,8,1,112,28,84,1984-8-1,-56
1984,8,2,98,0,98,1984-8-2,-98
1984,8,3,126,28,98,1984-8-3,-70
1984,8,4,112,42,70,1984-8-4,-28
1984,8,5,98,28,70,1984-8-5,-42
1984,8,6,126,126,0,1984-8-6,126
1984,8,7,168,154,14,1984-8-7,140
1984,8,8,210,196,14,1984-8-8,182
1984,8,9,252,238,14,1984-8-9,224
1984,8,10,308,308,0,1984-8-10,308
1984,8,11,140,140,0,1984-8-11,140
1984,8,12,126,126,0,1984-8-12,126
1984,8,13,126,126,0,1984-8-13,126
1984,8,14,84,84,0,1984-8-14,84
1984,8,15,70,70,0,1984-8-15,70
1984,8,16,84,14,70,1984-8-16,-56
1984,8,17,112,42,70,1984-8-17,-28
1984,8,18,70,28,42,1984-8-18,-14
1984,8,19,98,0,98,1984-8-19,-98
1984,8,20,84,0,84,1984-8-20,-84
1984,8,21,84,0,84,1984-8-21,-84
1984,8,22,56,0,56,1984-8-22,-56
1984,8,23,42,0,42,1984-8-23,-42
1984,8,24,140,0,140,1984-8-24,-140
1984,8,25,224,0,224,1984-8-25,-224
1984,8,26,336,0,336,1984-8-26,-336
1984,8,27,504,28,476,1984-8-27,-448
1984,8,28,420,0,420,1984-8-28,-420
1984,8,29,504,0,504,1984-8-29,-504
1984,8,30,448,0,448,1984-8-30,-448
1984,8,31,574,42,532,1984-8-31,-490
1984,9,1,714,56,658,1984-9-1,-602
1984,9,2,672,42,630,1984-9-2,-588
1984,9,3,686,84,602,1984-9-3,-518
1984,9,4,644,70,574,1984-9-4,-504
1984,9,5,504,98,406,1984-9-5,-308
1984,9,6,154,112,42,1984-9-6,70
1984,9,7,182,168,14,1984-9-7,154
1984,9,8,126,70,56,1984-9-8,14
1984,9,9,42,0,42,1984-9-9,-42
1984,9,10,28,14,14,1984-9-10,0
1984,9,11,28,14,14,1984-9-11,0
1984,9,12,14,0,14,1984-9-12,-14
1984,9,13,0,0,0,1984-9-13,0
1984,9,14,0,0,0,1984-9-14,0
1984,9,15,14,14,0,1984-9-15,14
1984,9,16,0,0,0,1984-9-16,0
1984,9,17,0,0,0,1984-9-17,0
1984,9,18,0,0,0,1984-9-18,0
1984,9,19,0,0,0,1984-9-19,0
1984,9,20,0,0,0,1984-9-20,0
1984,9,21,14,0,14,1984-9-21,-14
1984,9,22,14,0,14,1984-9-22,-14
1984,9,23,14,0,14,1984-9-23,-14
1984,9,24,14,0,14,1984-9-24,-14
1984,9,25,0,0,0,1984-9-25,0
1984,9,26,0,0,0,1984-9-26,0
1984,9,27,0,0,0,1984-9-27,0
1984,9,28,0,0,0,1984-9-28,0
1984,9,29,42,42,0,1984-9-29,42
1984,9,30,14,0,14,1984-9-30,-14
1984,10,1,14,0,14,1984-10-1,-14
1984,10,2,14,0,14,1984-10-2,-14
1984,10,3,28,14,14,1984-10-3,0
1984,10,4,28,14,14,1984-10-4,0
1984,10,5,0,0,0,1984-10-5,0
1984,10,6,0,0,0,1984-10-6,0
1984,10,7,0,0,0,1984-10-7,0
1984,10,8,42,0,42,1984-10-8,-42
1984,10,9,56,0,56,1984-10-9,-56
1984,10,10,70,0,70,1984-10-10,-70
1984,10,11,112,28,84,1984-10-11,-56
1984,10,12,84,0,84,1984-10-12,-84
1984,10,13,42,14,28,1984-10-13,-14
1984,10,14,0,0,0,1984-10-14,0
1984,10,15,112,112,0,1984-10-15,112
1984,10,16,224,224,0,1984-10-16,224
1984,10,17,252,252,0,1984-10-17,252
1984,10,18,224,224,0,1984-10-18,224
1984,10,19,182,182,0,1984-10-19,182
1984,10,20,168,168,0,1984-10-20,168
1984,10,21,126,112,14,1984-10-21,98
1984,10,22,98,98,0,1984-10-22,98
1984,10,23,56,56,0,1984-10-23,56
1984,10,24,42,42,0,1984-10-24,42
1984,10,25,42,42,0,1984-10-25,42
1984,10,26,14,14,0,1984-10-26,14
1984,10,27,14,14,0,1984-10-27,14
1984,10,28,0,0,0,1984-10-28,0
1984,10,29,28,28,0,1984-10-29,28
1984,10,30,28,14,14,1984-10-30,0
1984,10,31,42,14,28,1984-10-31,-14
1984,11,1,42,0,42,1984-11-1,-42
1984,11,2,28,0,28,1984-11-2,-28
1984,11,3,56,0,56,1984-11-3,-56
1984,11,4,70,0,70,1984-11-4,-70
1984,11,5,56,0,56,1984-11-5,-56
1984,11,6,0,0,0,1984-11-6,0
1984,11,7,0,0,0,1984-11-7,0
1984,11,8,28,14,14,1984-11-8,0
1984,11,9,126,112,14,1984-11-9,98
1984,11,10,168,140,28,1984-11-10,112
1984,11,11,182,140,42,1984-11-11,98
1984,11,12,112,98,14,1984-11-12,84
1984,11,13,70,70,0,1984-11-13,70
1984,11,14,126,84,42,1984-11-14,42
1984,11,15,112,0,112,1984-11-15,-112
1984,11,16,42,0,42,1984-11-16,-42
1984,11,17,28,14,14,1984-11-17,0
1984,11,18,56,56,0,1984-11-18,56
1984,11,19,42,42,0,1984-11-19,42
1984,11,20,378,98,280,1984-11-20,-182
1984,11,21,588,168,420,1984-11-21,-252
1984,11,22,518,126,392,1984-11-22,-266
1984,11,23,532,126,406,1984-11-23,-280
1984,11,24,546,98,448,1984-11-24,-350
1984,11,25,574,28,546,1984-11-25,-518
1984,11,26,658,0,658,1984-11-26,-658
1984,11,27,742,0,742,1984-11-27,-742
1984,11,28,490,0,490,1984-11-28,-490
1984,11,29,364,0,364,1984-11-29,-364
1984,11,30,294,0,294,1984-11-30,-294
1984,12,1,154,0,154,1984-12-1,-154
1984,12,2,140,14,126,1984-12-2,-112
1984,12,3,112,42,70,1984-12-3,-28
1984,12,4,126,84,42,1984-12-4,42
1984,12,5,56,56,0,1984-12-5,56
1984,12,6,56,28,28,1984-12-6,0
1984,12,7,56,14,42,1984-12-7,-28
1984,12,8,70,0,70,1984-12-8,-70
1984,12,9,42,14,28,1984-12-9,-14
1984,12,10,140,14,126,1984-12-10,-112
1984,12,11,210,42,168,1984-12-11,-126
1984,12,12,364,42,322,1984-12-12,-280
1984,12,13,280,28,252,1984-12-13,-224
1984,12,14,238,42,196,1984-12-14,-154
1984,12,15,210,42,168,1984-12-15,-126
1984,12,16,196,112,84,1984-12-16,28
1984,12,17,154,84,70,1984-12-17,14
1984,12,18,42,42,0,1984-12-18,42
1984,12,19,28,28,0,1984-12-19,28
1984,12,20,28,28,0,1984-12-20,28
1984,12,21,42,28,14,1984-12-21,14
1984,12,22,28,14,14,1984-12-22,0
1984,12,23,14,0,14,1984-12-23,-14
1984,12,24,56,0,56,1984-12-24,-56
1984,12,25,42,0,42,1984-12-25,-42
1984,12,26,42,0,42,1984-12-26,-42
1984,12,27,28,0,28,1984-12-27,-28
1984,12,28,28,0,28,1984-12-28,-28
1984,12,29,70,14,56,1984-12-29,-42
1984,12,30,28,0,28,1984-12-30,-28
1984,12,31,14,0,14,1984-12-31,-14
1985,1,1,0,0,0,1985-1-1,0
1985,1,2,0,0,0,1985-1-2,0
1985,1,3,0,0,0,1985-1-3,0
1985,1,4,0,0,0,1985-1-4,0
1985,1,5,0,0,0,1985-1-5,0
1985,1,6,0,0,0,1985-1-6,0
1985,1,7,14,0,14,1985-1-7,-14
1985,1,8,28,28,0,1985-1-8,28
1985,1,9,28,14,14,1985-1-9,0
1985,1,10,0,0,0,1985-1-10,0
1985,1,11,0,0,0,1985-1-11,0
1985,1,12,28,0,28,1985-1-12,-28
1985,1,13,84,0,84,1985-1-13,-84
1985,1,14,182,0,182,1985-1-14,-182
1985,1,15,168,0,168,1985-1-15,-168
1985,1,16,210,0,210,1985-1-16,-210
1985,1,17,336,0,336,1985-1-17,-336
1985,1,18,308,0,308,1985-1-18,-308
1985,1,19,308,0,308,1985-1-19,-308
1985,1,20,644,42,602,1985-1-20,-560
1985,1,21,798,42,756,1985-1-21,-714
1985,1,22,700,42,658,1985-1-22,-616
1985,1,23,574,42,532,1985-1-23,-490
1985,1,24,252,28,224,1985-1-24,-196
1985,1,25,462,28,434,1985-1-25,-406
1985,1,26,0,0,0,1985-1-26,0
1985,1,27,14,14,0,1985-1-27,14
1985,1,28,0,0,0,1985-1-28,0
1985,1,29,0,0,0,1985-1-29,0
1985,1,30,0,0,0,1985-1-30,0
1985,1,31,84,28,56,1985-1-31,-28
1985,2,1,84,42,42,1985-2-1,0
1985,2,2,196,154,42,1985-2-2,112
1985,2,3,168,126,42,1985-2-3,84
1985,2,4,112,84,28,1985-2-4,56
1985,2,5,70,42,28,1985-2-5,14
1985,2,6,42,28,14,1985-2-6,14
1985,2,7,28,28,0,1985-2-7,28
1985,2,8,70,28,42,1985-2-8,-14
1985,2,9,98,42,56,1985-2-9,-14
1985,2,10,84,28,56,1985-2-10,-28
1985,2,11,56,14,42,1985-2-11,-28
1985,2,12,42,0,42,1985-2-12,-42
1985,2,13,42,0,42,1985-2-13,-42
1985,2,14,70,42,28,1985-2-14,14
1985,2,15,42,0,42,1985-2-15,-42
1985,2,16,28,0,28,1985-2-16,-28
1985,2,17,0,0,0,1985-2-17,0
1985,2,18,14,14,0,1985-2-18,14
1985,2,19,196,140,56,1985-2-19,84
1985,2,20,378,336,42,1985-2-20,294
1985,2,21,294,266,28,1985-2-21,238
1985,2,22,182,168,14,1985-2-22,154
1985,2,23,196,182,14,1985-2-23,168
1985,2,24,112,112,0,1985-2-24,112
1985,2,25,70,70,0,1985-2-25,70
1985,2,26,70,70,0,1985-2-26,70
1985,2,27,56,56,0,1985-2-27,56
1985,2,28,56,56,0,1985-2-28,56
1985,3,1,42,42,0,1985-3-1,42
1985,3,2,28,28,0,1985-3-2,28
1985,3,3,14,14,0,1985-3-3,14
1985,3,4,0,0,0,1985-3-4,0
1985,3,5,0,0,0,1985-3-5,0
1985,3,6,0,0,0,1985-3-6,0
1985,3,7,0,0,0,1985-3-7,0
1985,3,8,42,0,42,1985-3-8,-42
1985,3,9,42,0,42,1985-3-9,-42
1985,3,10,28,14,14,1985-3-10,0
1985,3,11,28,14,14,1985-3-11,0
1985,3,12,70,70,0,1985-3-12,70
1985,3,13,28,28,0,1985-3-13,28
1985,3,14,0,0,0,1985-3-14,0
1985,3,15,0,0,0,1985-3-15,0
1985,3,16,28,0,28,1985-3-16,-28
1985,3,17,56,0,56,1985-3-17,-56
1985,3,18,112,28,84,1985-3-18,-56
1985,3,19,70,14,56,1985-3-19,-42
1985,3,20,28,0,28,1985-3-20,-28
1985,3,21,42,14,28,1985-3-21,-14
1985,3,22,364,322,42,1985-3-22,280
1985,3,23,434,434,0,1985-3-23,434
1985,3,24,448,406,42,1985-3-24,364
1985,3,25,434,392,42,1985-3-25,350
1985,3,26,462,448,14,1985-3-26,434
1985,3,27,364,364,0,1985-3-27,364
1985,3,28,294,280,14,1985-3-28,266
1985,3,29,210,196,14,1985-3-29,182
1985,3,30,238,210,28,1985-3-30,182
1985,3,31,196,182,14,1985-3-31,168
1985,4,1,196,168,28,1985-4-1,140
1985,4,2,182,140,42,1985-4-2,98
1985,4,3,154,98,56,1985-4-3,42
1985,4,4,56,0,56,1985-4-4,-56
1985,4,5,70,0,70,1985-4-5,-70
1985,4,6,84,0,84,1985-4-6,-84
1985,4,7,42,0,42,1985-4-7,-42
1985,4,8,14,0,14,1985-4-8,-14
1985,4,9,14,0,14,1985-4-9,-14
1985,4,10,0,0,0,1985-4-10,0
1985,4,11,0,0,0,1985-4-11,0
1985,4,12,0,0,0,1985-4-12,0
1985,4,13,14,0,14,1985-4-13,-14
1985,4,14,0,0,0,1985-4-14,0
1985,4,15,0,0,0,1985-4-15,0
1985,4,16,0,0,0,1985-4-16,0
1985,4,17,0,0,0,1985-4-17,0
1985,4,18,14,0,14,1985-4-18,-14
1985,4,19,28,0,28,1985-4-19,-28
1985,4,20,84,42,42,1985-4-20,0
1985,4,21,70,70,0,1985-4-21,70
1985,4,22,602,602,0,1985-4-22,602
1985,4,23,1176,1176,0,1985-4-23,1176
1985,4,24,994,980,14,1985-4-24,966
1985,4,25,2030,1988,42,1985-4-25,1946
1985,4,26,2058,2044,14,1985-4-26,2030
1985,4,27,938,938,0,1985-4-27,938
1985,4,28,770,770,0,1985-4-28,770
1985,4,29,686,686,0,1985-4-29,686
1985,4,30,770,770,0,1985-4-30,770
1985,5,1,336,336,0,1985-5-1,336
1985,5,2,266,266,0,1985-5-2,266
1985,5,3,70,70,0,1985-5-3,70
1985,5,4,42,42,0,1985-5-4,42
1985,5,5,28,28,0,1985-5-5,28
1985,5,6,42,42,0,1985-5-6,42
1985,5,7,490,70,420,1985-5-7,-350
1985,5,8,728,154,574,1985-5-8,-420
1985,5,9,784,126,658,1985-5-9,-532
1985,5,10,798,84,714,1985-5-10,-630
1985,5,11,868,28,840,1985-5-11,-812
1985,5,12,784,14,770,1985-5-12,-756
1985,5,13,672,14,658,1985-5-13,-644
1985,5,14,602,14,588,1985-5-14,-574
1985,5,15,588,14,574,1985-5-15,-560
1985,5,16,490,0,490,1985-5-16,-490
1985,5,17,657,167,489,1985-5-17,-322
1985,5,18,322,56,266,1985-5-18,-210
1985,5,19,476,168,308,1985-5-19,-140
1985,5,20,322,182,140,1985-5-20,42
1985,5,21,266,140,126,1985-5-21,14
1985,5,22,168,84,84,1985-5-22,0
1985,5,23,196,98,98,1985-5-23,0
1985,5,24,126,42,84,1985-5-24,-42
1985,5,25,70,14,56,1985-5-25,-42
1985,5,26,28,0,28,1985-5-26,-28
1985,5,27,28,0,28,1985-5-27,-28
1985,5,28,14,14,0,1985-5-28,14
1985,5,29,14,14,0,1985-5-29,14
1985,5,30,0,0,0,1985-5-30,0
1985,5,31,0,0,0,1985-5-31,0
1985,6,1,14,14,0,1985-6-1,14
1985,6,2,0,0,0,1985-6-2,0
1985,6,3,126,0,126,1985-6-3,-126
1985,6,4,252,0,252,1985-6-4,-252
1985,6,5,602,0,602,1985-6-5,-602
1985,6,6,560,126,434,1985-6-6,-308
1985,6,7,588,224,364,1985-6-7,-140
1985,6,8,574,224,350,1985-6-8,-126
1985,6,9,616,196,420,1985-6-9,-224
1985,6,10,714,266,448,1985-6-10,-182
1985,6,11,644,252,392,1985-6-11,-140
1985,6,12,546,182,364,1985-6-12,-182
1985,6,13,378,0,378,1985-6-13,-378
1985,6,14,336,0,336,1985-6-14,-336
1985,6,15,378,0,378,1985-6-15,-378
1985,6,16,210,28,182,1985-6-16,-154
1985,6,17,112,0,112,1985-6-17,-112
1985,6,18,56,0,56,1985-6-18,-56
1985,6,19,14,14,0,1985-6-19,14
1985,6,20,14,14,0,1985-6-20,14
1985,6,21,14,14,0,1985-6-21,14
1985,6,22,0,0,0,1985-6-22,0
1985,6,23,42,14,28,1985-6-23,-14
1985,6,24,42,0,42,1985-6-24,-42
1985,6,25,28,0,28,1985-6-25,-28
1985,6,26,28,0,28,1985-6-26,-28
1985,6,27,14,0,14,1985-6-27,-14
1985,6,28,98,0,98,1985-6-28,-98
1985,6,29,126,0,126,1985-6-29,-126
1985,6,30,280,0,280,1985-6-30,-280
1985,7,1,294,0,294,1985-7-1,-294
1985,7,2,280,0,280,1985-7-2,-280
1985,7,3,364,14,350,1985-7-3,-336
1985,7,4,364,14,350,1985-7-4,-336
1985,7,5,462,0,462,1985-7-5,-462
1985,7,6,574,28,546,1985-7-6,-518
1985,7,7,1148,0,1148,1985-7-7,-1148
1985,7,8,1540,0,1540,1985-7-8,-1540
1985,7,9,1246,196,1050,1985-7-9,-854
1985,7,10,1344,140,1204,1985-7-10,-1064
1985,7,11,1372,182,1190,1985-7-11,-1008
1985,7,12,854,126,728,1985-7-12,-602
1985,7,13,224,70,154,1985-7-13,-84
1985,7,14,28,28,0,1985-7-14,28
1985,7,15,14,14,0,1985-7-15,14
1985,7,16,126,0,126,1985-7-16,-126
1985,7,17,84,0,84,1985-7-17,-84
1985,7,18,70,0,70,1985-7-18,-70
1985,7,19,70,0,70,1985-7-19,-70
1985,7,20,42,0,42,1985-7-20,-42
1985,7,21,28,0,28,1985-7-21,-28
1985,7,22,14,0,14,1985-7-22,-14
1985,7,23,28,0,28,1985-7-23,-28
1985,7,24,14,0,14,1985-7-24,-14
1985,7,25,28,14,14,1985-7-25,0
1985,7,26,168,168,0,1985-7-26,168
1985,7,27,28,28,0,1985-7-27,28
1985,7,28,280,112,168,1985-7-28,-56
1985,7,29,434,182,252,1985-7-29,-70
1985,7,30,322,126,196,1985-7-30,-70
1985,7,31,322,140,182,1985-7-31,-42
1985,8,1,252,112,140,1985-8-1,-28
1985,8,2,182,42,140,1985-8-2,-98
1985,8,3,154,28,126,1985-8-3,-98
1985,8,4,154,28,126,1985-8-4,-98
1985,8,5,112,14,98,1985-8-5,-84
1985,8,6,126,28,98,1985-8-6,-70
1985,8,7,70,14,56,1985-8-7,-42
1985,8,8,84,14,70,1985-8-8,-56
1985,8,9,84,0,84,1985-8-9,-84
1985,8,10,28,0,28,1985-8-10,-28
1985,8,11,14,0,14,1985-8-11,-14
1985,8,12,0,0,0,1985-8-12,0
1985,8,13,0,0,0,1985-8-13,0
1985,8,14,0,0,0,1985-8-14,0
1985,8,15,0,0,0,1985-8-15,0
1985,8,16,0,0,0,1985-8-16,0
1985,8,17,14,0,14,1985-8-17,-14
1985,8,18,14,0,14,1985-8-18,-14
1985,8,19,14,0,14,1985-8-19,-14
1985,8,20,28,0,28,1985-8-20,-28
1985,8,21,0,0,0,1985-8-21,0
1985,8,22,0,0,0,1985-8-22,0
1985,8,23,0,0,0,1985-8-23,0
1985,8,24,0,0,0,1985-8-24,0
1985,8,25,14,0,14,1985-8-25,-14
1985,8,26,14,0,14,1985-8-26,-14
1985,8,27,14,14,0,1985-8-27,14
1985,8,28,0,0,0,1985-8-28,0
1985,8,29,0,0,0,1985-8-29,0
1985,8,30,0,0,0,1985-8-30,0
1985,8,31,28,28,0,1985-8-31,28
1985,9,1,0,0,0,1985-9-1,0
1985,9,2,0,0,0,1985-9-2,0
1985,9,3,0,0,0,1985-9-3,0
1985,9,4,0,0,0,1985-9-4,0
1985,9,5,0,0,0,1985-9-5,0
1985,9,6,0,0,0,1985-9-6,0
1985,9,7,14,14,0,1985-9-7,14
1985,9,8,0,0,0,1985-9-8,0
1985,9,9,0,0,0,1985-9-9,0
1985,9,10,0,0,0,1985-9-10,0
1985,9,11,14,0,14,1985-9-11,-14
1985,9,12,0,0,0,1985-9-12,0
1985,9,13,28,0,28,1985-9-13,-28
1985,9,14,42,0,42,1985-9-14,-42
1985,9,15,84,0,84,1985-9-15,-84
1985,9,16,84,14,70,1985-9-16,-56
1985,9,17,56,0,56,1985-9-17,-56
1985,9,18,56,0,56,1985-9-18,-56
1985,9,19,42,0,42,1985-9-19,-42
1985,9,20,98,0,98,1985-9-20,-98
1985,9,21,14,0,14,1985-9-21,-14
1985,9,22,0,0,0,1985-9-22,0
1985,9,23,0,0,0,1985-9-23,0
1985,9,24,0,0,0,1985-9-24,0
1985,9,25,0,0,0,1985-9-25,0
1985,9,26,0,0,0,1985-9-26,0
1985,9,27,0,0,0,1985-9-27,0
1985,9,28,0,0,0,1985-9-28,0
1985,9,29,14,0,14,1985-9-29,-14
1985,9,30,28,0,28,1985-9-30,-28
1985,10,1,0,0,0,1985-10-1,0
1985,10,2,0,0,0,1985-10-2,0
1985,10,3,0,0,0,1985-10-3,0
1985,10,4,0,0,0,1985-10-4,0
1985,10,5,0,0,0,1985-10-5,0
1985,10,6,0,0,0,1985-10-6,0
1985,10,7,0,0,0,1985-10-7,0
1985,10,8,0,0,0,1985-10-8,0
1985,10,9,0,0,0,1985-10-9,0
1985,10,10,0,0,0,1985-10-10,0
1985,10,11,0,0,0,1985-10-11,0
1985,10,12,0,0,0,1985-10-12,0
1985,10,13,14,0,14,1985-10-13,-14
1985,10,14,42,0,42,1985-10-14,-42
1985,10,15,126,98,28,1985-10-15,70
1985,10,16,224,210,14,1985-10-16,196
1985,10,17,476,476,0,1985-10-17,476
1985,10,18,280,280,0,1985-10-18,280
1985,10,19,462,462,0,1985-10-19,462
1985,10,20,518,504,14,1985-10-20,490
1985,10,21,476,476,0,1985-10-21,476
1985,10,22,728,728,0,1985-10-22,728
1985,10,23,756,756,0,1985-10-23,756
1985,10,24,672,672,0,1985-10-24,672
1985,10,25,476,476,0,1985-10-25,476
1985,10,26,336,336,0,1985-10-26,336
1985,10,27,224,224,0,1985-10-27,224
1985,10,28,112,112,0,1985-10-28,112
1985,10,29,70,70,0,1985-10-29,70
1985,10,30,0,0,0,1985-10-30,0
1985,10,31,0,0,0,1985-10-31,0
1985,11,1,0,0,0,1985-11-1,0
1985,11,2,0,0,0,1985-11-2,0
1985,11,3,0,0,0,1985-11-3,0
1985,11,4,0,0,0,1985-11-4,0
1985,11,5,42,42,0,1985-11-5,42
1985,11,6,98,98,0,1985-11-6,98
1985,11,7,98,98,0,1985-11-7,98
1985,11,8,210,126,84,1985-11-8,42
1985,11,9,112,42,70,1985-11-9,-28
1985,11,10,126,42,84,1985-11-10,-42
1985,11,11,126,0,126,1985-11-11,-126
1985,11,12,182,28,154,1985-11-12,-126
1985,11,13,126,14,112,1985-11-13,-98
1985,11,14,196,14,182,1985-11-14,-168
1985,11,15,420,14,406,1985-11-15,-392
1985,11,16,322,14,308,1985-11-16,-294
1985,11,17,280,56,224,1985-11-17,-168
1985,11,18,210,28,182,1985-11-18,-154
1985,11,19,154,14,140,1985-11-19,-126
1985,11,20,154,14,140,1985-11-20,-126
1985,11,21,112,14,98,1985-11-21,-84
1985,11,22,28,0,28,1985-11-22,-28
1985,11,23,14,0,14,1985-11-23,-14
1985,11,24,0,0,0,1985-11-24,0
1985,11,25,0,0,0,1985-11-25,0
1985,11,26,0,0,0,1985-11-26,0
1985,11,27,0,0,0,1985-11-27,0
1985,11,28,0,0,0,1985-11-28,0
1985,11,29,0,0,0,1985-11-29,0
1985,11,30,0,0,0,1985-11-30,0
1985,12,1,0,0,0,1985-12-1,0
1985,12,2,14,0,14,1985-12-2,-14
1985,12,3,14,0,14,1985-12-3,-14
1985,12,4,0,0,0,1985-12-4,0
1985,12,5,28,28,0,1985-12-5,28
1985,12,6,56,56,0,1985-12-6,56
1985,12,7,70,70,0,1985-12-7,70
1985,12,8,14,14,0,1985-12-8,14
1985,12,9,28,28,0,1985-12-9,28
1985,12,10,42,42,0,1985-12-10,42
1985,12,11,70,70,0,1985-12-11,70
1985,12,12,98,98,0,1985-12-12,98
1985,12,13,70,70,0,1985-12-13,70
1985,12,14,98,56,42,1985-12-14,14
1985,12,15,154,98,56,1985-12-15,42
1985,12,16,210,112,98,1985-12-16,14
1985,12,17,238,112,126,1985-12-17,-14
1985,12,18,182,70,112,1985-12-18,-42
1985,12,19,112,28,84,1985-12-19,-56
1985,12,20,42,0,42,1985-12-20,-42
1985,12,21,42,0,42,1985-12-21,-42
1985,12,22,0,0,0,1985-12-22,0
1985,12,23,0,0,0,1985-12-23,0
1985,12,24,0,0,0,1985-12-24,0
1985,12,25,0,0,0,1985-12-25,0
1985,12,26,0,0,0,1985-12-26,0
1985,12,27,0,0,0,1985-12-27,0
1985,12,28,0,0,0,1985-12-28,0
1985,12,29,0,0,0,1985-12-29,0
1985,12,30,0,0,0,1985-12-30,0
1985,12,31,0,0,0,1985-12-31,0
1986,1,1,0,0,0,1986-1-1,0
1986,1,2,0,0,0,1986-1-2,0
1986,1,3,0,0,0,1986-1-3,0
1986,1,4,0,0,0,1986-1-4,0
1986,1,5,0,0,0,1986-1-5,0
1986,1,6,0,0,0,1986-1-6,0
1986,1,7,0,0,0,1986-1-7,0
1986,1,8,0,0,0,1986-1-8,0
1986,1,9,0,0,0,1986-1-9,0
1986,1,10,0,0,0,1986-1-10,0
1986,1,11,0,0,0,1986-1-11,0
1986,1,12,0,0,0,1986-1-12,0
1986,1,13,112,0,112,1986-1-13,-112
1986,1,14,154,0,154,1986-1-14,-154
1986,1,15,98,0,98,1986-1-15,-98
1986,1,16,84,0,84,1986-1-16,-84
1986,1,17,0,0,0,1986-1-17,0
1986,1,18,0,0,0,1986-1-18,0
1986,1,19,0,0,0,1986-1-19,0
1986,1,20,0,0,0,1986-1-20,0
1986,1,21,0,0,0,1986-1-21,0
1986,1,22,14,14,0,1986-1-22,14
1986,1,23,0,0,0,1986-1-23,0
1986,1,24,0,0,0,1986-1-24,0
1986,1,25,0,0,0,1986-1-25,0
1986,1,26,14,0,14,1986-1-26,-14
1986,1,27,0,0,0,1986-1-27,0
1986,1,28,0,0,0,1986-1-28,0
1986,1,29,0,0,0,1986-1-29,0
1986,1,30,182,0,182,1986-1-30,-182
1986,1,31,350,14,336,1986-1-31,-322
1986,2,1,574,0,574,1986-2-1,-574
1986,2,2,896,0,896,1986-2-2,-896
1986,2,3,1176,0,1176,1986-2-3,-1176
1986,2,4,1302,0,1302,1986-2-4,-1302
1986,2,5,994,0,994,1986-2-5,-994
1986,2,6,840,0,840,1986-2-6,-840
1986,2,7,616,0,616,1986-2-7,-616
1986,2,8,406,0,406,1986-2-8,-406
1986,2,9,504,0,504,1986-2-9,-504
1986,2,10,630,0,630,1986-2-10,-630
1986,2,11,980,0,980,1986-2-11,-980
1986,2,12,952,0,952,1986-2-12,-952
1986,2,13,854,0,854,1986-2-13,-854
1986,2,14,392,392,0,1986-2-14,392
1986,2,15,350,0,350,1986-2-15,-350
1986,2,16,0,0,0,1986-2-16,0
1986,2,17,0,0,0,1986-2-17,0
1986,2,18,0,0,0,1986-2-18,0
1986,2,19,0,0,0,1986-2-19,0
1986,2,20,14,0,14,1986-2-20,-14
1986,2,21,14,0,14,1986-2-21,-14
1986,2,22,14,0,14,1986-2-22,-14
1986,2,23,14,0,14,1986-2-23,-14
1986,2,24,14,0,14,1986-2-24,-14
1986,2,25,0,0,0,1986-2-25,0
1986,2,26,28,14,14,1986-2-26,0
1986,2,27,98,98,0,1986-2-27,98
1986,2,28,28,28,0,1986-2-28,28
1986,3,1,504,504,0,1986-3-1,504
1986,3,2,490,490,0,1986-3-2,490
1986,3,3,532,532,0,1986-3-3,532
1986,3,4,532,532,0,1986-3-4,532
1986,3,5,574,574,0,1986-3-5,574
1986,3,6,462,462,0,1986-3-6,462
1986,3,7,448,0,448,1986-3-7,-448
1986,3,8,252,252,0,1986-3-8,252
1986,3,9,196,196,0,1986-3-9,196
1986,3,10,140,0,140,1986-3-10,-140
1986,3,11,98,98,0,1986-3-11,98
1986,3,12,70,70,0,1986-3-12,70
1986,3,13,0,0,0,1986-3-13,0
1986,3,14,0,0,0,1986-3-14,0
1986,3,15,0,0,0,1986-3-15,0
1986,3,16,0,0,0,1986-3-16,0
1986,3,17,0,0,0,1986-3-17,0
1986,3,18,0,0,0,1986-3-18,0
1986,3,19,0,0,0,1986-3-19,0
1986,3,20,28,0,28,1986-3-20,-28
1986,3,21,28,0,28,1986-3-21,-28
1986,3,22,14,0,14,1986-3-22,-14
1986,3,23,28,14,14,1986-3-23,0
1986,3,24,56,28,28,1986-3-24,0
1986,3,25,14,14,0,1986-3-25,14
1986,3,26,14,14,0,1986-3-26,14
1986,3,27,0,0,0,1986-3-27,0
1986,3,28,14,14,0,1986-3-28,14
1986,3,29,14,14,0,1986-3-29,14
1986,3,30,14,14,0,1986-3-30,14
1986,3,31,0,0,0,1986-3-31,0
1986,4,1,28,0,28,1986-4-1,-28
1986,4,2,14,0,14,1986-4-2,-14
1986,4,3,14,0,14,1986-4-3,-14
1986,4,4,0,0,0,1986-4-4,0
1986,4,5,0,0,0,1986-4-5,0
1986,4,6,0,0,0,1986-4-6,0
1986,4,7,14,0,14,1986-4-7,-14
1986,4,8,14,0,14,1986-4-8,-14
1986,4,9,0,0,0,1986-4-9,0
1986,4,10,14,0,14,1986-4-10,-14
1986,4,11,28,0,28,1986-4-11,-28
1986,4,12,28,0,28,1986-4-12,-28
1986,4,13,28,0,28,1986-4-13,-28
1986,4,14,126,84,42,1986-4-14,42
1986,4,15,126,98,28,1986-4-15,70
1986,4,16,196,168,28,1986-4-16,140
1986,4,17,140,140,0,1986-4-17,140
1986,4,18,126,126,0,1986-4-18,126
1986,4,19,98,98,0,1986-4-19,98
1986,4,20,98,70,28,1986-4-20,42
1986,4,21,126,84,42,1986-4-21,42
1986,4,22,98,28,70,1986-4-22,-42
1986,4,23,504,476,28,1986-4-23,448
1986,4,24,658,658,0,1986-4-24,658
1986,4,25,574,574,0,1986-4-25,574
1986,4,26,532,532,0,1986-4-26,532
1986,4,27,616,616,0,1986-4-27,616
1986,4,28,434,434,0,1986-4-28,434
1986,4,29,406,406,0,1986-4-29,406
1986,4,30,196,196,0,1986-4-30,196
1986,5,1,70,70,0,1986-5-1,70
1986,5,2,98,98,0,1986-5-2,98
1986,5,3,14,14,0,1986-5-3,14
1986,5,4,14,14,0,1986-5-4,14
1986,5,5,0,0,0,1986-5-5,0
1986,5,6,0,0,0,1986-5-6,0
1986,5,7,0,0,0,1986-5-7,0
1986,5,8,14,0,14,1986-5-8,-14
1986,5,9,0,0,0,1986-5-9,0
1986,5,10,0,0,0,1986-5-10,0
1986,5,11,0,0,0,1986-5-11,0
1986,5,12,0,0,0,1986-5-12,0
1986,5,13,0,0,0,1986-5-13,0
1986,5,14,0,0,0,1986-5-14,0
1986,5,15,28,28,0,1986-5-15,28
1986,5,16,42,42,0,1986-5-16,42
1986,5,17,70,70,0,1986-5-17,70
1986,5,18,70,70,0,1986-5-18,70
1986,5,19,154,154,0,1986-5-19,154
1986,5,20,112,112,0,1986-5-20,112
1986,5,21,98,98,0,1986-5-21,98
1986,5,22,70,70,0,1986-5-22,70
1986,5,23,56,56,0,1986-5-23,56
1986,5,24,70,70,0,1986-5-24,70
1986,5,25,84,84,0,1986-5-25,84
1986,5,26,126,112,14,1986-5-26,98
1986,5,27,56,42,14,1986-5-27,28
1986,5,28,56,56,0,1986-5-28,56
1986,5,29,42,42,0,1986-5-29,42
1986,5,30,28,14,14,1986-5-30,0
1986,5,31,28,0,28,1986-5-31,-28
1986,6,1,14,0,14,1986-6-1,-14
1986,6,2,0,0,0,1986-6-2,0
1986,6,3,0,0,0,1986-6-3,0
1986,6,4,0,0,0,1986-6-4,0
1986,6,5,0,0,0,1986-6-5,0
1986,6,6,0,0,0,1986-6-6,0
1986,6,7,0,0,0,1986-6-7,0
1986,6,8,28,28,0,1986-6-8,28
1986,6,9,0,0,0,1986-6-9,0
1986,6,10,0,0,0,1986-6-10,0
1986,6,11,0,0,0,1986-6-11,0
1986,6,12,0,0,0,1986-6-12,0
1986,6,13,0,0,0,1986-6-13,0
1986,6,14,0,0,0,1986-6-14,0
1986,6,15,0,0,0,1986-6-15,0
1986,6,16,0,0,0,1986-6-16,0
1986,6,17,0,0,0,1986-6-17,0
1986,6,18,0,0,0,1986-6-18,0
1986,6,19,0,0,0,1986-6-19,0
1986,6,20,0,0,0,1986-6-20,0
1986,6,21,14,14,0,1986-6-21,14
1986,6,22,0,0,0,1986-6-22,0
1986,6,23,0,0,0,1986-6-23,0
1986,6,24,0,0,0,1986-6-24,0
1986,6,25,0,0,0,1986-6-25,0
1986,6,26,0,0,0,1986-6-26,0
1986,6,27,0,0,0,1986-6-27,0
1986,6,28,0,0,0,1986-6-28,0
1986,6,29,0,0,0,1986-6-29,0
1986,6,30,0,0,0,1986-6-30,0
1986,7,1,0,0,0,1986-7-1,0
1986,7,2,0,0,0,1986-7-2,0
1986,7,3,14,14,0,1986-7-3,14
1986,7,4,28,28,0,1986-7-4,28
1986,7,5,98,98,0,1986-7-5,98
1986,7,6,168,168,0,1986-7-6,168
1986,7,7,210,210,0,1986-7-7,210
1986,7,8,238,238,0,1986-7-8,238
1986,7,9,154,154,0,1986-7-9,154
1986,7,10,210,210,0,1986-7-10,210
1986,7,11,238,126,112,1986-7-11,14
1986,7,12,280,140,140,1986-7-12,0
1986,7,13,154,154,0,1986-7-13,154
1986,7,14,56,0,56,1986-7-14,-56
1986,7,15,84,56,28,1986-7-15,28
1986,7,16,56,42,14,1986-7-16,28
1986,7,17,56,28,28,1986-7-17,0
1986,7,18,42,28,14,1986-7-18,14
1986,7,19,28,28,0,1986-7-19,28
1986,7,20,42,42,0,1986-7-20,42
1986,7,21,42,42,0,1986-7-21,42
1986,7,22,42,42,0,1986-7-22,42
1986,7,23,14,14,0,1986-7-23,14
1986,7,24,0,0,0,1986-7-24,0
1986,7,25,0,0,0,1986-7-25,0
1986,7,26,0,0,0,1986-7-26,0
1986,7,27,126,126,0,1986-7-27,126
1986,7,28,154,154,0,1986-7-28,154
1986,7,29,238,238,0,1986-7-29,238
1986,7,30,266,266,0,1986-7-30,266
1986,7,31,224,224,0,1986-7-31,224
1986,8,1,196,196,0,1986-8-1,196
1986,8,2,182,182,0,1986-8-2,182
1986,8,3,196,196,0,1986-8-3,196
1986,8,4,182,182,0,1986-8-4,182
1986,8,5,168,168,0,1986-8-5,168
1986,8,6,168,168,0,1986-8-6,168
1986,8,7,140,140,0,1986-8-7,140
1986,8,8,112,112,0,1986-8-8,112
1986,8,9,112,112,0,1986-8-9,112
1986,8,10,0,0,0,1986-8-10,0
1986,8,11,0,0,0,1986-8-11,0
1986,8,12,0,0,0,1986-8-12,0
1986,8,13,0,0,0,1986-8-13,0
1986,8,14,0,0,0,1986-8-14,0
1986,8,15,0,0,0,1986-8-15,0
1986,8,16,0,0,0,1986-8-16,0
1986,8,17,14,14,0,1986-8-17,14
1986,8,18,0,0,0,1986-8-18,0
1986,8,19,0,0,0,1986-8-19,0
1986,8,20,14,0,14,1986-8-20,-14
1986,8,21,28,0,28,1986-8-21,-28
1986,8,22,28,0,28,1986-8-22,-28
1986,8,23,98,84,14,1986-8-23,70
1986,8,24,126,126,0,1986-8-24,126
1986,8,25,126,126,0,1986-8-25,126
1986,8,26,98,98,0,1986-8-26,98
1986,8,27,112,112,0,1986-8-27,112
1986,8,28,112,112,0,1986-8-28,112
1986,8,29,112,112,0,1986-8-29,112
1986,8,30,112,112,0,1986-8-30,112
1986,8,31,98,98,0,1986-8-31,98
1986,9,1,98,98,0,1986-9-1,98
1986,9,2,70,70,0,1986-9-2,70
1986,9,3,112,112,0,1986-9-3,112
1986,9,4,56,56,0,1986-9-4,56
1986,9,5,0,0,0,1986-9-5,0
1986,9,6,42,42,0,1986-9-6,42
1986,9,7,70,70,0,1986-9-7,70
1986,9,8,42,42,0,1986-9-8,42
1986,9,9,14,14,0,1986-9-9,14
1986,9,10,14,14,0,1986-9-10,14
1986,9,11,0,0,0,1986-9-11,0
1986,9,12,0,0,0,1986-9-12,0
1986,9,13,0,0,0,1986-9-13,0
1986,9,14,0,0,0,1986-9-14,0
1986,9,15,0,0,0,1986-9-15,0
1986,9,16,0,0,0,1986-9-16,0
1986,9,17,0,0,0,1986-9-17,0
1986,9,18,0,0,0,1986-9-18,0
1986,9,19,0,0,0,1986-9-19,0
1986,9,20,0,0,0,1986-9-20,0
1986,9,21,0,0,0,1986-9-21,0
1986,9,22,0,0,0,1986-9-22,0
1986,9,23,0,0,0,1986-9-23,0
1986,9,24,0,0,0,1986-9-24,0
1986,9,25,0,0,0,1986-9-25,0
1986,9,26,0,0,0,1986-9-26,0
1986,9,27,0,0,0,1986-9-27,0
1986,9,28,0,0,0,1986-9-28,0
1986,9,29,98,98,0,1986-9-29,98
1986,9,30,98,98,0,1986-9-30,98
1986,10,1,28,28,0,1986-10-1,28
1986,10,2,126,126,0,1986-10-2,126
1986,10,3,112,112,0,1986-10-3,112
1986,10,4,84,84,0,1986-10-4,84
1986,10,5,28,28,0,1986-10-5,28
1986,10,6,42,42,0,1986-10-6,42
1986,10,7,98,84,14,1986-10-7,70
1986,10,8,84,84,0,1986-10-8,84
1986,10,9,462,280,182,1986-10-9,98
1986,10,10,98,70,28,1986-10-10,42
1986,10,11,112,84,28,1986-10-11,56
1986,10,12,140,84,56,1986-10-12,28
1986,10,13,252,84,168,1986-10-13,-84
1986,10,14,0,0,0,1986-10-14,0
1986,10,15,0,0,0,1986-10-15,0
1986,10,16,56,56,0,1986-10-16,56
1986,10,17,308,308,0,1986-10-17,308
1986,10,18,574,574,0,1986-10-18,574
1986,10,19,882,882,0,1986-10-19,882
1986,10,20,742,686,56,1986-10-20,630
1986,10,21,672,532,140,1986-10-21,392
1986,10,22,770,546,224,1986-10-22,322
1986,10,23,532,308,224,1986-10-23,84
1986,10,24,532,266,266,1986-10-24,0
1986,10,25,364,182,182,1986-10-25,0
1986,10,26,392,238,154,1986-10-26,84
1986,10,27,602,448,154,1986-10-27,294
1986,10,28,784,350,434,1986-10-28,-84
1986,10,29,924,784,140,1986-10-29,644
1986,10,30,784,686,98,1986-10-30,588
1986,10,31,574,518,56,1986-10-31,462
1986,11,1,602,574,28,1986-11-1,546
1986,11,2,476,476,0,1986-11-2,476
1986,11,3,308,294,14,1986-11-3,280
1986,11,4,252,98,154,1986-11-4,-56
1986,11,5,252,126,126,1986-11-5,0
1986,11,6,196,140,56,1986-11-6,84
1986,11,7,182,126,56,1986-11-7,70
1986,11,8,56,42,14,1986-11-8,28
1986,11,9,28,28,0,1986-11-9,28
1986,11,10,14,0,14,1986-11-10,-14
1986,11,11,0,0,0,1986-11-11,0
1986,11,12,0,0,0,1986-11-12,0
1986,11,13,0,0,0,1986-11-13,0
1986,11,14,42,42,0,1986-11-14,42
1986,11,15,98,98,0,1986-11-15,98
1986,11,16,56,56,0,1986-11-16,56
1986,11,17,56,56,0,1986-11-17,56
1986,11,18,28,28,0,1986-11-18,28
1986,11,19,28,28,0,1986-11-19,28
1986,11,20,28,28,0,1986-11-20,28
1986,11,21,42,42,0,1986-11-21,42
1986,11,22,14,14,0,1986-11-22,14
1986,11,23,42,28,14,1986-11-23,14
1986,11,24,14,0,14,1986-11-24,-14
1986,11,25,14,0,14,1986-11-25,-14
1986,11,26,0,0,0,1986-11-26,0
1986,11,27,0,0,0,1986-11-27,0
1986,11,28,0,0,0,1986-11-28,0
1986,11,29,0,0,0,1986-11-29,0
1986,11,30,0,0,0,1986-11-30,0
1986,12,1,0,0,0,1986-12-1,0
1986,12,2,0,0,0,1986-12-2,0
1986,12,3,0,0,0,1986-12-3,0
1986,12,4,0,0,0,1986-12-4,0
1986,12,5,0,0,0,1986-12-5,0
1986,12,6,0,0,0,1986-12-6,0
1986,12,7,0,0,0,1986-12-7,0
1986,12,8,0,0,0,1986-12-8,0
1986,12,9,28,28,0,1986-12-9,28
1986,12,10,56,42,14,1986-12-10,28
1986,12,11,56,28,28,1986-12-11,0
1986,12,12,28,14,14,1986-12-12,0
1986,12,13,28,14,14,1986-12-13,0
1986,12,14,28,14,14,1986-12-14,0
1986,12,15,0,0,0,1986-12-15,0
1986,12,16,0,0,0,1986-12-16,0
1986,12,17,14,0,14,1986-12-17,-14
1986,12,18,0,0,0,1986-12-18,0
1986,12,19,0,0,0,1986-12-19,0
1986,12,20,0,0,0,1986-12-20,0
1986,12,21,28,0,28,1986-12-21,-28
1986,12,22,70,0,70,1986-12-22,-70
1986,12,23,42,0,42,1986-12-23,-42
1986,12,24,14,0,14,1986-12-24,-14
1986,12,25,28,0,28,1986-12-25,-28
1986,12,26,0,0,0,1986-12-26,0
1986,12,27,0,0,0,1986-12-27,0
1986,12,28,0,0,0,1986-12-28,0
1986,12,29,0,0,0,1986-12-29,0
1986,12,30,0,0,0,1986-12-30,0
1986,12,31,14,14,0,1986-12-31,14
1987,1,1,98,98,0,1987-1-1,98
1987,1,2,70,70,0,1987-1-2,70
1987,1,3,56,56,0,1987-1-3,56
1987,1,4,42,42,0,1987-1-4,42
1987,1,5,14,14,0,1987-1-5,14
1987,1,6,0,0,0,1987-1-6,0
1987,1,7,0,0,0,1987-1-7,0
1987,1,8,0,0,0,1987-1-8,0
1987,1,9,0,0,0,1987-1-9,0
1987,1,10,0,0,0,1987-1-10,0
1987,1,11,0,0,0,1987-1-11,0
1987,1,12,0,0,0,1987-1-12,0
1987,1,13,0,0,0,1987-1-13,0
1987,1,14,14,0,14,1987-1-14,-14
1987,1,15,14,0,14,1987-1-15,-14
1987,1,16,14,0,14,1987-1-16,-14
1987,1,17,14,0,14,1987-1-17,-14
1987,1,18,14,0,14,1987-1-18,-14
1987,1,19,0,0,0,1987-1-19,0
1987,1,20,14,0,14,1987-1-20,-14
1987,1,21,42,0,42,1987-1-21,-42
1987,1,22,98,0,98,1987-1-22,-98
1987,1,23,98,14,84,1987-1-23,-70
1987,1,24,42,14,28,1987-1-24,-14
1987,1,25,14,0,14,1987-1-25,-14
1987,1,26,42,28,14,1987-1-26,14
1987,1,27,28,28,0,1987-1-27,28
1987,1,28,28,14,14,1987-1-28,0
1987,1,29,28,14,14,1987-1-29,0
1987,1,30,0,0,0,1987-1-30,0
1987,1,31,0,0,0,1987-1-31,0
1987,2,1,0,0,0,1987-2-1,0
1987,2,2,0,0,0,1987-2-2,0
1987,2,3,0,0,0,1987-2-3,0
1987,2,4,0,0,0,1987-2-4,0
1987,2,5,0,0,0,1987-2-5,0
1987,2,6,0,0,0,1987-2-6,0
1987,2,7,0,0,0,1987-2-7,0
1987,2,8,0,0,0,1987-2-8,0
1987,2,9,14,0,14,1987-2-9,-14
1987,2,10,14,0,14,1987-2-10,-14
1987,2,11,0,0,0,1987-2-11,0
1987,2,12,14,14,0,1987-2-12,14
1987,2,13,0,0,0,1987-2-13,0
1987,2,14,28,28,0,1987-2-14,28
1987,2,15,14,14,0,1987-2-15,14
1987,2,16,0,0,0,1987-2-16,0
1987,2,17,0,0,0,1987-2-17,0
1987,2,18,0,0,0,1987-2-18,0
1987,2,19,0,0,0,1987-2-19,0
1987,2,20,0,0,0,1987-2-20,0
1987,2,21,0,0,0,1987-2-21,0
1987,2,22,0,0,0,1987-2-22,0
1987,2,23,0,0,0,1987-2-23,0
1987,2,24,56,56,0,1987-2-24,56
1987,2,25,70,56,14,1987-2-25,42
1987,2,26,56,56,0,1987-2-26,56
1987,2,27,70,56,14,1987-2-27,42
1987,2,28,42,42,0,1987-2-28,42
1987,3,1,84,70,14,1987-3-1,56
1987,3,2,112,84,28,1987-3-2,56
1987,3,3,28,14,14,1987-3-3,0
1987,3,4,42,28,14,1987-3-4,14
1987,3,5,98,56,42,1987-3-5,14
1987,3,6,98,98,0,1987-3-6,98
1987,3,7,126,126,0,1987-3-7,126
1987,3,8,154,154,0,1987-3-8,154
1987,3,9,154,154,0,1987-3-9,154
1987,3,10,126,126,0,1987-3-10,126
1987,3,11,42,42,0,1987-3-11,42
1987,3,12,0,0,0,1987-3-12,0
1987,3,13,0,0,0,1987-3-13,0
1987,3,14,56,0,56,1987-3-14,-56
1987,3,15,42,0,42,1987-3-15,-42
1987,3,16,28,0,28,1987-3-16,-28
1987,3,17,42,0,42,1987-3-17,-42
1987,3,18,28,0,28,1987-3-18,-28
1987,3,19,28,0,28,1987-3-19,-28
1987,3,20,28,14,14,1987-3-20,0
1987,3,21,42,42,0,1987-3-21,42
1987,3,22,70,70,0,1987-3-22,70
1987,3,23,112,112,0,1987-3-23,112
1987,3,24,126,126,0,1987-3-24,126
1987,3,25,294,294,0,1987-3-25,294
1987,3,26,280,280,0,1987-3-26,280
1987,3,27,238,238,0,1987-3-27,238
1987,3,28,252,252,0,1987-3-28,252
1987,3,29,168,168,0,1987-3-29,168
1987,3,30,238,224,14,1987-3-30,210
1987,3,31,238,224,14,1987-3-31,210
1987,4,1,168,168,0,1987-4-1,168
1987,4,2,168,168,0,1987-4-2,168
1987,4,3,168,168,0,1987-4-3,168
1987,4,4,182,154,28,1987-4-4,126
1987,4,5,238,168,70,1987-4-5,98
1987,4,6,658,126,532,1987-4-6,-406
1987,4,7,1148,0,1148,1987-4-7,-1148
1987,4,8,1372,0,1372,1987-4-8,-1372
1987,4,9,1218,0,1218,1987-4-9,-1218
1987,4,10,1162,0,1162,1987-4-10,-1162
1987,4,11,1078,28,1050,1987-4-11,-1022
1987,4,12,1120,98,1022,1987-4-12,-924
1987,4,13,1036,70,966,1987-4-13,-896
1987,4,14,938,70,868,1987-4-14,-798
1987,4,15,910,28,882,1987-4-15,-854
1987,4,16,728,28,700,1987-4-16,-672
1987,4,17,616,14,602,1987-4-17,-588
1987,4,18,966,14,952,1987-4-18,-938
1987,4,19,406,14,392,1987-4-19,-378
1987,4,20,14,14,0,1987-4-20,14
1987,4,21,56,42,14,1987-4-21,28
1987,4,22,112,84,28,1987-4-22,56
1987,4,23,70,70,0,1987-4-23,70
1987,4,24,140,140,0,1987-4-24,140
1987,4,25,140,140,0,1987-4-25,140
1987,4,26,70,70,0,1987-4-26,70
1987,4,27,28,28,0,1987-4-27,28
1987,4,28,42,14,28,1987-4-28,-14
1987,4,29,28,14,14,1987-4-29,0
1987,4,30,98,28,70,1987-4-30,-42
1987,5,1,140,42,98,1987-5-1,-56
1987,5,2,154,56,98,1987-5-2,-42
1987,5,3,168,56,112,1987-5-3,-56
1987,5,4,252,0,252,1987-5-4,-252
1987,5,5,252,0,252,1987-5-5,-252
1987,5,6,308,0,308,1987-5-6,-308
1987,5,7,350,0,350,1987-5-7,-350
1987,5,8,308,0,308,1987-5-8,-308
1987,5,9,280,0,280,1987-5-9,-280
1987,5,10,280,0,280,1987-5-10,-280
1987,5,11,182,0,182,1987-5-11,-182
1987,5,12,154,14,140,1987-5-12,-126
1987,5,13,168,14,154,1987-5-13,-140
1987,5,14,196,0,196,1987-5-14,-196
1987,5,15,644,308,336,1987-5-15,-28
1987,5,16,882,588,294,1987-5-16,294
1987,5,17,910,574,336,1987-5-17,238
1987,5,18,770,602,168,1987-5-18,434
1987,5,19,784,686,98,1987-5-19,588
1987,5,20,714,700,14,1987-5-20,686
1987,5,21,854,840,14,1987-5-21,826
1987,5,22,1120,1120,0,1987-5-22,1120
1987,5,23,881,881,-1,1987-5-23,882
1987,5,24,700,700,0,1987-5-24,700
1987,5,25,770,770,0,1987-5-25,770
1987,5,26,546,546,0,1987-5-26,546
1987,5,27,546,546,0,1987-5-27,546
1987,5,28,154,154,0,1987-5-28,154
1987,5,29,112,112,0,1987-5-29,112
1987,5,30,84,84,0,1987-5-30,84
1987,5,31,56,56,0,1987-5-31,56
1987,6,1,70,70,0,1987-6-1,70
1987,6,2,14,14,0,1987-6-2,14
1987,6,3,0,0,0,1987-6-3,0
1987,6,4,0,0,0,1987-6-4,0
1987,6,5,0,0,0,1987-6-5,0
1987,6,6,0,0,0,1987-6-6,0
1987,6,7,0,0,0,1987-6-7,0
1987,6,8,0,0,0,1987-6-8,0
1987,6,9,0,0,0,1987-6-9,0
1987,6,10,0,0,0,1987-6-10,0
1987,6,11,14,0,14,1987-6-11,-14
1987,6,12,56,14,42,1987-6-12,-28
1987,6,13,28,14,14,1987-6-13,0
1987,6,14,14,14,0,1987-6-14,14
1987,6,15,14,14,0,1987-6-15,14
1987,6,16,0,0,0,1987-6-16,0
1987,6,17,28,14,14,1987-6-17,0
1987,6,18,112,14,98,1987-6-18,-84
1987,6,19,154,14,140,1987-6-19,-126
1987,6,20,140,14,126,1987-6-20,-112
1987,6,21,182,70,112,1987-6-21,-42
1987,6,22,322,238,84,1987-6-22,154
1987,6,23,322,252,70,1987-6-23,182
1987,6,24,308,252,56,1987-6-24,196
1987,6,25,336,308,28,1987-6-25,280
1987,6,26,308,294,14,1987-6-26,280
1987,6,27,280,252,28,1987-6-27,224
1987,6,28,224,196,28,1987-6-28,168
1987,6,29,182,182,0,1987-6-29,182
1987,6,30,14,14,0,1987-6-30,14
1987,7,1,0,0,0,1987-7-1,0
1987,7,2,0,0,0,1987-7-2,0
1987,7,3,0,0,0,1987-7-3,0
1987,7,4,0,0,0,1987-7-4,0
1987,7,5,0,0,0,1987-7-5,0
1987,7,6,0,0,0,1987-7-6,0
1987,7,7,14,0,14,1987-7-7,-14
1987,7,8,28,0,28,1987-7-8,-28
1987,7,9,42,0,42,1987-7-9,-42
1987,7,10,28,0,28,1987-7-10,-28
1987,7,11,0,0,0,1987-7-11,0
1987,7,12,0,0,0,1987-7-12,0
1987,7,13,0,0,0,1987-7-13,0
1987,7,14,0,0,0,1987-7-14,0
1987,7,15,28,28,0,1987-7-15,28
1987,7,16,98,28,70,1987-7-16,-42
1987,7,17,154,0,154,1987-7-17,-154
1987,7,18,168,0,168,1987-7-18,-168
1987,7,19,140,0,140,1987-7-19,-140
1987,7,20,238,14,224,1987-7-20,-210
1987,7,21,490,28,462,1987-7-21,-434
1987,7,22,658,28,630,1987-7-22,-602
1987,7,23,938,196,742,1987-7-23,-546
1987,7,24,1176,322,854,1987-7-24,-532
1987,7,25,1036,322,714,1987-7-25,-392
1987,7,26,966,266,700,1987-7-26,-434
1987,7,27,672,210,462,1987-7-27,-252
1987,7,28,294,140,154,1987-7-28,-14
1987,7,29,224,140,84,1987-7-29,56
1987,7,30,280,168,112,1987-7-30,56
1987,7,31,280,196,84,1987-7-31,112
1987,8,1,294,280,14,1987-8-1,266
1987,8,2,336,266,70,1987-8-2,196
1987,8,3,280,224,56,1987-8-3,168
1987,8,4,210,154,56,1987-8-4,98
1987,8,5,196,112,84,1987-8-5,28
1987,8,6,182,84,98,1987-8-6,-14
1987,8,7,252,0,252,1987-8-7,-252
1987,8,8,574,28,546,1987-8-8,-518
1987,8,9,770,14,756,1987-8-9,-742
1987,8,10,868,14,854,1987-8-10,-840
1987,8,11,672,28,644,1987-8-11,-616
1987,8,12,714,14,700,1987-8-12,-686
1987,8,13,1358,140,1218,1987-8-13,-1078
1987,8,14,1260,14,1246,1987-8-14,-1232
1987,8,15,1162,14,1148,1987-8-15,-1134
1987,8,16,1022,0,1022,1987-8-16,-1022
1987,8,17,966,0,966,1987-8-17,-966
1987,8,18,840,0,840,1987-8-18,-840
1987,8,19,742,14,728,1987-8-19,-714
1987,8,20,924,0,924,1987-8-20,-924
1987,8,21,896,56,840,1987-8-21,-784
1987,8,22,798,126,672,1987-8-22,-546
1987,8,23,560,84,476,1987-8-23,-392
1987,8,24,420,98,322,1987-8-24,-224
1987,8,25,588,462,126,1987-8-25,336
1987,8,26,308,308,0,1987-8-26,308
1987,8,27,238,224,14,1987-8-27,210
1987,8,28,28,14,14,1987-8-28,0
1987,8,29,14,0,14,1987-8-29,-14
1987,8,30,42,14,28,1987-8-30,-14
1987,8,31,28,0,28,1987-8-31,-28
1987,9,1,154,0,154,1987-9-1,-154
1987,9,2,420,0,420,1987-9-2,-420
1987,9,3,378,0,378,1987-9-3,-378
1987,9,4,280,0,280,1987-9-4,-280
1987,9,5,308,14,294,1987-9-5,-280
1987,9,6,392,0,392,1987-9-6,-392
1987,9,7,490,0,490,1987-9-7,-490
1987,9,8,630,28,602,1987-9-8,-574
1987,9,9,560,56,504,1987-9-9,-448
1987,9,10,504,28,476,1987-9-10,-448
1987,9,11,420,14,406,1987-9-11,-392
1987,9,12,364,28,336,1987-9-12,-308
1987,9,13,196,14,182,1987-9-13,-168
1987,9,14,154,0,154,1987-9-14,-154
1987,9,15,112,28,84,1987-9-15,-56
1987,9,16,56,0,56,1987-9-16,-56
1987,9,17,140,70,70,1987-9-17,0
1987,9,18,182,98,84,1987-9-18,14
1987,9,19,154,84,70,1987-9-19,14
1987,9,20,182,84,98,1987-9-20,-14
1987,9,21,182,70,112,1987-9-21,-42
1987,9,22,210,84,126,1987-9-22,-42
1987,9,23,210,98,112,1987-9-23,-14
1987,9,24,168,84,84,1987-9-24,0
1987,9,25,56,56,0,1987-9-25,56
1987,9,26,42,42,0,1987-9-26,42
1987,9,27,42,28,14,1987-9-27,14
1987,9,28,70,28,42,1987-9-28,-14
1987,9,29,196,168,28,1987-9-29,140
1987,9,30,238,196,42,1987-9-30,154
1987,10,1,252,210,42,1987-10-1,168
1987,10,2,294,280,14,1987-10-2,266
1987,10,3,238,238,0,1987-10-3,238
1987,10,4,350,336,14,1987-10-4,322
1987,10,5,350,336,14,1987-10-5,322
1987,10,6,294,280,14,1987-10-6,266
1987,10,7,252,252,0,1987-10-7,252
1987,10,8,210,196,14,1987-10-8,182
1987,10,9,364,336,28,1987-10-9,308
1987,10,10,616,518,98,1987-10-10,420
1987,10,11,784,602,182,1987-10-11,420
1987,10,12,728,504,224,1987-10-12,280
1987,10,13,868,560,308,1987-10-13,252
1987,10,14,924,560,364,1987-10-14,196
1987,10,15,1022,560,462,1987-10-15,98
1987,10,16,896,434,462,1987-10-16,-28
1987,10,17,854,462,392,1987-10-17,70
1987,10,18,616,238,378,1987-10-18,-140
1987,10,19,574,168,406,1987-10-19,-238
1987,10,20,392,126,266,1987-10-20,-140
1987,10,21,294,84,210,1987-10-21,-126
1987,10,22,196,28,168,1987-10-22,-140
1987,10,23,56,0,56,1987-10-23,-56
1987,10,24,112,84,28,1987-10-24,56
1987,10,25,392,378,14,1987-10-25,364
1987,10,26,406,364,42,1987-10-26,322
1987,10,27,504,420,84,1987-10-27,336
1987,10,28,602,406,196,1987-10-28,210
1987,10,29,798,490,308,1987-10-29,182
1987,10,30,560,308,252,1987-10-30,56
1987,10,31,504,252,252,1987-10-31,0
1987,11,1,504,280,224,1987-11-1,56
1987,11,2,476,266,210,1987-11-2,56
1987,11,3,350,196,154,1987-11-3,42
1987,11,4,504,294,210,1987-11-4,84
1987,11,5,406,210,196,1987-11-5,14
1987,11,6,238,112,126,1987-11-6,-14
1987,11,7,224,42,182,1987-11-7,-140
1987,11,8,196,70,126,1987-11-8,-56
1987,11,9,126,42,84,1987-11-9,-42
1987,11,10,56,28,28,1987-11-10,0
1987,11,11,266,56,210,1987-11-11,-154
1987,11,12,588,56,532,1987-11-12,-476
1987,11,13,686,0,686,1987-11-13,-686
1987,11,14,574,0,574,1987-11-14,-574
1987,11,15,644,0,644,1987-11-15,-644
1987,11,16,882,0,882,1987-11-16,-882
1987,11,17,812,0,812,1987-11-17,-812
1987,11,18,574,0,574,1987-11-18,-574
1987,11,19,728,0,728,1987-11-19,-728
1987,11,20,812,0,812,1987-11-20,-812
1987,11,21,896,0,896,1987-11-21,-896
1987,11,22,1064,28,1036,1987-11-22,-1008
1987,11,23,896,14,882,1987-11-23,-868
1987,11,24,644,0,644,1987-11-24,-644
1987,11,25,420,0,420,1987-11-25,-420
1987,11,26,588,28,560,1987-11-26,-532
1987,11,27,308,14,294,1987-11-27,-280
1987,11,28,154,0,154,1987-11-28,-154
1987,11,29,42,14,28,1987-11-29,-14
1987,11,30,42,14,28,1987-11-30,-14
1987,12,1,70,28,42,1987-12-1,-14
1987,12,2,42,14,28,1987-12-2,-14
1987,12,3,84,14,70,1987-12-3,-56
1987,12,4,42,14,28,1987-12-4,-14
1987,12,5,42,0,42,1987-12-5,-42
1987,12,6,140,0,140,1987-12-6,-140
1987,12,7,140,42,98,1987-12-7,-56
1987,12,8,210,42,168,1987-12-8,-126
1987,12,9,238,0,238,1987-12-9,-238
1987,12,10,210,0,210,1987-12-10,-210
1987,12,11,56,0,56,1987-12-11,-56
1987,12,12,168,28,140,1987-12-12,-112
1987,12,13,364,28,336,1987-12-13,-308
1987,12,14,364,0,364,1987-12-14,-364
1987,12,15,336,0,336,1987-12-15,-336
1987,12,16,420,0,420,1987-12-16,-420
1987,12,17,322,28,294,1987-12-17,-266
1987,12,18,322,56,266,1987-12-18,-210
1987,12,19,252,42,210,1987-12-19,-168
1987,12,20,210,14,196,1987-12-20,-182
1987,12,21,168,0,168,1987-12-21,-168
1987,12,22,168,0,168,1987-12-22,-168
1987,12,23,140,0,140,1987-12-23,-140
1987,12,24,154,0,154,1987-12-24,-154
1987,12,25,280,0,280,1987-12-25,-280
1987,12,26,714,14,700,1987-12-26,-686
1987,12,27,644,0,644,1987-12-27,-644
1987,12,28,742,0,742,1987-12-28,-742
1987,12,29,714,0,714,1987-12-29,-714
1987,12,30,672,0,672,1987-12-30,-672
1987,12,31,700,0,700,1987-12-31,-700
1988,1,1,476,0,476,1988-1-1,-476
1988,1,2,392,0,392,1988-1-2,-392
1988,1,3,280,0,280,1988-1-3,-280
1988,1,4,280,28,252,1988-1-4,-224
1988,1,5,252,28,224,1988-1-5,-196
1988,1,6,196,56,140,1988-1-6,-84
1988,1,7,322,112,210,1988-1-7,-98
1988,1,8,420,112,308,1988-1-8,-196
1988,1,9,378,98,280,1988-1-9,-182
1988,1,10,308,112,196,1988-1-10,-84
1988,1,11,364,196,168,1988-1-11,28
1988,1,12,448,280,168,1988-1-12,112
1988,1,13,560,252,308,1988-1-13,-56
1988,1,14,742,196,546,1988-1-14,-350
1988,1,15,812,98,714,1988-1-15,-616
1988,1,16,798,42,756,1988-1-16,-714
1988,1,17,602,14,588,1988-1-17,-574
1988,1,18,630,28,602,1988-1-18,-574
1988,1,19,672,0,672,1988-1-19,-672
1988,1,20,854,14,840,1988-1-20,-826
1988,1,21,742,0,742,1988-1-21,-742
1988,1,22,728,0,728,1988-1-22,-728
1988,1,23,504,0,504,1988-1-23,-504
1988,1,24,420,14,406,1988-1-24,-392
1988,1,25,308,0,308,1988-1-25,-308
1988,1,26,364,42,322,1988-1-26,-280
1988,1,27,378,224,154,1988-1-27,70
1988,1,28,700,616,84,1988-1-28,532
1988,1,29,518,462,56,1988-1-29,406
1988,1,30,350,308,42,1988-1-30,266
1988,1,31,378,336,42,1988-1-31,294
1988,2,1,504,490,14,1988-2-1,476
1988,2,2,658,630,28,1988-2-2,602
1988,2,3,518,504,14,1988-2-3,490
1988,2,4,420,392,28,1988-2-4,364
1988,2,5,322,308,14,1988-2-5,294
1988,2,6,322,294,28,1988-2-6,266
1988,2,7,294,294,0,1988-2-7,294
1988,2,8,322,308,14,1988-2-8,294
1988,2,9,294,252,42,1988-2-9,210
1988,2,10,154,112,42,1988-2-10,70
1988,2,11,112,84,28,1988-2-11,56
1988,2,12,42,28,14,1988-2-12,14
1988,2,13,826,770,56,1988-2-13,714
1988,2,14,924,854,70,1988-2-14,784
1988,2,15,812,784,28,1988-2-15,756
1988,2,16,770,742,28,1988-2-16,714
1988,2,17,854,826,28,1988-2-17,798
1988,2,18,938,798,140,1988-2-18,658
1988,2,19,910,700,210,1988-2-19,490
1988,2,20,854,686,168,1988-2-20,518
1988,2,21,672,658,14,1988-2-21,644
1988,2,22,644,644,0,1988-2-22,644
1988,2,23,546,546,0,1988-2-23,546
1988,2,24,448,434,14,1988-2-24,420
1988,2,25,420,406,14,1988-2-25,392
1988,2,26,56,56,0,1988-2-26,56
1988,2,27,112,112,0,1988-2-27,112
1988,2,28,546,350,196,1988-2-28,154
1988,2,29,434,168,266,1988-2-29,-98
1988,3,1,588,210,378,1988-3-1,-168
1988,3,2,714,210,504,1988-3-2,-294
1988,3,3,630,252,378,1988-3-3,-126
1988,3,4,700,308,392,1988-3-4,-84
1988,3,5,616,294,322,1988-3-5,-28
1988,3,6,518,266,252,1988-3-6,14
1988,3,7,434,280,154,1988-3-7,126
1988,3,8,392,294,98,1988-3-8,196
1988,3,9,392,322,70,1988-3-9,252
1988,3,10,182,182,0,1988-3-10,182
1988,3,11,126,98,28,1988-3-11,70
1988,3,12,644,294,350,1988-3-12,-56
1988,3,13,952,364,588,1988-3-13,-224
1988,3,14,1050,350,700,1988-3-14,-350
1988,3,15,966,294,672,1988-3-15,-378
1988,3,16,1036,308,728,1988-3-16,-420
1988,3,17,1050,294,756,1988-3-17,-462
1988,3,18,966,336,630,1988-3-18,-294
1988,3,19,1246,406,840,1988-3-19,-434
1988,3,20,1260,294,966,1988-3-20,-672
1988,3,21,1190,322,868,1988-3-21,-546
1988,3,22,882,322,560,1988-3-22,-238
1988,3,23,966,350,616,1988-3-23,-266
1988,3,24,1078,434,644,1988-3-24,-210
1988,3,25,1344,952,392,1988-3-25,560
1988,3,26,1386,952,434,1988-3-26,518
1988,3,27,1162,672,490,1988-3-27,182
1988,3,28,1204,686,518,1988-3-28,168
1988,3,29,1162,574,588,1988-3-29,-14
1988,3,30,1092,658,434,1988-3-30,224
1988,3,31,1064,574,490,1988-3-31,84
1988,4,1,1092,630,462,1988-4-1,168
1988,4,2,1078,602,476,1988-4-2,126
1988,4,3,1176,714,462,1988-4-3,252
1988,4,4,1246,812,434,1988-4-4,378
1988,4,5,910,532,378,1988-4-5,154
1988,4,6,938,574,364,1988-4-6,210
1988,4,7,784,434,350,1988-4-7,84
1988,4,8,896,616,280,1988-4-8,336
1988,4,9,1078,700,378,1988-4-9,322
1988,4,10,1064,770,294,1988-4-10,476
1988,4,11,1260,980,280,1988-4-11,700
1988,4,12,1456,1232,224,1988-4-12,1008
1988,4,13,1470,1064,406,1988-4-13,658
1988,4,14,1260,854,406,1988-4-14,448
1988,4,15,1666,1162,504,1988-4-15,658
1988,4,16,1764,1316,448,1988-4-16,868
1988,4,17,2002,1624,378,1988-4-17,1246
1988,4,18,1750,1498,252,1988-4-18,1246
1988,4,19,1554,1358,196,1988-4-19,1162
1988,4,20,966,868,98,1988-4-20,770
1988,4,21,742,644,98,1988-4-21,546
1988,4,22,714,560,154,1988-4-22,406
1988,4,23,630,350,280,1988-4-23,70
1988,4,24,392,140,252,1988-4-24,-112
1988,4,25,448,84,364,1988-4-25,-280
1988,4,26,448,0,448,1988-4-26,-448
1988,4,27,616,0,616,1988-4-27,-616
1988,4,28,686,0,686,1988-4-28,-686
1988,4,29,392,0,392,1988-4-29,-392
1988,4,30,504,14,490,1988-4-30,-476
1988,5,1,532,28,504,1988-5-1,-476
1988,5,2,546,84,462,1988-5-2,-378
1988,5,3,434,70,364,1988-5-3,-294
1988,5,4,560,112,448,1988-5-4,-336
1988,5,5,742,196,546,1988-5-5,-350
1988,5,6,532,266,266,1988-5-6,0
1988,5,7,210,168,42,1988-5-7,126
1988,5,8,196,98,98,1988-5-8,0
1988,5,9,406,98,308,1988-5-9,-210
1988,5,10,364,56,308,1988-5-10,-252
1988,5,11,378,126,252,1988-5-11,-126
1988,5,12,112,70,42,1988-5-12,28
1988,5,13,140,98,42,1988-5-13,56
1988,5,14,112,70,42,1988-5-14,28
1988,5,15,294,196,98,1988-5-15,98
1988,5,16,196,28,168,1988-5-16,-140
1988,5,17,252,28,224,1988-5-17,-196
1988,5,18,252,28,224,1988-5-18,-196
1988,5,19,196,14,182,1988-5-19,-168
1988,5,20,140,0,140,1988-5-20,-140
1988,5,21,98,0,98,1988-5-21,-98
1988,5,22,154,0,154,1988-5-22,-154
1988,5,23,532,0,532,1988-5-23,-532
1988,5,24,784,14,770,1988-5-24,-756
1988,5,25,742,0,742,1988-5-25,-742
1988,5,26,840,14,826,1988-5-26,-812
1988,5,27,812,14,798,1988-5-27,-784
1988,5,28,826,28,798,1988-5-28,-770
1988,5,29,1204,434,770,1988-5-29,-336
1988,5,30,1260,504,756,1988-5-30,-252
1988,5,31,1414,854,560,1988-5-31,294
1988,6,1,1470,952,518,1988-6-1,434
1988,6,2,1470,826,644,1988-6-2,182
1988,6,3,1442,868,574,1988-6-3,294
1988,6,4,1148,812,336,1988-6-4,476
1988,6,5,1386,714,672,1988-6-5,42
1988,6,6,1680,728,952,1988-6-6,-224
1988,6,7,1778,728,1050,1988-6-7,-322
1988,6,8,1918,826,1092,1988-6-8,-266
1988,6,9,1792,952,840,1988-6-9,112
1988,6,10,1456,854,602,1988-6-10,252
1988,6,11,994,658,336,1988-6-11,322
1988,6,12,462,280,182,1988-6-12,98
1988,6,13,350,252,98,1988-6-13,154
1988,6,14,630,336,294,1988-6-14,42
1988,6,15,910,434,476,1988-6-15,-42
1988,6,16,924,392,532,1988-6-16,-140
1988,6,17,938,420,518,1988-6-17,-98
1988,6,18,980,378,602,1988-6-18,-224
1988,6,19,868,280,588,1988-6-19,-308
1988,6,20,938,238,700,1988-6-20,-462
1988,6,21,952,238,714,1988-6-21,-476
1988,6,22,1050,308,742,1988-6-22,-434
1988,6,23,1316,294,1022,1988-6-23,-728
1988,6,24,1652,280,1372,1988-6-24,-1092
1988,6,25,2114,280,1834,1988-6-25,-1554
1988,6,26,2968,434,2534,1988-6-26,-2100
1988,6,27,4830,504,4326,1988-6-27,-3822
1988,6,28,4830,686,4144,1988-6-28,-3458
1988,6,29,4760,602,4158,1988-6-29,-3556
1988,6,30,4662,700,3962,1988-6-30,-3262
1988,7,1,4648,812,3836,1988-7-1,-3024
1988,7,2,4368,882,3486,1988-7-2,-2604
1988,7,3,4186,1036,3150,1988-7-3,-2114
1988,7,4,3808,980,2828,1988-7-4,-1848
1988,7,5,3164,798,2366,1988-7-5,-1568
1988,7,6,2562,1148,1414,1988-7-6,-266
1988,7,7,1932,994,938,1988-7-7,56
1988,7,8,1190,756,434,1988-7-8,322
1988,7,9,882,882,0,1988-7-9,882
1988,7,10,896,882,14,1988-7-10,868
1988,7,11,1064,826,238,1988-7-11,588
1988,7,12,1918,798,1120,1988-7-12,-322
1988,7,13,2114,714,1400,1988-7-13,-686
1988,7,14,2268,602,1666,1988-7-14,-1064
1988,7,15,1904,280,1624,1988-7-15,-1344
1988,7,16,2128,210,1918,1988-7-16,-1708
1988,7,17,1876,70,1806,1988-7-17,-1736
1988,7,18,1344,84,1260,1988-7-18,-1176
1988,7,19,1484,28,1456,1988-7-19,-1428
1988,7,20,1540,28,1512,1988-7-20,-1484
1988,7,21,1400,56,1344,1988-7-21,-1288
1988,7,22,1190,224,966,1988-7-22,-742
1988,7,23,1218,406,812,1988-7-23,-406
1988,7,24,938,364,574,1988-7-24,-210
1988,7,25,518,322,196,1988-7-25,126
1988,7,26,994,434,560,1988-7-26,-126
1988,7,27,1624,854,770,1988-7-27,84
1988,7,28,2184,1568,616,1988-7-28,952
1988,7,29,2660,1806,854,1988-7-29,952
1988,7,30,2366,1792,574,1988-7-30,1218
1988,7,31,2996,2436,560,1988-7-31,1876
1988,8,1,2240,1708,532,1988-8-1,1176
1988,8,2,2044,1610,434,1988-8-2,1176
1988,8,3,2240,1834,406,1988-8-3,1428
1988,8,4,1694,1470,224,1988-8-4,1246
1988,8,5,1120,1092,28,1988-8-5,1064
1988,8,6,1162,952,210,1988-8-6,742
1988,8,7,1638,1106,532,1988-8-7,574
1988,8,8,2478,1442,1036,1988-8-8,406
1988,8,9,2604,1400,1204,1988-8-9,196
1988,8,10,2856,1666,1190,1988-8-10,476
1988,8,11,3038,2002,1036,1988-8-11,966
1988,8,12,2660,2072,588,1988-8-12,1484
1988,8,13,2380,1820,560,1988-8-13,1260
1988,8,14,1820,1358,462,1988-8-14,896
1988,8,15,1568,1204,364,1988-8-15,840
1988,8,16,1260,882,378,1988-8-16,504
1988,8,17,994,602,392,1988-8-17,210
1988,8,18,1008,658,350,1988-8-18,308
1988,8,19,952,658,294,1988-8-19,364
1988,8,20,364,196,168,1988-8-20,28
1988,8,21,210,196,14,1988-8-21,182
1988,8,22,182,168,14,1988-8-22,154
1988,8,23,210,196,14,1988-8-23,182
1988,8,24,378,238,140,1988-8-24,98
1988,8,25,1022,476,546,1988-8-25,-70
1988,8,26,1372,574,798,1988-8-26,-224
1988,8,27,1806,602,1204,1988-8-27,-602
1988,8,28,2352,658,1694,1988-8-28,-1036
1988,8,29,3290,1078,2212,1988-8-29,-1134
1988,8,30,2982,574,2408,1988-8-30,-1834
1988,8,31,3220,602,2618,1988-8-31,-2016
1988,9,1,2954,574,2380,1988-9-1,-1806
1988,9,2,2338,350,1988,1988-9-2,-1638
1988,9,3,1918,252,1666,1988-9-3,-1414
1988,9,4,1918,266,1652,1988-9-4,-1386
1988,9,5,1848,252,1596,1988-9-5,-1344
1988,9,6,1274,112,1162,1988-9-6,-1050
1988,9,7,938,154,784,1988-9-7,-630
1988,9,8,686,168,518,1988-9-8,-350
1988,9,9,518,154,364,1988-9-9,-210
1988,9,10,378,224,154,1988-9-10,70
1988,9,11,560,252,308,1988-9-11,-56
1988,9,12,686,182,504,1988-9-12,-322
1988,9,13,756,238,518,1988-9-13,-280
1988,9,14,784,308,476,1988-9-14,-168
1988,9,15,980,532,448,1988-9-15,84
1988,9,16,728,280,448,1988-9-16,-168
1988,9,17,770,140,630,1988-9-17,-490
1988,9,18,840,154,686,1988-9-18,-532
1988,9,19,910,168,742,1988-9-19,-574
1988,9,20,1358,546,812,1988-9-20,-266
1988,9,21,1064,280,784,1988-9-21,-504
1988,9,22,1148,406,742,1988-9-22,-336
1988,9,23,1470,714,756,1988-9-23,-42
1988,9,24,1442,966,476,1988-9-24,490
1988,9,25,1246,924,322,1988-9-25,602
1988,9,26,1708,1106,602,1988-9-26,504
1988,9,27,1470,672,798,1988-9-27,-126
1988,9,28,1456,588,868,1988-9-28,-280
1988,9,29,1330,560,770,1988-9-29,-210
1988,9,30,1148,532,616,1988-9-30,-84
1988,10,1,1988,980,1008,1988-10-1,-28
1988,10,2,2114,588,1526,1988-10-2,-938
1988,10,3,3052,1218,1834,1988-10-3,-616
1988,10,4,3416,1512,1904,1988-10-4,-392
1988,10,5,3234,1470,1764,1988-10-5,-294
1988,10,6,2646,1050,1596,1988-10-6,-546
1988,10,7,2366,812,1554,1988-10-7,-742
1988,10,8,2548,840,1708,1988-10-8,-868
1988,10,9,2100,700,1400,1988-10-9,-700
1988,10,10,2114,672,1442,1988-10-10,-770
1988,10,11,2436,784,1652,1988-10-11,-868
1988,10,12,2310,728,1582,1988-10-12,-854
1988,10,13,1386,490,896,1988-10-13,-406
1988,10,14,728,532,196,1988-10-14,336
1988,10,15,616,406,210,1988-10-15,196
1988,10,16,616,308,308,1988-10-16,0
1988,10,17,938,616,322,1988-10-17,294
1988,10,18,1904,1372,532,1988-10-18,840
1988,10,19,2268,1680,588,1988-10-19,1092
1988,10,20,2226,1946,280,1988-10-20,1666
1988,10,21,2268,1932,336,1988-10-21,1596
1988,10,22,2198,1904,294,1988-10-22,1610
1988,10,23,2016,1764,252,1988-10-23,1512
1988,10,24,2058,1722,336,1988-10-24,1386
1988,10,25,1988,1652,336,1988-10-25,1316
1988,10,26,1862,1526,336,1988-10-26,1190
1988,10,27,1764,1470,294,1988-10-27,1176
1988,10,28,1610,1176,434,1988-10-28,742
1988,10,29,2030,882,1148,1988-10-29,-266
1988,10,30,1512,434,1078,1988-10-30,-644
1988,10,31,1638,280,1358,1988-10-31,-1078
1988,11,1,2002,644,1358,1988-11-1,-714
1988,11,2,2030,784,1246,1988-11-2,-462
1988,11,3,2002,868,1134,1988-11-3,-266
1988,11,4,2198,966,1232,1988-11-4,-266
1988,11,5,2464,1120,1344,1988-11-5,-224
1988,11,6,2324,1092,1232,1988-11-6,-140
1988,11,7,2142,966,1176,1988-11-7,-210
1988,11,8,1764,784,980,1988-11-8,-196
1988,11,9,2156,1232,924,1988-11-9,308
1988,11,10,2240,1540,700,1988-11-10,840
1988,11,11,1792,1596,196,1988-11-11,1400
1988,11,12,1540,1344,196,1988-11-12,1148
1988,11,13,1568,1274,294,1988-11-13,980
1988,11,14,1960,1456,504,1988-11-14,952
1988,11,15,1932,1302,630,1988-11-15,672
1988,11,16,1834,1330,504,1988-11-16,826
1988,11,17,2142,1428,714,1988-11-17,714
1988,11,18,2016,1470,546,1988-11-18,924
1988,11,19,1274,1120,154,1988-11-19,966
1988,11,20,896,770,126,1988-11-20,644
1988,11,21,1232,826,406,1988-11-21,420
1988,11,22,1232,910,322,1988-11-22,588
1988,11,23,1064,770,294,1988-11-23,476
1988,11,24,910,560,350,1988-11-24,210
1988,11,25,1036,392,644,1988-11-25,-252
1988,11,26,728,126,602,1988-11-26,-476
1988,11,27,700,154,546,1988-11-27,-392
1988,11,28,742,196,546,1988-11-28,-350
1988,11,29,882,196,686,1988-11-29,-490
1988,11,30,994,336,658,1988-11-30,-322
1988,12,1,1372,728,644,1988-12-1,84
1988,12,2,1414,742,672,1988-12-2,70
1988,12,3,1372,616,756,1988-12-3,-140
1988,12,4,1568,728,840,1988-12-4,-112
1988,12,5,1806,840,966,1988-12-5,-126
1988,12,6,1568,616,952,1988-12-6,-336
1988,12,7,1162,504,658,1988-12-7,-154
1988,12,8,924,420,504,1988-12-8,-84
1988,12,9,1176,602,574,1988-12-9,28
1988,12,10,1190,518,672,1988-12-10,-154
1988,12,11,1176,448,728,1988-12-11,-280
1988,12,12,1778,784,994,1988-12-12,-210
1988,12,13,2268,1540,728,1988-12-13,812
1988,12,14,2786,2072,714,1988-12-14,1358
1988,12,15,3010,2184,826,1988-12-15,1358
1988,12,16,3248,2464,784,1988-12-16,1680
1988,12,17,3682,2926,756,1988-12-17,2170
1988,12,18,4074,3262,812,1988-12-18,2450
1988,12,19,4620,3626,994,1988-12-19,2632
1988,12,20,4718,3682,1036,1988-12-20,2646
1988,12,21,3906,3164,742,1988-12-21,2422
1988,12,22,3920,3164,756,1988-12-22,2408
1988,12,23,4088,3374,714,1988-12-23,2660
1988,12,24,3696,3192,504,1988-12-24,2688
1988,12,25,2730,2324,406,1988-12-25,1918
1988,12,26,2254,1680,574,1988-12-26,1106
1988,12,27,2254,1568,686,1988-12-27,882
1988,12,28,2352,1442,910,1988-12-28,532
1988,12,29,2016,1092,924,1988-12-29,168
1988,12,30,1610,686,924,1988-12-30,-238
1988,12,31,1400,574,826,1988-12-31,-252
1989,1,1,1764,672,1092,1989-1-1,-420
1989,1,2,2296,910,1386,1989-1-2,-476
1989,1,3,2128,714,1414,1989-1-3,-700
1989,1,4,2254,980,1274,1989-1-4,-294
1989,1,5,2394,980,1414,1989-1-5,-434
1989,1,6,2562,994,1568,1989-1-6,-574
1989,1,7,2716,826,1890,1989-1-7,-1064
1989,1,8,3206,756,2450,1989-1-8,-1694
1989,1,9,3262,672,2590,1989-1-9,-1918
1989,1,10,3318,686,2632,1989-1-10,-1946
1989,1,11,3654,868,2786,1989-1-11,-1918
1989,1,12,3472,784,2688,1989-1-12,-1904
1989,1,13,3486,714,2772,1989-1-13,-2058
1989,1,14,3850,826,3024,1989-1-14,-2198
1989,1,15,4872,1764,3108,1989-1-15,-1344
1989,1,16,5110,2016,3094,1989-1-16,-1078
1989,1,17,4186,2016,2170,1989-1-17,-154
1989,1,18,4242,2296,1946,1989-1-18,350
1989,1,19,3836,2478,1358,1989-1-19,1120
1989,1,20,3766,2982,784,1989-1-20,2198
1989,1,21,2492,2338,154,1989-1-21,2184
1989,1,22,2016,1456,560,1989-1-22,896
1989,1,23,2660,1736,924,1989-1-23,812
1989,1,24,2548,1820,728,1989-1-24,1092
1989,1,25,2954,1876,1078,1989-1-25,798
1989,1,26,2870,1638,1232,1989-1-26,406
1989,1,27,2590,1386,1204,1989-1-27,182
1989,1,28,2044,1106,938,1989-1-28,168
1989,1,29,1764,1022,742,1989-1-29,280
1989,1,30,1666,854,812,1989-1-30,42
1989,1,31,1540,588,952,1989-1-31,-364
1989,2,1,1008,196,812,1989-2-1,-616
1989,2,2,840,210,630,1989-2-2,-420
1989,2,3,812,252,560,1989-2-3,-308
1989,2,4,980,490,490,1989-2-4,0
1989,2,5,4018,3654,364,1989-2-5,3290
1989,2,6,2814,2548,266,1989-2-6,2282
1989,2,7,2856,2422,434,1989-2-7,1988
1989,2,8,2478,2086,392,1989-2-8,1694
1989,2,9,4942,4340,602,1989-2-9,3738
1989,2,10,3444,2814,630,1989-2-10,2184
1989,2,11,3696,3038,658,1989-2-11,2380
1989,2,12,3752,3164,588,1989-2-12,2576
1989,2,13,3934,2940,994,1989-2-13,1946
1989,2,14,3976,2492,1484,1989-2-14,1008
1989,2,15,4088,2296,1792,1989-2-15,504
1989,2,16,3262,1946,1316,1989-2-16,630
1989,2,17,2282,1302,980,1989-2-17,322
1989,2,18,1442,672,770,1989-2-18,-98
1989,2,19,1190,476,714,1989-2-19,-238
1989,2,20,1498,784,714,1989-2-20,70
1989,2,21,1974,1036,938,1989-2-21,98
1989,2,22,2268,1134,1134,1989-2-22,0
1989,2,23,2506,1358,1148,1989-2-23,210
1989,2,24,3122,1680,1442,1989-2-24,238
1989,2,25,2744,1554,1190,1989-2-25,364
1989,2,26,2184,1512,672,1989-2-26,840
1989,2,27,3318,3136,182,1989-2-27,2954
1989,2,28,1162,896,266,1989-2-28,630
1989,3,1,1372,1092,280,1989-3-1,812
1989,3,2,1218,1134,84,1989-3-2,1050
1989,3,3,1442,1316,126,1989-3-3,1190
1989,3,4,1106,966,140,1989-3-4,826
1989,3,5,1190,1092,98,1989-3-5,994
1989,3,6,2828,2716,112,1989-3-6,2604
1989,3,7,3696,3584,112,1989-3-7,3472
1989,3,8,3668,3528,140,1989-3-8,3388
1989,3,9,4466,4074,392,1989-3-9,3682
1989,3,10,3906,3654,252,1989-3-10,3402
1989,3,11,4228,3752,476,1989-3-11,3276
1989,3,12,4844,4144,700,1989-3-12,3444
1989,3,13,5614,4718,896,1989-3-13,3822
1989,3,14,5964,5152,812,1989-3-14,4340
1989,3,15,6090,5292,798,1989-3-15,4494
1989,3,16,6580,5880,700,1989-3-16,5180
1989,3,17,7126,6412,714,1989-3-17,5698
1989,3,18,3430,3010,420,1989-3-18,2590
1989,3,19,2548,2198,350,1989-3-19,1848
1989,3,20,2072,1260,812,1989-3-20,448
1989,3,21,2758,1638,1120,1989-3-21,518
1989,3,22,3080,1932,1148,1989-3-22,784
1989,3,23,2842,1750,1092,1989-3-23,658
1989,3,24,2492,1582,910,1989-3-24,672
1989,3,25,1820,1274,546,1989-3-25,728
1989,3,26,1526,980,546,1989-3-26,434
1989,3,27,1036,490,546,1989-3-27,-56
1989,3,28,714,252,462,1989-3-28,-210
1989,3,29,1078,196,882,1989-3-29,-686
1989,3,30,1876,196,1680,1989-3-30,-1484
1989,3,31,2086,154,1932,1989-3-31,-1778
1989,4,1,2114,168,1946,1989-4-1,-1778
1989,4,2,2016,238,1778,1989-4-2,-1540
1989,4,3,2450,308,2142,1989-4-3,-1834
1989,4,4,2156,378,1778,1989-4-4,-1400
1989,4,5,1974,294,1680,1989-4-5,-1386
1989,4,6,2002,364,1638,1989-4-6,-1274
1989,4,7,2632,588,2044,1989-4-7,-1456
1989,4,8,2282,840,1442,1989-4-8,-602
1989,4,9,1834,770,1064,1989-4-9,-294
1989,4,10,1442,532,910,1989-4-10,-378
1989,4,11,700,322,378,1989-4-11,-56
1989,4,12,686,392,294,1989-4-12,98
1989,4,13,1246,868,378,1989-4-13,490
1989,4,14,1834,1498,336,1989-4-14,1162
1989,4,15,2142,1526,616,1989-4-15,910
1989,4,16,2156,1330,826,1989-4-16,504
1989,4,17,2632,1484,1148,1989-4-17,336
1989,4,18,2730,1330,1400,1989-4-18,-70
1989,4,19,2856,1456,1400,1989-4-19,56
1989,4,20,2576,1484,1092,1989-4-20,392
1989,4,21,3094,1652,1442,1989-4-21,210
1989,4,22,2296,1288,1008,1989-4-22,280
1989,4,23,1680,952,728,1989-4-23,224
1989,4,24,1680,784,896,1989-4-24,-112
1989,4,25,1876,504,1372,1989-4-25,-868
1989,4,26,1456,238,1218,1989-4-26,-980
1989,4,27,1736,224,1512,1989-4-27,-1288
1989,4,28,1764,224,1540,1989-4-28,-1316
1989,4,29,1484,224,1260,1989-4-29,-1036
1989,4,30,1106,322,784,1989-4-30,-462
1989,5,1,1498,616,882,1989-5-1,-266
1989,5,2,1302,560,742,1989-5-2,-182
1989,5,3,1400,630,770,1989-5-3,-140
1989,5,4,2058,826,1232,1989-5-4,-406
1989,5,5,2072,686,1386,1989-5-5,-700
1989,5,6,1918,574,1344,1989-5-6,-770
1989,5,7,2114,630,1484,1989-5-7,-854
1989,5,8,1848,686,1162,1989-5-8,-476
1989,5,9,1694,854,840,1989-5-9,14
1989,5,10,1764,798,966,1989-5-10,-168
1989,5,11,1330,714,616,1989-5-11,98
1989,5,12,1232,588,644,1989-5-12,-56
1989,5,13,1092,616,476,1989-5-13,140
1989,5,14,1134,714,420,1989-5-14,294
1989,5,15,1582,1008,574,1989-5-15,434
1989,5,16,1708,1050,658,1989-5-16,392
1989,5,17,1414,868,546,1989-5-17,322
1989,5,18,1652,1022,630,1989-5-18,392
1989,5,19,1596,1008,588,1989-5-19,420
1989,5,20,1596,1148,448,1989-5-20,700
1989,5,21,2366,1582,784,1989-5-21,798
1989,5,22,2408,1456,952,1989-5-22,504
1989,5,23,2408,966,1442,1989-5-23,-476
1989,5,24,2912,1134,1778,1989-5-24,-644
1989,5,25,2772,770,2002,1989-5-25,-1232
1989,5,26,2730,686,2044,1989-5-26,-1358
1989,5,27,2604,616,1988,1989-5-27,-1372
1989,5,28,1820,504,1316,1989-5-28,-812
1989,5,29,1582,630,952,1989-5-29,-322
1989,5,30,1386,560,826,1989-5-30,-266
1989,5,31,1554,672,882,1989-5-31,-210
1989,6,1,2338,700,1638,1989-6-1,-938
1989,6,2,2030,490,1540,1989-6-2,-1050
1989,6,3,2842,532,2310,1989-6-3,-1778
1989,6,4,2730,392,2338,1989-6-4,-1946
1989,6,5,2296,280,2016,1989-6-5,-1736
1989,6,6,1568,126,1442,1989-6-6,-1316
1989,6,7,1274,112,1162,1989-6-7,-1050
1989,6,8,2254,1092,1162,1989-6-8,-70
1989,6,9,3626,2324,1302,1989-6-9,1022
1989,6,10,4060,2408,1652,1989-6-10,756
1989,6,11,4564,2688,1876,1989-6-11,812
1989,6,12,5796,3276,2520,1989-6-12,756
1989,6,13,5838,3612,2226,1989-6-13,1386
1989,6,14,6300,3976,2324,1989-6-14,1652
1989,6,15,6146,4102,2044,1989-6-15,2058
1989,6,16,6104,4242,1862,1989-6-16,2380
1989,6,17,5334,3738,1596,1989-6-17,2142
1989,6,18,4970,3542,1428,1989-6-18,2114
1989,6,19,5222,3038,2184,1989-6-19,854
1989,6,20,4900,2548,2352,1989-6-20,196
1989,6,21,3640,1764,1876,1989-6-21,-112
1989,6,22,3514,1974,1540,1989-6-22,434
1989,6,23,3374,1764,1610,1989-6-23,154
1989,6,24,3542,1876,1666,1989-6-24,210
1989,6,25,3094,1624,1470,1989-6-25,154
1989,6,26,2674,1470,1204,1989-6-26,266
1989,6,27,2590,1596,994,1989-6-27,602
1989,6,28,2450,1400,1050,1989-6-28,350
1989,6,29,3374,2240,1134,1989-6-29,1106
1989,6,30,2968,1512,1456,1989-6-30,56
1989,7,1,1946,1022,924,1989-7-1,98
1989,7,2,3430,1316,2114,1989-7-2,-798
1989,7,3,1428,756,672,1989-7-3,84
1989,7,4,1050,574,476,1989-7-4,98
1989,7,5,868,476,392,1989-7-5,84
1989,7,6,1092,518,574,1989-7-6,-56
1989,7,7,1092,406,686,1989-7-7,-280
1989,7,8,980,308,672,1989-7-8,-364
1989,7,9,826,182,644,1989-7-9,-462
1989,7,10,1204,490,714,1989-7-10,-224
1989,7,11,1498,882,616,1989-7-11,266
1989,7,12,1428,910,518,1989-7-12,392
1989,7,13,1386,896,490,1989-7-13,406
1989,7,14,1078,728,350,1989-7-14,378
1989,7,15,1148,672,476,1989-7-15,196
1989,7,16,1358,588,770,1989-7-16,-182
1989,7,17,1680,644,1036,1989-7-17,-392
1989,7,18,1428,476,952,1989-7-18,-476
1989,7,19,1792,784,1008,1989-7-19,-224
1989,7,20,1540,658,882,1989-7-20,-224
1989,7,21,1596,672,924,1989-7-21,-252
1989,7,22,1960,770,1190,1989-7-22,-420
1989,7,23,2002,714,1288,1989-7-23,-574
1989,7,24,2016,686,1330,1989-7-24,-644
1989,7,25,1806,602,1204,1989-7-25,-602
1989,7,26,1232,224,1008,1989-7-26,-784
1989,7,27,1778,182,1596,1989-7-27,-1414
1989,7,28,1176,196,980,1989-7-28,-784
1989,7,29,1372,280,1092,1989-7-29,-812
1989,7,30,1764,420,1344,1989-7-30,-924
1989,7,31,1652,266,1386,1989-7-31,-1120
1989,8,1,1736,266,1470,1989-8-1,-1204
1989,8,2,2072,546,1526,1989-8-2,-980
1989,8,3,2744,350,2394,1989-8-3,-2044
1989,8,4,3122,420,2702,1989-8-4,-2282
1989,8,5,3122,350,2772,1989-8-5,-2422
1989,8,6,3696,658,3038,1989-8-6,-2380
1989,8,7,4354,658,3696,1989-8-7,-3038
1989,8,8,4046,616,3430,1989-8-8,-2814
1989,8,9,3962,644,3318,1989-8-9,-2674
1989,8,10,3220,574,2646,1989-8-10,-2072
1989,8,11,3836,994,2842,1989-8-11,-1848
1989,8,12,3682,1400,2282,1989-8-12,-882
1989,8,13,4788,2422,2366,1989-8-13,56
1989,8,14,5446,3486,1960,1989-8-14,1526
1989,8,15,5544,3850,1694,1989-8-15,2156
1989,8,16,4256,3626,630,1989-8-16,2996
1989,8,17,3514,3024,490,1989-8-17,2534
1989,8,18,3696,3094,602,1989-8-18,2492
1989,8,19,3696,3038,658,1989-8-19,2380
1989,8,20,3458,2758,700,1989-8-20,2058
1989,8,21,2912,2268,644,1989-8-21,1624
1989,8,22,2268,1778,490,1989-8-22,1288
1989,8,23,1694,1162,532,1989-8-23,630
1989,8,24,1778,1162,616,1989-8-24,546
1989,8,25,980,448,532,1989-8-25,-84
1989,8,26,560,210,350,1989-8-26,-140
1989,8,27,546,196,350,1989-8-27,-154
1989,8,28,490,196,294,1989-8-28,-98
1989,8,29,4242,322,3920,1989-8-29,-3598
1989,8,30,3304,294,3010,1989-8-30,-2716
1989,8,31,4886,476,4410,1989-8-31,-3934
1989,9,1,4522,210,4312,1989-9-1,-4102
1989,9,2,6720,294,6426,1989-9-2,-6132
1989,9,3,5082,490,4592,1989-9-3,-4102
1989,9,4,4606,476,4130,1989-9-4,-3654
1989,9,5,4704,1316,3388,1989-9-5,-2072
1989,9,6,5446,1876,3570,1989-9-6,-1694
1989,9,7,6608,2702,3906,1989-9-7,-1204
1989,9,8,5306,2828,2478,1989-9-8,350
1989,9,9,4928,3038,1890,1989-9-9,1148
1989,9,10,3976,2604,1372,1989-9-10,1232
1989,9,11,3934,3010,924,1989-9-11,2086
1989,9,12,3444,2996,448,1989-9-12,2548
1989,9,13,2884,2562,322,1989-9-13,2240
1989,9,14,2562,2338,224,1989-9-14,2114
1989,9,15,2268,2058,210,1989-9-15,1848
1989,9,16,2800,2240,560,1989-9-16,1680
1989,9,17,3164,2380,784,1989-9-17,1596
1989,9,18,2688,1540,1148,1989-9-18,392
1989,9,19,2716,1246,1470,1989-9-19,-224
1989,9,20,2058,448,1610,1989-9-20,-1162
1989,9,21,2058,322,1736,1989-9-21,-1414
1989,9,22,1974,182,1792,1989-9-22,-1610
1989,9,23,1848,168,1680,1989-9-23,-1512
1989,9,24,1638,42,1596,1989-9-24,-1554
1989,9,25,1582,28,1554,1989-9-25,-1526
1989,9,26,1890,14,1876,1989-9-26,-1862
1989,9,27,3094,462,2632,1989-9-27,-2170
1989,9,28,1792,252,1540,1989-9-28,-1288
1989,9,29,1442,518,924,1989-9-29,-406
1989,9,30,1526,630,896,1989-9-30,-266
1989,10,1,1582,756,826,1989-10-1,-70
1989,10,2,1764,924,840,1989-10-2,84
1989,10,3,1890,1176,714,1989-10-3,462
1989,10,4,2058,1386,672,1989-10-4,714
1989,10,5,2394,1610,784,1989-10-5,826
1989,10,6,1960,1442,518,1989-10-6,924
1989,10,7,1974,1358,616,1989-10-7,742
1989,10,8,1736,1190,546,1989-10-8,644
1989,10,9,1484,1134,350,1989-10-9,784
1989,10,10,1386,1050,336,1989-10-10,714
1989,10,11,1456,1008,448,1989-10-11,560
1989,10,12,1694,1008,686,1989-10-12,322
1989,10,13,1848,1120,728,1989-10-13,392
1989,10,14,2884,1176,1708,1989-10-14,-532
1989,10,15,3276,1316,1960,1989-10-15,-644
1989,10,16,3388,1260,2128,1989-10-16,-868
1989,10,17,3374,1162,2212,1989-10-17,-1050
1989,10,18,2786,630,2156,1989-10-18,-1526
1989,10,19,2338,406,1932,1989-10-19,-1526
1989,10,20,2142,210,1932,1989-10-20,-1722
1989,10,21,1946,84,1862,1989-10-21,-1778
1989,10,22,1862,70,1792,1989-10-22,-1722
1989,10,23,2660,98,2562,1989-10-23,-2464
1989,10,24,2422,70,2352,1989-10-24,-2282
1989,10,25,2478,168,2310,1989-10-25,-2142
1989,10,26,1162,266,896,1989-10-26,-630
1989,10,27,728,364,364,1989-10-27,0
1989,10,28,868,504,364,1989-10-28,140
1989,10,29,1218,784,434,1989-10-29,350
1989,10,30,1652,1106,546,1989-10-30,560
1989,10,31,1834,1274,560,1989-10-31,714
1989,11,1,2184,1694,490,1989-11-1,1204
1989,11,2,2282,1946,336,1989-11-2,1610
1989,11,3,2030,1806,224,1989-11-3,1582
1989,11,4,2128,1890,238,1989-11-4,1652
1989,11,5,1960,1722,238,1989-11-5,1484
1989,11,6,2926,2618,308,1989-11-6,2310
1989,11,7,2534,2338,196,1989-11-7,2142
1989,11,8,2352,2170,182,1989-11-8,1988
1989,11,9,2576,2366,210,1989-11-9,2156
1989,11,10,2800,2310,490,1989-11-10,1820
1989,11,11,2926,2226,700,1989-11-11,1526
1989,11,12,2240,1666,574,1989-11-12,1092
1989,11,13,2002,1470,532,1989-11-13,938
1989,11,14,2310,1722,588,1989-11-14,1134
1989,11,15,2226,1526,700,1989-11-15,826
1989,11,16,1806,952,854,1989-11-16,98
1989,11,17,1274,728,546,1989-11-17,182
1989,11,18,1456,812,644,1989-11-18,168
1989,11,19,2016,1120,896,1989-11-19,224
1989,11,20,2226,1330,896,1989-11-20,434
1989,11,21,2674,1834,840,1989-11-21,994
1989,11,22,2604,2086,518,1989-11-22,1568
1989,11,23,2646,2324,322,1989-11-23,2002
1989,11,24,2954,2604,350,1989-11-24,2254
1989,11,25,2534,2212,322,1989-11-25,1890
1989,11,26,3766,2408,1358,1989-11-26,1050
1989,11,27,3668,2212,1456,1989-11-27,756
1989,11,28,3794,2016,1778,1989-11-28,238
1989,11,29,2786,1372,1414,1989-11-29,-42
1989,11,30,2996,1918,1078,1989-11-30,840
1989,12,1,2912,2254,658,1989-12-1,1596
1989,12,2,2646,2268,378,1989-12-2,1890
1989,12,3,2786,2296,490,1989-12-3,1806
1989,12,4,2744,2156,588,1989-12-4,1568
1989,12,5,2870,2296,574,1989-12-5,1722
1989,12,6,2072,1596,476,1989-12-6,1120
1989,12,7,2072,1568,504,1989-12-7,1064
1989,12,8,1736,1204,532,1989-12-8,672
1989,12,9,1638,1190,448,1989-12-9,742
1989,12,10,1484,1092,392,1989-12-10,700
1989,12,11,882,728,154,1989-12-11,574
1989,12,12,854,700,154,1989-12-12,546
1989,12,13,938,826,112,1989-12-13,714
1989,12,14,952,826,126,1989-12-14,700
1989,12,15,1106,798,308,1989-12-15,490
1989,12,16,1162,700,462,1989-12-16,238
1989,12,17,1232,742,490,1989-12-17,252
1989,12,18,1414,742,672,1989-12-18,70
1989,12,19,1652,840,812,1989-12-19,28
1989,12,20,1708,798,910,1989-12-20,-112
1989,12,21,1736,826,910,1989-12-21,-84
1989,12,22,2114,1232,882,1989-12-22,350
1989,12,23,2716,1470,1246,1989-12-23,224
1989,12,24,3304,1932,1372,1989-12-24,560
1989,12,25,3500,1750,1750,1989-12-25,0
1989,12,26,4382,1568,2814,1989-12-26,-1246
1989,12,27,4270,1274,2996,1989-12-27,-1722
1989,12,28,4074,1484,2590,1989-12-28,-1106
1989,12,29,5012,1820,3192,1989-12-29,-1372
1989,12,30,4256,1764,2492,1989-12-30,-728
1989,12,31,4172,1890,2282,1989-12-31,-392
1990,1,1,2156,1582,574,1990-1-1,1008
1990,1,2,3080,1582,1498,1990-1-2,84
1990,1,3,2394,1050,1344,1990-1-3,-294
1990,1,4,1568,882,686,1990-1-4,196
1990,1,5,1638,1078,560,1990-1-5,518
1990,1,6,1666,1064,602,1990-1-6,462
1990,1,7,1596,952,644,1990-1-7,308
1990,1,8,1680,840,840,1990-1-8,0
1990,1,9,1302,532,770,1990-1-9,-238
1990,1,10,1610,574,1036,1990-1-10,-462
1990,1,11,1456,406,1050,1990-1-11,-644
1990,1,12,1708,560,1148,1990-1-12,-588
1990,1,13,1400,504,896,1990-1-13,-392
1990,1,14,980,448,532,1990-1-14,-84
1990,1,15,1274,742,532,1990-1-15,210
1990,1,16,1330,896,434,1990-1-16,462
1990,1,17,1428,826,602,1990-1-17,224
1990,1,18,1512,714,798,1990-1-18,-84
1990,1,19,2198,826,1372,1990-1-19,-546
1990,1,20,2226,812,1414,1990-1-20,-602
1990,1,21,2212,728,1484,1990-1-21,-756
1990,1,22,2548,602,1946,1990-1-22,-1344
1990,1,23,3052,672,2380,1990-1-23,-1708
1990,1,24,2828,378,2450,1990-1-24,-2072
1990,1,25,2856,434,2422,1990-1-25,-1988
1990,1,26,2926,700,2226,1990-1-26,-1526
1990,1,27,2548,882,1666,1990-1-27,-784
1990,1,28,2632,980,1652,1990-1-28,-672
1990,1,29,3430,1316,2114,1990-1-29,-798
1990,1,30,2534,980,1554,1990-1-30,-574
1990,1,31,2716,1120,1596,1990-1-31,-476
1990,2,1,2660,1204,1456,1990-2-1,-252
1990,2,2,2268,1288,980,1990-2-2,308
1990,2,3,1876,1190,686,1990-2-3,504
1990,2,4,1064,966,98,1990-2-4,868
1990,2,5,812,742,70,1990-2-5,672
1990,2,6,490,420,70,1990-2-6,350
1990,2,7,952,840,112,1990-2-7,728
1990,2,8,1064,854,210,1990-2-8,644
1990,2,9,1064,700,364,1990-2-9,336
1990,2,10,854,742,112,1990-2-10,630
1990,2,11,742,658,84,1990-2-11,574
1990,2,12,728,686,42,1990-2-12,644
1990,2,13,756,728,28,1990-2-13,700
1990,2,14,1820,1736,84,1990-2-14,1652
1990,2,15,2548,2268,280,1990-2-15,1988
1990,2,16,1442,1358,84,1990-2-16,1274
1990,2,17,770,602,168,1990-2-17,434
1990,2,18,882,574,308,1990-2-18,266
1990,2,19,1428,546,882,1990-2-19,-336
1990,2,20,2086,896,1190,1990-2-20,-294
1990,2,21,2170,798,1372,1990-2-21,-574
1990,2,22,3332,1008,2324,1990-2-22,-1316
1990,2,23,2604,1092,1512,1990-2-23,-420
1990,2,24,2856,1204,1652,1990-2-24,-448
1990,2,25,2912,1022,1890,1990-2-25,-868
1990,2,26,2604,826,1778,1990-2-26,-952
1990,2,27,2884,1106,1778,1990-2-27,-672
1990,2,28,2688,1148,1540,1990-2-28,-392
1990,3,1,2268,1022,1246,1990-3-1,-224
1990,3,2,2058,826,1232,1990-3-2,-406
1990,3,3,1806,770,1036,1990-3-3,-266
1990,3,4,1484,602,882,1990-3-4,-280
1990,3,5,1442,602,840,1990-3-5,-238
1990,3,6,1260,392,868,1990-3-6,-476
1990,3,7,1694,672,1022,1990-3-7,-350
1990,3,8,1414,546,868,1990-3-8,-322
1990,3,9,1302,560,742,1990-3-9,-182
1990,3,10,1288,686,602,1990-3-10,84
1990,3,11,1288,784,504,1990-3-11,280
1990,3,12,952,742,210,1990-3-12,532
1990,3,13,1022,868,154,1990-3-13,714
1990,3,14,1106,826,280,1990-3-14,546
1990,3,15,1288,966,322,1990-3-15,644
1990,3,16,1260,840,420,1990-3-16,420
1990,3,17,1498,924,574,1990-3-17,350
1990,3,18,2072,980,1092,1990-3-18,-112
1990,3,19,2198,714,1484,1990-3-19,-770
1990,3,20,3220,812,2408,1990-3-20,-1596
1990,3,21,2534,378,2156,1990-3-21,-1778
1990,3,22,2520,196,2324,1990-3-22,-2128
1990,3,23,2394,210,2184,1990-3-23,-1974
1990,3,24,2520,336,2184,1990-3-24,-1848
1990,3,25,2674,308,2366,1990-3-25,-2058
1990,3,26,2856,336,2520,1990-3-26,-2184
1990,3,27,2394,294,2100,1990-3-27,-1806
1990,3,28,2254,238,2016,1990-3-28,-1778
1990,3,29,1582,238,1344,1990-3-29,-1106
1990,3,30,1316,434,882,1990-3-30,-448
1990,3,31,1666,868,798,1990-3-31,70
1990,4,1,1372,966,406,1990-4-1,560
1990,4,2,1456,1064,392,1990-4-2,672
1990,4,3,1372,1078,294,1990-4-3,784
1990,4,4,1372,1120,252,1990-4-4,868
1990,4,5,1582,1218,364,1990-4-5,854
1990,4,6,1484,1176,308,1990-4-6,868
1990,4,7,994,770,224,1990-4-7,546
1990,4,8,798,616,182,1990-4-8,434
1990,4,9,728,560,168,1990-4-9,392
1990,4,10,770,630,140,1990-4-10,490
1990,4,11,616,490,126,1990-4-11,364
1990,4,12,714,546,168,1990-4-12,378
1990,4,13,1708,1162,546,1990-4-13,616
1990,4,14,2394,1736,658,1990-4-14,1078
1990,4,15,2394,1540,854,1990-4-15,686
1990,4,16,2254,1526,728,1990-4-16,798
1990,4,17,2590,1820,770,1990-4-17,1050
1990,4,18,2380,1484,896,1990-4-18,588
1990,4,19,2170,1358,812,1990-4-19,546
1990,4,20,2380,1330,1050,1990-4-20,280
1990,4,21,2002,1176,826,1990-4-21,350
1990,4,22,2212,1302,910,1990-4-22,392
1990,4,23,2212,1372,840,1990-4-23,532
1990,4,24,1876,1176,700,1990-4-24,476
1990,4,25,1806,1176,630,1990-4-25,546
1990,4,26,1526,966,560,1990-4-26,406
1990,4,27,1078,630,448,1990-4-27,182
1990,4,28,826,476,350,1990-4-28,126
1990,4,29,966,476,490,1990-4-29,-14
1990,4,30,924,434,490,1990-4-30,-56
1990,5,1,840,322,518,1990-5-1,-196
1990,5,2,644,308,336,1990-5-2,-28
1990,5,3,756,392,364,1990-5-3,28
1990,5,4,812,462,350,1990-5-4,112
1990,5,5,784,490,294,1990-5-5,196
1990,5,6,1344,770,574,1990-5-6,196
1990,5,7,1078,518,560,1990-5-7,-42
1990,5,8,1008,462,546,1990-5-8,-84
1990,5,9,1008,518,490,1990-5-9,28
1990,5,10,882,546,336,1990-5-10,210
1990,5,11,826,602,224,1990-5-11,378
1990,5,12,1218,1008,210,1990-5-12,798
1990,5,13,1946,1624,322,1990-5-13,1302
1990,5,14,1694,1148,546,1990-5-14,602
1990,5,15,2744,1736,1008,1990-5-15,728
1990,5,16,2828,1344,1484,1990-5-16,-140
1990,5,17,3374,1344,2030,1990-5-17,-686
1990,5,18,4074,1204,2870,1990-5-18,-1666
1990,5,19,4116,1232,2884,1990-5-19,-1652
1990,5,20,3808,1288,2520,1990-5-20,-1232
1990,5,21,4088,1414,2674,1990-5-21,-1260
1990,5,22,3878,1008,2870,1990-5-22,-1862
1990,5,23,3640,1274,2366,1990-5-23,-1092
1990,5,24,3066,938,2128,1990-5-24,-1190
1990,5,25,1624,602,1022,1990-5-25,-420
1990,5,26,1190,630,560,1990-5-26,70
1990,5,27,1274,686,588,1990-5-27,98
1990,5,28,1022,490,532,1990-5-28,-42
1990,5,29,868,462,406,1990-5-29,56
1990,5,30,882,462,420,1990-5-30,42
1990,5,31,728,336,392,1990-5-31,-56
1990,6,1,882,322,560,1990-6-1,-238
1990,6,2,994,322,672,1990-6-2,-350
1990,6,3,924,434,490,1990-6-3,-56
1990,6,4,1316,672,644,1990-6-4,28
1990,6,5,854,644,210,1990-6-5,434
1990,6,6,1008,770,238,1990-6-6,532
1990,6,7,952,728,224,1990-6-7,504
1990,6,8,1190,700,490,1990-6-8,210
1990,6,9,1232,784,448,1990-6-9,336
1990,6,10,1484,826,658,1990-6-10,168
1990,6,11,1526,896,630,1990-6-11,266
1990,6,12,1806,1162,644,1990-6-12,518
1990,6,13,1498,798,700,1990-6-13,98
1990,6,14,1722,840,882,1990-6-14,-42
1990,6,15,1610,672,938,1990-6-15,-266
1990,6,16,1204,322,882,1990-6-16,-560
1990,6,17,1022,224,798,1990-6-17,-574
1990,6,18,812,182,630,1990-6-18,-448
1990,6,19,686,84,602,1990-6-19,-518
1990,6,20,812,168,644,1990-6-20,-476
1990,6,21,770,210,560,1990-6-21,-350
1990,6,22,588,238,350,1990-6-22,-112
1990,6,23,630,168,462,1990-6-23,-294
1990,6,24,952,168,784,1990-6-24,-616
1990,6,25,1232,154,1078,1990-6-25,-924
1990,6,26,1218,182,1036,1990-6-26,-854
1990,6,27,1960,434,1526,1990-6-27,-1092
1990,6,28,2310,1092,1218,1990-6-28,-126
1990,6,29,3150,1596,1554,1990-6-29,42
1990,6,30,3668,2002,1666,1990-6-30,336
1990,7,1,4172,2366,1806,1990-7-1,560
1990,7,2,4298,2422,1876,1990-7-2,546
1990,7,3,4060,2520,1540,1990-7-3,980
1990,7,4,3864,2338,1526,1990-7-4,812
1990,7,5,3444,2184,1260,1990-7-5,924
1990,7,6,3220,1890,1330,1990-7-6,560
1990,7,7,3024,1722,1302,1990-7-7,420
1990,7,8,2352,1302,1050,1990-7-8,252
1990,7,9,1456,896,560,1990-7-9,336
1990,7,10,1106,798,308,1990-7-10,490
1990,7,11,854,658,196,1990-7-11,462
1990,7,12,588,420,168,1990-7-12,252
1990,7,13,602,490,112,1990-7-13,378
1990,7,14,756,546,210,1990-7-14,336
1990,7,15,784,616,168,1990-7-15,448
1990,7,16,952,728,224,1990-7-16,504
1990,7,17,686,392,294,1990-7-17,98
1990,7,18,980,308,672,1990-7-18,-364
1990,7,19,1260,476,784,1990-7-19,-308
1990,7,20,1554,504,1050,1990-7-20,-546
1990,7,21,2072,812,1260,1990-7-21,-448
1990,7,22,2254,994,1260,1990-7-22,-266
1990,7,23,2296,1008,1288,1990-7-23,-280
1990,7,24,2492,1274,1218,1990-7-24,56
1990,7,25,2772,1484,1288,1990-7-25,196
1990,7,26,2604,1260,1344,1990-7-26,-84
1990,7,27,2898,1484,1414,1990-7-27,70
1990,7,28,2086,1120,966,1990-7-28,154
1990,7,29,1680,1036,644,1990-7-29,392
1990,7,30,1190,798,392,1990-7-30,406
1990,7,31,1946,1470,476,1990-7-31,994
1990,8,1,2282,1610,672,1990-8-1,938
1990,8,2,2856,1778,1078,1990-8-2,700
1990,8,3,2996,1764,1232,1990-8-3,532
1990,8,4,2030,1400,630,1990-8-4,770
1990,8,5,1708,1246,462,1990-8-5,784
1990,8,6,1554,1218,336,1990-8-6,882
1990,8,7,1610,1190,420,1990-8-7,770
1990,8,8,1890,1232,658,1990-8-8,574
1990,8,9,2198,1512,686,1990-8-9,826
1990,8,10,3150,1666,1484,1990-8-10,182
1990,8,11,1890,1470,420,1990-8-11,1050
1990,8,12,1848,1498,350,1990-8-12,1148
1990,8,13,1582,1148,434,1990-8-13,714
1990,8,14,2240,1568,672,1990-8-14,896
1990,8,15,2632,1876,756,1990-8-15,1120
1990,8,16,2576,1890,686,1990-8-16,1204
1990,8,17,3150,2142,1008,1990-8-17,1134
1990,8,18,3892,2100,1792,1990-8-18,308
1990,8,19,6104,2100,4004,1990-8-19,-1904
1990,8,20,5418,1512,3906,1990-8-20,-2394
1990,8,21,6804,1372,5432,1990-8-21,-4060
1990,8,22,6832,910,5922,1990-8-22,-5012
1990,8,23,6370,840,5530,1990-8-23,-4690
1990,8,24,6496,868,5628,1990-8-24,-4760
1990,8,25,5978,952,5026,1990-8-25,-4074
1990,8,26,4830,1050,3780,1990-8-26,-2730
1990,8,27,3808,868,2940,1990-8-27,-2072
1990,8,28,3220,924,2296,1990-8-28,-1372
1990,8,29,3094,980,2114,1990-8-29,-1134
1990,8,30,2772,1064,1708,1990-8-30,-644
1990,8,31,2030,1288,742,1990-8-31,546
1990,9,1,1722,1204,518,1990-9-1,686
1990,9,2,1554,1162,392,1990-9-2,770
1990,9,3,1428,1064,364,1990-9-3,700
1990,9,4,1386,1092,294,1990-9-4,798
1990,9,5,980,728,252,1990-9-5,476
1990,9,6,1064,840,224,1990-9-6,616
1990,9,7,1008,742,266,1990-9-7,476
1990,9,8,966,756,210,1990-9-8,546
1990,9,9,952,728,224,1990-9-9,504
1990,9,10,1134,770,364,1990-9-10,406
1990,9,11,1540,854,686,1990-9-11,168
1990,9,12,1974,1162,812,1990-9-12,350
1990,9,13,2086,1190,896,1990-9-13,294
1990,9,14,2226,1078,1148,1990-9-14,-70
1990,9,15,2394,966,1428,1990-9-15,-462
1990,9,16,2170,826,1344,1990-9-16,-518
1990,9,17,1960,672,1288,1990-9-17,-616
1990,9,18,1834,448,1386,1990-9-18,-938
1990,9,19,1960,602,1358,1990-9-19,-756
1990,9,20,2030,658,1372,1990-9-20,-714
1990,9,21,2058,840,1218,1990-9-21,-378
1990,9,22,1988,798,1190,1990-9-22,-392
1990,9,23,2282,644,1638,1990-9-23,-994
1990,9,24,2058,518,1540,1990-9-24,-1022
1990,9,25,1638,378,1260,1990-9-25,-882
1990,9,26,1610,378,1232,1990-9-26,-854
1990,9,27,1946,336,1610,1990-9-27,-1274
1990,9,28,1232,294,938,1990-9-28,-644
1990,9,29,1344,238,1106,1990-9-29,-868
1990,9,30,1344,210,1134,1990-9-30,-924
1990,10,1,1316,112,1204,1990-10-1,-1092
1990,10,2,1848,252,1596,1990-10-2,-1344
1990,10,3,2408,504,1904,1990-10-3,-1400
1990,10,4,2422,672,1750,1990-10-4,-1078
1990,10,5,1946,392,1554,1990-10-5,-1162
1990,10,6,1582,308,1274,1990-10-6,-966
1990,10,7,1848,644,1204,1990-10-7,-560
1990,10,8,2156,966,1190,1990-10-8,-224
1990,10,9,2366,1050,1316,1990-10-9,-266
1990,10,10,2548,826,1722,1990-10-10,-896
1990,10,11,2842,1162,1680,1990-10-11,-518
1990,10,12,2674,1078,1596,1990-10-12,-518
1990,10,13,2674,1050,1624,1990-10-13,-574
1990,10,14,2828,1176,1652,1990-10-14,-476
1990,10,15,3010,1148,1862,1990-10-15,-714
1990,10,16,2828,1092,1736,1990-10-16,-644
1990,10,17,2982,1316,1666,1990-10-17,-350
1990,10,18,2968,1274,1694,1990-10-18,-420
1990,10,19,2632,1330,1302,1990-10-19,28
1990,10,20,2114,1036,1078,1990-10-20,-42
1990,10,21,1022,686,336,1990-10-21,350
1990,10,22,868,658,210,1990-10-22,448
1990,10,23,938,644,294,1990-10-23,350
1990,10,24,1078,518,560,1990-10-24,-42
1990,10,25,1162,448,714,1990-10-25,-266
1990,10,26,1036,462,574,1990-10-26,-112
1990,10,27,910,350,560,1990-10-27,-210
1990,10,28,1400,406,994,1990-10-28,-588
1990,10,29,1582,420,1162,1990-10-29,-742
1990,10,30,1400,224,1176,1990-10-30,-952
1990,10,31,1302,182,1120,1990-10-31,-938
1990,11,1,1400,224,1176,1990-11-1,-952
1990,11,2,1092,168,924,1990-11-2,-756
1990,11,3,1680,182,1498,1990-11-3,-1316
1990,11,4,1288,462,826,1990-11-4,-364
1990,11,5,1764,700,1064,1990-11-5,-364
1990,11,6,3122,2058,1064,1990-11-6,994
1990,11,7,3108,1820,1288,1990-11-7,532
1990,11,8,3066,1890,1176,1990-11-8,714
1990,11,9,2548,1568,980,1990-11-9,588
1990,11,10,3136,2324,812,1990-11-10,1512
1990,11,11,1988,1204,784,1990-11-11,420
1990,11,12,2128,1008,1120,1990-11-12,-112
1990,11,13,2674,1750,924,1990-11-13,826
1990,11,14,3738,2954,784,1990-11-14,2170
1990,11,15,4606,4074,532,1990-11-15,3542
1990,11,16,4676,4060,616,1990-11-16,3444
1990,11,17,5418,4844,574,1990-11-17,4270
1990,11,18,4788,4410,378,1990-11-18,4032
1990,11,19,4046,3752,294,1990-11-19,3458
1990,11,20,3808,3640,168,1990-11-20,3472
1990,11,21,3556,3332,224,1990-11-21,3108
1990,11,22,3430,3150,280,1990-11-22,2870
1990,11,23,3780,3262,518,1990-11-23,2744
1990,11,24,3066,2548,518,1990-11-24,2030
1990,11,25,2730,2058,672,1990-11-25,1386
1990,11,26,2198,882,1316,1990-11-26,-434
1990,11,27,1652,644,1008,1990-11-27,-364
1990,11,28,966,196,770,1990-11-28,-574
1990,11,29,1036,308,728,1990-11-29,-420
1990,11,30,1316,448,868,1990-11-30,-420
1990,12,1,1428,910,518,1990-12-1,392
1990,12,2,1414,910,504,1990-12-2,406
1990,12,3,1904,1302,602,1990-12-3,700
1990,12,4,2044,1218,826,1990-12-4,392
1990,12,5,2198,812,1386,1990-12-5,-574
1990,12,6,1960,742,1218,1990-12-6,-476
1990,12,7,1554,868,686,1990-12-7,182
1990,12,8,2072,1162,910,1990-12-8,252
1990,12,9,2366,1526,840,1990-12-9,686
1990,12,10,2800,1932,868,1990-12-10,1064
1990,12,11,3458,2800,658,1990-12-11,2142
1990,12,12,4452,4018,434,1990-12-12,3584
1990,12,13,3402,3276,126,1990-12-13,3150
1990,12,14,2982,2884,98,1990-12-14,2786
1990,12,15,2800,2716,84,1990-12-15,2632
1990,12,16,2758,2716,42,1990-12-16,2674
1990,12,17,2996,2898,98,1990-12-17,2800
1990,12,18,2786,2674,112,1990-12-18,2562
1990,12,19,3024,2912,112,1990-12-19,2800
1990,12,20,2492,2352,140,1990-12-20,2212
1990,12,21,2940,2436,504,1990-12-21,1932
1990,12,22,2800,1974,826,1990-12-22,1148
1990,12,23,3164,1666,1498,1990-12-23,168
1990,12,24,1638,532,1106,1990-12-24,-574
1990,12,25,1092,98,994,1990-12-25,-896
1990,12,26,1344,70,1274,1990-12-26,-1204
1990,12,27,1302,14,1288,1990-12-27,-1274
1990,12,28,1428,112,1316,1990-12-28,-1204
1990,12,29,1456,140,1316,1990-12-29,-1176
1990,12,30,1330,154,1176,1990-12-30,-1022
1990,12,31,1204,196,1008,1990-12-31,-812
1991,1,1,1190,196,994,1991-1-1,-798
1991,1,2,1190,182,1008,1991-1-2,-826
1991,1,3,812,140,672,1991-1-3,-532
1991,1,4,854,112,742,1991-1-4,-630
1991,1,5,1232,98,1134,1991-1-5,-1036
1991,1,6,1162,252,910,1991-1-6,-658
1991,1,7,1442,616,826,1991-1-7,-210
1991,1,8,2674,1862,812,1991-1-8,1050
1991,1,9,2828,2058,770,1991-1-9,1288
1991,1,10,2954,2324,630,1991-1-10,1694
1991,1,11,3010,2324,686,1991-1-11,1638
1991,1,12,2842,2310,532,1991-1-12,1778
1991,1,13,3164,2604,560,1991-1-13,2044
1991,1,14,2716,2030,686,1991-1-14,1344
1991,1,15,2702,2128,574,1991-1-15,1554
1991,1,16,3136,2394,742,1991-1-16,1652
1991,1,17,2912,1960,952,1991-1-17,1008
1991,1,18,3416,2534,882,1991-1-18,1652
1991,1,19,2982,2086,896,1991-1-19,1190
1991,1,20,2282,1274,1008,1991-1-20,266
1991,1,21,2338,392,1946,1991-1-21,-1554
1991,1,22,3052,630,2422,1991-1-22,-1792
1991,1,23,3472,294,3178,1991-1-23,-2884
1991,1,24,3640,308,3332,1991-1-24,-3024
1991,1,25,3752,210,3542,1991-1-25,-3332
1991,1,26,4578,308,4270,1991-1-26,-3962
1991,1,27,6160,546,5614,1991-1-27,-5068
1991,1,28,6076,868,5208,1991-1-28,-4340
1991,1,29,6258,994,5264,1991-1-29,-4270
1991,1,30,7770,1078,6692,1991-1-30,-5614
1991,1,31,6958,504,6454,1991-1-31,-5950
1991,2,1,6650,336,6314,1991-2-1,-5978
1991,2,2,6692,420,6272,1991-2-2,-5852
1991,2,3,5292,476,4816,1991-2-3,-4340
1991,2,4,3500,504,2996,1991-2-4,-2492
1991,2,5,3458,1134,2324,1991-2-5,-1190
1991,2,6,2856,1148,1708,1991-2-6,-560
1991,2,7,2156,1246,910,1991-2-7,336
1991,2,8,1512,1078,434,1991-2-8,644
1991,2,9,1792,1302,490,1991-2-9,812
1991,2,10,1680,1316,364,1991-2-10,952
1991,2,11,1344,1120,224,1991-2-11,896
1991,2,12,1988,1526,462,1991-2-12,1064
1991,2,13,2002,1316,686,1991-2-13,630
1991,2,14,1624,966,658,1991-2-14,308
1991,2,15,2114,1036,1078,1991-2-15,-42
1991,2,16,1694,616,1078,1991-2-16,-462
1991,2,17,1512,308,1204,1991-2-17,-896
1991,2,18,2772,154,2618,1991-2-18,-2464
1991,2,19,3976,350,3626,1991-2-19,-3276
1991,2,20,4060,406,3654,1991-2-20,-3248
1991,2,21,4382,546,3836,1991-2-21,-3290
1991,2,22,4354,672,3682,1991-2-22,-3010
1991,2,23,4354,560,3794,1991-2-23,-3234
1991,2,24,4158,336,3822,1991-2-24,-3486
1991,2,25,3626,322,3304,1991-2-25,-2982
1991,2,26,3332,378,2954,1991-2-26,-2576
1991,2,27,2870,364,2506,1991-2-27,-2142
1991,2,28,2954,336,2618,1991-2-28,-2282
1991,3,1,2884,420,2464,1991-3-1,-2044
1991,3,2,2814,504,2310,1991-3-2,-1806
1991,3,3,1218,420,798,1991-3-3,-378
1991,3,4,686,434,252,1991-3-4,182
1991,3,5,1078,490,588,1991-3-5,-98
1991,3,6,2016,518,1498,1991-3-6,-980
1991,3,7,2058,350,1708,1991-3-7,-1358
1991,3,8,1778,322,1456,1991-3-8,-1134
1991,3,9,1750,182,1568,1991-3-9,-1386
1991,3,10,2268,140,2128,1991-3-10,-1988
1991,3,11,2506,56,2450,1991-3-11,-2394
1991,3,12,2870,126,2744,1991-3-12,-2618
1991,3,13,2366,28,2338,1991-3-13,-2310
1991,3,14,2016,28,1988,1991-3-14,-1960
1991,3,15,2492,56,2436,1991-3-15,-2380
1991,3,16,2688,126,2562,1991-3-16,-2436
1991,3,17,2478,112,2366,1991-3-17,-2254
1991,3,18,3038,140,2898,1991-3-18,-2758
1991,3,19,3360,98,3262,1991-3-19,-3164
1991,3,20,4382,112,4270,1991-3-20,-4158
1991,3,21,3696,84,3612,1991-3-21,-3528
1991,3,22,3010,56,2954,1991-3-22,-2898
1991,3,23,3850,70,3780,1991-3-23,-3710
1991,3,24,4326,70,4256,1991-3-24,-4186
1991,3,25,4200,28,4172,1991-3-25,-4144
1991,3,26,4032,42,3990,1991-3-26,-3948
1991,3,27,3766,56,3710,1991-3-27,-3654
1991,3,28,3514,308,3206,1991-3-28,-2898
1991,3,29,3136,476,2660,1991-3-29,-2184
1991,3,30,3402,840,2562,1991-3-30,-1722
1991,3,31,2940,784,2156,1991-3-31,-1372
1991,4,1,1526,840,686,1991-4-1,154
1991,4,2,1470,812,658,1991-4-2,154
1991,4,3,1666,896,770,1991-4-3,126
1991,4,4,1512,812,700,1991-4-4,112
1991,4,5,1750,1022,728,1991-4-5,294
1991,4,6,1610,966,644,1991-4-6,322
1991,4,7,1218,714,504,1991-4-7,210
1991,4,8,1204,756,448,1991-4-8,308
1991,4,9,1470,812,658,1991-4-9,154
1991,4,10,1484,910,574,1991-4-10,336
1991,4,11,1834,1064,770,1991-4-11,294
1991,4,12,2156,1400,756,1991-4-12,644
1991,4,13,2170,1694,476,1991-4-13,1218
1991,4,14,2996,1988,1008,1991-4-14,980
1991,4,15,3024,1806,1218,1991-4-15,588
1991,4,16,2380,1316,1064,1991-4-16,252
1991,4,17,2394,1568,826,1991-4-17,742
1991,4,18,2604,1946,658,1991-4-18,1288
1991,4,19,2492,1904,588,1991-4-19,1316
1991,4,20,1442,854,588,1991-4-20,266
1991,4,21,1134,616,518,1991-4-21,98
1991,4,22,420,210,210,1991-4-22,0
1991,4,23,168,28,140,1991-4-23,-112
1991,4,24,168,0,168,1991-4-24,-168
1991,4,25,266,70,196,1991-4-25,-126
1991,4,26,448,84,364,1991-4-26,-280
1991,4,27,518,112,406,1991-4-27,-294
1991,4,28,798,238,560,1991-4-28,-322
1991,4,29,1176,448,728,1991-4-29,-280
1991,4,30,1106,392,714,1991-4-30,-322
1991,5,1,938,322,616,1991-5-1,-294
1991,5,2,728,196,532,1991-5-2,-336
1991,5,3,742,182,560,1991-5-3,-378
1991,5,4,896,196,700,1991-5-4,-504
1991,5,5,1974,938,1036,1991-5-5,-98
1991,5,6,3010,1624,1386,1991-5-6,238
1991,5,7,3794,2030,1764,1991-5-7,266
1991,5,8,4704,2184,2520,1991-5-8,-336
1991,5,9,5194,2408,2786,1991-5-9,-378
1991,5,10,4760,2450,2310,1991-5-10,140
1991,5,11,3668,2268,1400,1991-5-11,868
1991,5,12,2814,2324,490,1991-5-12,1834
1991,5,13,2800,2184,616,1991-5-13,1568
1991,5,14,2674,2030,644,1991-5-14,1386
1991,5,15,2954,2002,952,1991-5-15,1050
1991,5,16,2898,2128,770,1991-5-16,1358
1991,5,17,2660,1876,784,1991-5-17,1092
1991,5,18,3178,2072,1106,1991-5-18,966
1991,5,19,1106,294,812,1991-5-19,-518
1991,5,20,1162,336,826,1991-5-20,-490
1991,5,21,1008,392,616,1991-5-21,-224
1991,5,22,994,518,476,1991-5-22,42
1991,5,23,1218,840,378,1991-5-23,462
1991,5,24,1414,868,546,1991-5-24,322
1991,5,25,1736,1358,378,1991-5-25,980
1991,5,26,2394,1974,420,1991-5-26,1554
1991,5,27,2492,2086,406,1991-5-27,1680
1991,5,28,1974,1498,476,1991-5-28,1022
1991,5,29,2016,1694,322,1991-5-29,1372
1991,5,30,1596,1372,224,1991-5-30,1148
1991,5,31,1050,868,182,1991-5-31,686
1991,6,1,2772,1806,966,1991-6-1,840
1991,6,2,2842,1890,952,1991-6-2,938
1991,6,3,3696,2716,980,1991-6-3,1736
1991,6,4,4718,3514,1204,1991-6-4,2310
1991,6,5,4648,3458,1190,1991-6-5,2268
1991,6,6,4676,3752,924,1991-6-6,2828
1991,6,7,4074,3430,644,1991-6-7,2786
1991,6,8,4326,3668,658,1991-6-8,3010
1991,6,9,4340,3766,574,1991-6-9,3192
1991,6,10,4480,3822,658,1991-6-10,3164
1991,6,11,3990,3206,784,1991-6-11,2422
1991,6,12,4354,3318,1036,1991-6-12,2282
1991,6,13,4270,3262,1008,1991-6-13,2254
1991,6,14,4228,3346,882,1991-6-14,2464
1991,6,15,3402,2716,686,1991-6-15,2030
1991,6,16,1848,1078,770,1991-6-16,308
1991,6,17,1106,630,476,1991-6-17,154
1991,6,18,1428,728,700,1991-6-18,28
1991,6,19,1204,490,714,1991-6-19,-224
1991,6,20,1176,490,686,1991-6-20,-196
1991,6,21,1106,518,588,1991-6-21,-70
1991,6,22,1134,434,700,1991-6-22,-266
1991,6,23,910,336,574,1991-6-23,-238
1991,6,24,812,504,308,1991-6-24,196
1991,6,25,1050,714,336,1991-6-25,378
1991,6,26,1288,980,308,1991-6-26,672
1991,6,27,1722,1400,322,1991-6-27,1078
1991,6,28,1960,1414,546,1991-6-28,868
1991,6,29,2086,1456,630,1991-6-29,826
1991,6,30,2212,1540,672,1991-6-30,868
1991,7,1,2730,2058,672,1991-7-1,1386
1991,7,2,2884,2100,784,1991-7-2,1316
1991,7,3,3164,2492,672,1991-7-3,1820
1991,7,4,3024,2282,742,1991-7-4,1540
1991,7,5,2548,2016,532,1991-7-5,1484
1991,7,6,2548,1848,700,1991-7-6,1148
1991,7,7,2394,1414,980,1991-7-7,434
1991,7,8,2422,1232,1190,1991-7-8,42
1991,7,9,2212,1036,1176,1991-7-9,-140
1991,7,10,2142,966,1176,1991-7-10,-210
1991,7,11,1736,896,840,1991-7-11,56
1991,7,12,1974,644,1330,1991-7-12,-686
1991,7,13,2352,742,1610,1991-7-13,-868
1991,7,14,2310,644,1666,1991-7-14,-1022
1991,7,15,2030,378,1652,1991-7-15,-1274
1991,7,16,1218,70,1148,1991-7-16,-1078
1991,7,17,966,42,924,1991-7-17,-882
1991,7,18,812,42,770,1991-7-18,-728
1991,7,19,1400,574,826,1991-7-19,-252
1991,7,20,2366,1232,1134,1991-7-20,98
1991,7,21,2996,1904,1092,1991-7-21,812
1991,7,22,2996,2100,896,1991-7-22,1204
1991,7,23,3598,2660,938,1991-7-23,1722
1991,7,24,3458,2562,896,1991-7-24,1666
1991,7,25,3626,2744,882,1991-7-25,1862
1991,7,26,3612,2520,1092,1991-7-26,1428
1991,7,27,2856,2016,840,1991-7-27,1176
1991,7,28,2604,1918,686,1991-7-28,1232
1991,7,29,2814,2016,798,1991-7-29,1218
1991,7,30,3668,2464,1204,1991-7-30,1260
1991,7,31,2828,2002,826,1991-7-31,1176
1991,8,1,2310,1666,644,1991-8-1,1022
1991,8,2,2030,1414,616,1991-8-2,798
1991,8,3,2352,1624,728,1991-8-3,896
1991,8,4,1946,1400,546,1991-8-4,854
1991,8,5,2170,1596,574,1991-8-5,1022
1991,8,6,1862,1274,588,1991-8-6,686
1991,8,7,1876,1260,616,1991-8-7,644
1991,8,8,1820,1316,504,1991-8-8,812
1991,8,9,1302,854,448,1991-8-9,406
1991,8,10,686,252,434,1991-8-10,-182
1991,8,11,896,266,630,1991-8-11,-364
1991,8,12,910,210,700,1991-8-12,-490
1991,8,13,1274,196,1078,1991-8-13,-882
1991,8,14,1708,140,1568,1991-8-14,-1428
1991,8,15,2632,280,2352,1991-8-15,-2072
1991,8,16,3514,560,2954,1991-8-16,-2394
1991,8,17,4452,1064,3388,1991-8-17,-2324
1991,8,18,4522,1246,3276,1991-8-18,-2030
1991,8,19,4312,1400,2912,1991-8-19,-1512
1991,8,20,3864,1148,2716,1991-8-20,-1568
1991,8,21,4662,1288,3374,1991-8-21,-2086
1991,8,22,4606,1274,3332,1991-8-22,-2058
1991,8,23,4620,1316,3304,1991-8-23,-1988
1991,8,24,4606,1526,3080,1991-8-24,-1554
1991,8,25,3612,1484,2128,1991-8-25,-644
1991,8,26,2338,1568,770,1991-8-26,798
1991,8,27,2352,1596,756,1991-8-27,840
1991,8,28,2338,1428,910,1991-8-28,518
1991,8,29,2240,1190,1050,1991-8-29,140
1991,8,30,2296,966,1330,1991-8-30,-364
1991,8,31,1918,784,1134,1991-8-31,-350
1991,9,1,1904,854,1050,1991-9-1,-196
1991,9,2,1428,574,854,1991-9-2,-280
1991,9,3,1512,518,994,1991-9-3,-476
1991,9,4,1708,672,1036,1991-9-4,-364
1991,9,5,1666,616,1050,1991-9-5,-434
1991,9,6,1708,420,1288,1991-9-6,-868
1991,9,7,1708,28,1680,1991-9-7,-1652
1991,9,8,2002,182,1820,1991-9-8,-1638
1991,9,9,2254,336,1918,1991-9-9,-1582
1991,9,10,1974,434,1540,1991-9-10,-1106
1991,9,11,1820,406,1414,1991-9-11,-1008
1991,9,12,1666,378,1288,1991-9-12,-910
1991,9,13,1890,476,1414,1991-9-13,-938
1991,9,14,1428,532,896,1991-9-14,-364
1991,9,15,1232,490,742,1991-9-15,-252
1991,9,16,854,434,420,1991-9-16,14
1991,9,17,658,392,266,1991-9-17,126
1991,9,18,742,518,224,1991-9-18,294
1991,9,19,728,518,210,1991-9-19,308
1991,9,20,784,546,238,1991-9-20,308
1991,9,21,770,546,224,1991-9-21,322
1991,9,22,966,560,406,1991-9-22,154
1991,9,23,798,406,392,1991-9-23,14
1991,9,24,994,350,644,1991-9-24,-294
1991,9,25,1848,266,1582,1991-9-25,-1316
1991,9,26,2702,294,2408,1991-9-26,-2114
1991,9,27,2618,140,2478,1991-9-27,-2338
1991,9,28,2450,196,2254,1991-9-28,-2058
1991,9,29,2884,616,2268,1991-9-29,-1652
1991,9,30,3360,476,2884,1991-9-30,-2408
1991,10,1,3696,630,3066,1991-10-1,-2436
1991,10,2,3598,644,2954,1991-10-2,-2310
1991,10,3,3654,826,2828,1991-10-3,-2002
1991,10,4,3598,826,2772,1991-10-4,-1946
1991,10,5,3724,882,2842,1991-10-5,-1960
1991,10,6,3458,910,2548,1991-10-6,-1638
1991,10,7,2058,672,1386,1991-10-7,-714
1991,10,8,1456,742,714,1991-10-8,28
1991,10,9,1694,798,896,1991-10-9,-98
1991,10,10,1694,700,994,1991-10-10,-294
1991,10,11,1820,504,1316,1991-10-11,-812
1991,10,12,1722,364,1358,1991-10-12,-994
1991,10,13,1834,532,1302,1991-10-13,-770
1991,10,14,1666,448,1218,1991-10-14,-770
1991,10,15,1386,336,1050,1991-10-15,-714
1991,10,16,1526,476,1050,1991-10-16,-574
1991,10,17,1246,490,756,1991-10-17,-266
1991,10,18,1148,532,616,1991-10-18,-84
1991,10,19,840,434,406,1991-10-19,28
1991,10,20,532,336,196,1991-10-20,140
1991,10,21,364,182,182,1991-10-21,0
1991,10,22,1918,182,1736,1991-10-22,-1554
1991,10,23,3332,224,3108,1991-10-23,-2884
1991,10,24,4382,728,3654,1991-10-24,-2926
1991,10,25,5152,910,4242,1991-10-25,-3332
1991,10,26,4648,868,3780,1991-10-26,-2912
1991,10,27,4900,770,4130,1991-10-27,-3360
1991,10,28,4578,784,3794,1991-10-28,-3010
1991,10,29,4648,798,3850,1991-10-29,-3052
1991,10,30,4928,1022,3906,1991-10-30,-2884
1991,10,31,4172,1050,3122,1991-10-31,-2072
1991,11,1,3584,952,2632,1991-11-1,-1680
1991,11,2,2912,714,2198,1991-11-2,-1484
1991,11,3,1736,546,1190,1991-11-3,-644
1991,11,4,1092,462,630,1991-11-4,-168
1991,11,5,1204,266,938,1991-11-5,-672
1991,11,6,1372,196,1176,1991-11-6,-980
1991,11,7,1428,196,1232,1991-11-7,-1036
1991,11,8,1904,434,1470,1991-11-8,-1036
1991,11,9,2450,826,1624,1991-11-9,-798
1991,11,10,2674,938,1736,1991-11-10,-798
1991,11,11,1862,784,1078,1991-11-11,-294
1991,11,12,1918,1008,910,1991-11-12,98
1991,11,13,1778,840,938,1991-11-13,-98
1991,11,14,1498,574,924,1991-11-14,-350
1991,11,15,1372,630,742,1991-11-15,-112
1991,11,16,980,546,434,1991-11-16,112
1991,11,17,952,308,644,1991-11-17,-336
1991,11,18,952,196,756,1991-11-18,-560
1991,11,19,756,14,742,1991-11-19,-728
1991,11,20,812,84,728,1991-11-20,-644
1991,11,21,518,126,392,1991-11-21,-266
1991,11,22,518,98,420,1991-11-22,-322
1991,11,23,462,56,406,1991-11-23,-350
1991,11,24,448,28,420,1991-11-24,-392
1991,11,25,532,28,504,1991-11-25,-476
1991,11,26,644,14,630,1991-11-26,-616
1991,11,27,1120,140,980,1991-11-27,-840
1991,11,28,1134,182,952,1991-11-28,-770
1991,11,29,1302,210,1092,1991-11-29,-882
1991,11,30,1190,182,1008,1991-11-30,-826
1991,12,1,1050,168,882,1991-12-1,-714
1991,12,2,1330,406,924,1991-12-2,-518
1991,12,3,1512,686,826,1991-12-3,-140
1991,12,4,1932,1064,868,1991-12-4,196
1991,12,5,1834,1092,742,1991-12-5,350
1991,12,6,2226,1428,798,1991-12-6,630
1991,12,7,2744,1736,1008,1991-12-7,728
1991,12,8,2940,2002,938,1991-12-8,1064
1991,12,9,4256,2254,2002,1991-12-9,252
1991,12,10,3766,1470,2296,1991-12-10,-826
1991,12,11,3724,1512,2212,1991-12-11,-700
1991,12,12,3584,1414,2170,1991-12-12,-756
1991,12,13,3640,1582,2058,1991-12-13,-476
1991,12,14,3696,1862,1834,1991-12-14,28
1991,12,15,3514,2170,1344,1991-12-15,826
1991,12,16,3038,1778,1260,1991-12-16,518
1991,12,17,2786,1526,1260,1991-12-17,266
1991,12,18,2884,1344,1540,1991-12-18,-196
1991,12,19,2352,322,2030,1991-12-19,-1708
1991,12,20,2170,14,2156,1991-12-20,-2142
1991,12,21,2030,0,2030,1991-12-21,-2030
1991,12,22,2576,28,2548,1991-12-22,-2520
1991,12,23,4018,0,4018,1991-12-23,-4018
1991,12,24,5110,0,5110,1991-12-24,-5110
1991,12,25,4564,0,4564,1991-12-25,-4564
1991,12,26,4144,0,4144,1991-12-26,-4144
1991,12,27,4284,0,4284,1991-12-27,-4284
1991,12,28,4088,0,4088,1991-12-28,-4088
1991,12,29,3556,0,3556,1991-12-29,-3556
1991,12,30,3108,14,3094,1991-12-30,-3080
1991,12,31,2002,0,2002,1991-12-31,-2002
1992,1,1,2730,14,2716,1992-1-1,-2702
1992,1,2,3318,378,2940,1992-1-2,-2562
1992,1,3,3710,742,2968,1992-1-3,-2226
1992,1,4,3934,812,3122,1992-1-4,-2310
1992,1,5,3472,966,2506,1992-1-5,-1540
1992,1,6,3458,966,2492,1992-1-6,-1526
1992,1,7,3374,1176,2198,1992-1-7,-1022
1992,1,8,4298,1904,2394,1992-1-8,-490
1992,1,9,3528,1596,1932,1992-1-9,-336
1992,1,10,4914,1400,3514,1992-1-10,-2114
1992,1,11,2156,770,1386,1992-1-11,-616
1992,1,12,1680,616,1064,1992-1-12,-448
1992,1,13,1512,616,896,1992-1-13,-280
1992,1,14,1190,532,658,1992-1-14,-126
1992,1,15,966,196,770,1992-1-15,-574
1992,1,16,770,112,658,1992-1-16,-546
1992,1,17,630,56,574,1992-1-17,-518
1992,1,18,672,126,546,1992-1-18,-420
1992,1,19,1078,504,574,1992-1-19,-70
1992,1,20,1232,616,616,1992-1-20,0
1992,1,21,1274,546,728,1992-1-21,-182
1992,1,22,1330,630,700,1992-1-22,-70
1992,1,23,1232,546,686,1992-1-23,-140
1992,1,24,1456,784,672,1992-1-24,112
1992,1,25,1778,784,994,1992-1-25,-210
1992,1,26,1974,770,1204,1992-1-26,-434
1992,1,27,2870,966,1904,1992-1-27,-938
1992,1,28,2814,910,1904,1992-1-28,-994
1992,1,29,3444,1050,2394,1992-1-29,-1344
1992,1,30,3794,1022,2772,1992-1-30,-1750
1992,1,31,4228,994,3234,1992-1-31,-2240
1992,2,1,4074,1078,2996,1992-2-1,-1918
1992,2,2,3780,952,2828,1992-2-2,-1876
1992,2,3,4116,840,3276,1992-2-3,-2436
1992,2,4,3780,980,2800,1992-2-4,-1820
1992,2,5,2786,616,2170,1992-2-5,-1554
1992,2,6,2618,770,1848,1992-2-6,-1078
1992,2,7,2548,966,1582,1992-2-7,-616
1992,2,8,2324,952,1372,1992-2-8,-420
1992,2,9,2730,994,1736,1992-2-9,-742
1992,2,10,2968,1498,1470,1992-2-10,28
1992,2,11,3178,1652,1526,1992-2-11,126
1992,2,12,2674,1428,1246,1992-2-12,182
1992,2,13,2506,1288,1218,1992-2-13,70
1992,2,14,2086,798,1288,1992-2-14,-490
1992,2,15,2072,602,1470,1992-2-15,-868
1992,2,16,1960,490,1470,1992-2-16,-980
1992,2,17,1876,420,1456,1992-2-17,-1036
1992,2,18,1512,462,1050,1992-2-18,-588
1992,2,19,2212,924,1288,1992-2-19,-364
1992,2,20,2114,1092,1022,1992-2-20,70
1992,2,21,2296,1414,882,1992-2-21,532
1992,2,22,2604,1862,742,1992-2-22,1120
1992,2,23,3654,2772,882,1992-2-23,1890
1992,2,24,3920,2884,1036,1992-2-24,1848
1992,2,25,4102,2716,1386,1992-2-25,1330
1992,2,26,3584,2744,840,1992-2-26,1904
1992,2,27,3164,2366,798,1992-2-27,1568
1992,2,28,2646,1946,700,1992-2-28,1246
1992,2,29,2394,1638,756,1992-2-29,882
1992,3,1,2450,1638,812,1992-3-1,826
1992,3,2,1372,630,742,1992-3-2,-112
1992,3,3,952,560,392,1992-3-3,168
1992,3,4,686,420,266,1992-3-4,154
1992,3,5,476,266,210,1992-3-5,56
1992,3,6,644,280,364,1992-3-6,-84
1992,3,7,812,266,546,1992-3-7,-280
1992,3,8,826,154,672,1992-3-8,-518
1992,3,9,1050,196,854,1992-3-9,-658
1992,3,10,980,112,868,1992-3-10,-756
1992,3,11,938,140,798,1992-3-11,-658
1992,3,12,924,112,812,1992-3-12,-700
1992,3,13,1414,112,1302,1992-3-13,-1190
1992,3,14,1134,112,1022,1992-3-14,-910
1992,3,15,1008,70,938,1992-3-15,-868
1992,3,16,868,154,714,1992-3-16,-560
1992,3,17,770,210,560,1992-3-17,-350
1992,3,18,2324,1862,462,1992-3-18,1400
1992,3,19,980,518,462,1992-3-19,56
1992,3,20,1036,728,308,1992-3-20,420
1992,3,21,1008,686,322,1992-3-21,364
1992,3,22,896,574,322,1992-3-22,252
1992,3,23,700,504,196,1992-3-23,308
1992,3,24,784,560,224,1992-3-24,336
1992,3,25,1302,966,336,1992-3-25,630
1992,3,26,1806,1176,630,1992-3-26,546
1992,3,27,1918,1344,574,1992-3-27,770
1992,3,28,1974,1442,532,1992-3-28,910
1992,3,29,2422,1638,784,1992-3-29,854
1992,3,30,2562,1750,812,1992-3-30,938
1992,3,31,2394,1624,770,1992-3-31,854
1992,4,1,2478,1498,980,1992-4-1,518
1992,4,2,2212,1288,924,1992-4-2,364
1992,4,3,2002,1204,798,1992-4-3,406
1992,4,4,924,560,364,1992-4-4,196
1992,4,5,952,490,462,1992-4-5,28
1992,4,6,966,392,574,1992-4-6,-182
1992,4,7,868,252,616,1992-4-7,-364
1992,4,8,882,0,882,1992-4-8,-882
1992,4,9,1064,0,1064,1992-4-9,-1064
1992,4,10,980,14,966,1992-4-10,-952
1992,4,11,896,28,868,1992-4-11,-840
1992,4,12,938,56,882,1992-4-12,-826
1992,4,13,1008,140,868,1992-4-13,-728
1992,4,14,1092,210,882,1992-4-14,-672
1992,4,15,1064,210,854,1992-4-15,-644
1992,4,16,1078,126,952,1992-4-16,-826
1992,4,17,1442,126,1316,1992-4-17,-1190
1992,4,18,1736,224,1512,1992-4-18,-1288
1992,4,19,2254,546,1708,1992-4-19,-1162
1992,4,20,2576,672,1904,1992-4-20,-1232
1992,4,21,2058,378,1680,1992-4-21,-1302
1992,4,22,2212,434,1778,1992-4-22,-1344
1992,4,23,1960,294,1666,1992-4-23,-1372
1992,4,24,1680,490,1190,1992-4-24,-700
1992,4,25,1232,378,854,1992-4-25,-476
1992,4,26,994,294,700,1992-4-26,-406
1992,4,27,658,182,476,1992-4-27,-294
1992,4,28,532,126,406,1992-4-28,-280
1992,4,29,686,140,546,1992-4-29,-406
1992,4,30,672,98,574,1992-4-30,-476
1992,5,1,672,168,504,1992-5-1,-336
1992,5,2,742,112,630,1992-5-2,-518
1992,5,3,910,98,812,1992-5-3,-714
1992,5,4,938,84,854,1992-5-4,-770
1992,5,5,1008,42,966,1992-5-5,-924
1992,5,6,1218,28,1190,1992-5-6,-1162
1992,5,7,826,28,798,1992-5-7,-770
1992,5,8,742,84,658,1992-5-8,-574
1992,5,9,658,182,476,1992-5-9,-294
1992,5,10,616,168,448,1992-5-10,-280
1992,5,11,672,182,490,1992-5-11,-308
1992,5,12,630,154,476,1992-5-12,-322
1992,5,13,490,98,392,1992-5-13,-294
1992,5,14,462,0,462,1992-5-14,-462
1992,5,15,266,0,266,1992-5-15,-266
1992,5,16,112,0,112,1992-5-16,-112
1992,5,17,140,0,140,1992-5-17,-140
1992,5,18,154,84,70,1992-5-18,14
1992,5,19,546,476,70,1992-5-19,406
1992,5,20,1218,1008,210,1992-5-20,798
1992,5,21,1428,1148,280,1992-5-21,868
1992,5,22,2156,1134,1022,1992-5-22,112
1992,5,23,1316,1036,280,1992-5-23,756
1992,5,24,1218,1022,196,1992-5-24,826
1992,5,25,1064,994,70,1992-5-25,924
1992,5,26,910,896,14,1992-5-26,882
1992,5,27,1078,994,84,1992-5-27,910
1992,5,28,910,784,126,1992-5-28,658
1992,5,29,224,224,0,1992-5-29,224
1992,5,30,98,0,98,1992-5-30,-98
1992,5,31,196,56,140,1992-5-31,-84
1992,6,1,252,168,84,1992-6-1,84
1992,6,2,574,490,84,1992-6-2,406
1992,6,3,602,490,112,1992-6-3,378
1992,6,4,560,462,98,1992-6-4,364
1992,6,5,602,546,56,1992-6-5,490
1992,6,6,518,504,14,1992-6-6,490
1992,6,7,560,546,14,1992-6-7,532
1992,6,8,518,504,14,1992-6-8,490
1992,6,9,616,504,112,1992-6-9,392
1992,6,10,546,364,182,1992-6-10,182
1992,6,11,672,462,210,1992-6-11,252
1992,6,12,742,378,364,1992-6-12,14
1992,6,13,728,420,308,1992-6-13,112
1992,6,14,644,364,280,1992-6-14,84
1992,6,15,546,280,266,1992-6-15,14
1992,6,16,616,308,308,1992-6-16,0
1992,6,17,588,336,252,1992-6-17,84
1992,6,18,462,252,210,1992-6-18,42
1992,6,19,602,294,308,1992-6-19,-14
1992,6,20,434,280,154,1992-6-20,126
1992,6,21,420,294,126,1992-6-21,168
1992,6,22,896,728,168,1992-6-22,560
1992,6,23,1386,1260,126,1992-6-23,1134
1992,6,24,1960,1876,84,1992-6-24,1792
1992,6,25,1792,1778,14,1992-6-25,1764
1992,6,26,868,854,14,1992-6-26,840
1992,6,27,84,84,0,1992-6-27,84
1992,6,28,336,322,14,1992-6-28,308
1992,6,29,1050,1036,14,1992-6-29,1022
1992,6,30,1470,1470,0,1992-6-30,1470
1992,7,1,1638,1624,14,1992-7-1,1610
1992,7,2,1414,1414,0,1992-7-2,1414
1992,7,3,1134,1134,0,1992-7-3,1134
1992,7,4,1232,1232,0,1992-7-4,1232
1992,7,5,1330,1190,140,1992-7-5,1050
1992,7,6,1624,1092,532,1992-7-6,560
1992,7,7,1918,966,952,1992-7-7,14
1992,7,8,1932,742,1190,1992-7-8,-448
1992,7,9,2072,742,1330,1992-7-9,-588
1992,7,10,2114,630,1484,1992-7-10,-854
1992,7,11,1848,350,1498,1992-7-11,-1148
1992,7,12,2324,280,2044,1992-7-12,-1764
1992,7,13,2128,112,2016,1992-7-13,-1904
1992,7,14,1750,112,1638,1992-7-14,-1526
1992,7,15,2058,294,1764,1992-7-15,-1470
1992,7,16,2100,322,1778,1992-7-16,-1456
1992,7,17,1638,294,1344,1992-7-17,-1050
1992,7,18,1064,266,798,1992-7-18,-532
1992,7,19,392,266,126,1992-7-19,140
1992,7,20,294,252,42,1992-7-20,210
1992,7,21,266,182,84,1992-7-21,98
1992,7,22,238,154,84,1992-7-22,70
1992,7,23,350,196,154,1992-7-23,42
1992,7,24,350,42,308,1992-7-24,-266
1992,7,25,392,42,350,1992-7-25,-308
1992,7,26,504,168,336,1992-7-26,-168
1992,7,27,672,392,280,1992-7-27,112
1992,7,28,742,476,266,1992-7-28,210
1992,7,29,574,350,224,1992-7-29,126
1992,7,30,560,336,224,1992-7-30,112
1992,7,31,588,308,280,1992-7-31,28
1992,8,1,630,266,364,1992-8-1,-98
1992,8,2,1162,378,784,1992-8-2,-406
1992,8,3,1442,518,924,1992-8-3,-406
1992,8,4,1512,518,994,1992-8-4,-476
1992,8,5,1218,420,798,1992-8-5,-378
1992,8,6,1078,224,854,1992-8-6,-630
1992,8,7,1232,98,1134,1992-8-7,-1036
1992,8,8,1400,126,1274,1992-8-8,-1148
1992,8,9,1162,0,1162,1992-8-9,-1162
1992,8,10,1092,0,1092,1992-8-10,-1092
1992,8,11,1526,700,826,1992-8-11,-126
1992,8,12,2016,1442,574,1992-8-12,868
1992,8,13,1862,1288,574,1992-8-13,714
1992,8,14,1498,1190,308,1992-8-14,882
1992,8,15,1316,1232,84,1992-8-15,1148
1992,8,16,1316,1274,42,1992-8-16,1232
1992,8,17,1554,1526,28,1992-8-17,1498
1992,8,18,1610,1610,0,1992-8-18,1610
1992,8,19,2002,1918,84,1992-8-19,1834
1992,8,20,2072,2030,42,1992-8-20,1988
1992,8,21,1988,1918,70,1992-8-21,1848
1992,8,22,1554,1498,56,1992-8-22,1442
1992,8,23,1666,1610,56,1992-8-23,1554
1992,8,24,462,364,98,1992-8-24,266
1992,8,25,56,14,42,1992-8-25,-28
1992,8,26,70,42,28,1992-8-26,14
1992,8,27,112,112,0,1992-8-27,112
1992,8,28,140,140,0,1992-8-28,140
1992,8,29,224,140,84,1992-8-29,56
1992,8,30,98,28,70,1992-8-30,-42
1992,8,31,140,28,112,1992-8-31,-84
1992,9,1,210,28,182,1992-9-1,-154
1992,9,2,378,28,350,1992-9-2,-322
1992,9,3,406,0,406,1992-9-3,-406
1992,9,4,448,14,434,1992-9-4,-420
1992,9,5,462,14,448,1992-9-5,-434
1992,9,6,700,14,686,1992-9-6,-672
1992,9,7,1134,168,966,1992-9-7,-798
1992,9,8,1078,434,644,1992-9-8,-210
1992,9,9,588,364,224,1992-9-9,140
1992,9,10,392,322,70,1992-9-10,252
1992,9,11,462,294,168,1992-9-11,126
1992,9,12,476,308,168,1992-9-12,140
1992,9,13,616,294,322,1992-9-13,-28
1992,9,14,518,238,280,1992-9-14,-42
1992,9,15,560,210,350,1992-9-15,-140
1992,9,16,812,406,406,1992-9-16,0
1992,9,17,952,630,322,1992-9-17,308
1992,9,18,854,560,294,1992-9-18,266
1992,9,19,637,406,231,1992-9-19,175
1992,9,20,560,168,392,1992-9-20,-224
1992,9,21,658,56,602,1992-9-21,-546
1992,9,22,784,98,686,1992-9-22,-588
1992,9,23,882,70,812,1992-9-23,-742
1992,9,24,910,56,854,1992-9-24,-798
1992,9,25,1064,112,952,1992-9-25,-840
1992,9,26,1036,182,854,1992-9-26,-672
1992,9,27,1008,238,770,1992-9-27,-532
1992,9,28,1162,322,840,1992-9-28,-518
1992,9,29,1162,434,728,1992-9-29,-294
1992,9,30,1106,434,672,1992-9-30,-238
1992,10,1,1022,476,546,1992-10-1,-70
1992,10,2,938,434,504,1992-10-2,-70
1992,10,3,980,462,518,1992-10-3,-56
1992,10,4,826,336,490,1992-10-4,-154
1992,10,5,1036,322,714,1992-10-5,-392
1992,10,6,1092,266,826,1992-10-6,-560
1992,10,7,980,266,714,1992-10-7,-448
1992,10,8,840,252,588,1992-10-8,-336
1992,10,9,714,266,448,1992-10-9,-182
1992,10,10,560,196,364,1992-10-10,-168
1992,10,11,574,112,462,1992-10-11,-350
1992,10,12,322,0,322,1992-10-12,-322
1992,10,13,140,14,126,1992-10-13,-112
1992,10,14,210,98,112,1992-10-14,-14
1992,10,15,210,98,112,1992-10-15,-14
1992,10,16,294,224,70,1992-10-16,154
1992,10,17,392,210,182,1992-10-17,28
1992,10,18,630,224,406,1992-10-18,-182
1992,10,19,854,406,448,1992-10-19,-42
1992,10,20,1540,980,560,1992-10-20,420
1992,10,21,1890,1022,868,1992-10-21,154
1992,10,22,1890,1078,812,1992-10-22,266
1992,10,23,2002,1134,868,1992-10-23,266
1992,10,24,2100,1190,910,1992-10-24,280
1992,10,25,2730,1274,1456,1992-10-25,-182
1992,10,26,3346,1092,2254,1992-10-26,-1162
1992,10,27,3360,378,2982,1992-10-27,-2604
1992,10,28,3332,168,3164,1992-10-28,-2996
1992,10,29,3374,42,3332,1992-10-29,-3290
1992,10,30,3374,56,3318,1992-10-30,-3262
1992,10,31,2198,14,2184,1992-10-31,-2170
1992,11,1,1064,98,966,1992-11-1,-868
1992,11,2,1148,28,1120,1992-11-2,-1092
1992,11,3,1162,28,1134,1992-11-3,-1106
1992,11,4,1204,0,1204,1992-11-4,-1204
1992,11,5,1666,84,1582,1992-11-5,-1498
1992,11,6,1820,266,1554,1992-11-6,-1288
1992,11,7,1778,308,1470,1992-11-7,-1162
1992,11,8,1498,280,1218,1992-11-8,-938
1992,11,9,1638,322,1316,1992-11-9,-994
1992,11,10,1638,420,1218,1992-11-10,-798
1992,11,11,1498,490,1008,1992-11-11,-518
1992,11,12,1246,448,798,1992-11-12,-350
1992,11,13,938,238,700,1992-11-13,-462
1992,11,14,826,238,588,1992-11-14,-350
1992,11,15,728,182,546,1992-11-15,-364
1992,11,16,1162,154,1008,1992-11-16,-854
1992,11,17,1442,84,1358,1992-11-17,-1274
1992,11,18,1568,56,1512,1992-11-18,-1456
1992,11,19,1498,28,1470,1992-11-19,-1442
1992,11,20,1596,0,1596,1992-11-20,-1596
1992,11,21,1288,0,1288,1992-11-21,-1288
1992,11,22,1120,70,1050,1992-11-22,-980
1992,11,23,1764,476,1288,1992-11-23,-812
1992,11,24,1862,658,1204,1992-11-24,-546
1992,11,25,1834,644,1190,1992-11-25,-546
1992,11,26,1974,686,1288,1992-11-26,-602
1992,11,27,1834,770,1064,1992-11-27,-294
1992,11,28,1218,686,532,1992-11-28,154
1992,11,29,980,602,378,1992-11-29,224
1992,11,30,980,672,308,1992-11-30,364
1992,12,1,924,784,140,1992-12-1,644
1992,12,2,1064,826,238,1992-12-2,588
1992,12,3,938,658,280,1992-12-3,378
1992,12,4,770,518,252,1992-12-4,266
1992,12,5,784,392,392,1992-12-5,0
1992,12,6,210,28,182,1992-12-6,-154
1992,12,7,210,0,210,1992-12-7,-210
1992,12,8,476,56,420,1992-12-8,-364
1992,12,9,700,56,644,1992-12-9,-588
1992,12,10,1078,84,994,1992-12-10,-910
1992,12,11,1610,98,1512,1992-12-11,-1414
1992,12,12,1848,84,1764,1992-12-12,-1680
1992,12,13,1666,70,1596,1992-12-13,-1526
1992,12,14,1680,70,1610,1992-12-14,-1540
1992,12,15,1890,84,1806,1992-12-15,-1722
1992,12,16,1442,70,1372,1992-12-16,-1302
1992,12,17,1050,84,966,1992-12-17,-882
1992,12,18,882,70,812,1992-12-18,-742
1992,12,19,1036,126,910,1992-12-19,-784
1992,12,20,1176,182,994,1992-12-20,-812
1992,12,21,1204,322,882,1992-12-21,-560
1992,12,22,1008,266,742,1992-12-22,-476
1992,12,23,756,112,644,1992-12-23,-532
1992,12,24,714,140,574,1992-12-24,-434
1992,12,25,616,210,406,1992-12-25,-196
1992,12,26,672,336,336,1992-12-26,0
1992,12,27,770,448,322,1992-12-27,126
1992,12,28,742,462,280,1992-12-28,182
1992,12,29,770,532,238,1992-12-29,294
1992,12,30,770,560,210,1992-12-30,350
1992,12,31,532,336,196,1992-12-31,140
1993,1,1,826,140,686,1993-1-1,-546
1993,1,2,728,112,616,1993-1-2,-504
1993,1,3,714,14,700,1993-1-3,-686
1993,1,4,952,0,952,1993-1-4,-952
1993,1,5,980,0,980,1993-1-5,-980
1993,1,6,994,56,938,1993-1-6,-882
1993,1,7,784,112,672,1993-1-7,-560
1993,1,8,686,84,602,1993-1-8,-518
1993,1,9,560,84,476,1993-1-9,-392
1993,1,10,574,126,448,1993-1-10,-322
1993,1,11,504,140,364,1993-1-11,-224
1993,1,12,658,168,490,1993-1-12,-322
1993,1,13,700,154,546,1993-1-13,-392
1993,1,14,644,154,490,1993-1-14,-336
1993,1,15,742,266,476,1993-1-15,-210
1993,1,16,812,266,546,1993-1-16,-280
1993,1,17,840,280,560,1993-1-17,-280
1993,1,18,714,280,434,1993-1-18,-154
1993,1,19,812,308,504,1993-1-19,-196
1993,1,20,532,238,294,1993-1-20,-56
1993,1,21,490,280,210,1993-1-21,70
1993,1,22,392,210,182,1993-1-22,28
1993,1,23,336,224,112,1993-1-23,112
1993,1,24,378,238,140,1993-1-24,98
1993,1,25,336,224,112,1993-1-25,112
1993,1,26,322,224,98,1993-1-26,126
1993,1,27,462,168,294,1993-1-27,-126
1993,1,28,364,0,364,1993-1-28,-364
1993,1,29,434,0,434,1993-1-29,-434
1993,1,30,406,0,406,1993-1-30,-406
1993,1,31,350,0,350,1993-1-31,-350
1993,2,1,742,336,406,1993-2-1,-70
1993,2,2,812,700,112,1993-2-2,588
1993,2,3,1582,1428,154,1993-2-3,1274
1993,2,4,1988,1764,224,1993-2-4,1540
1993,2,5,2800,1988,812,1993-2-5,1176
1993,2,6,2856,1792,1064,1993-2-6,728
1993,2,7,2786,1596,1190,1993-2-7,406
1993,2,8,2884,1498,1386,1993-2-8,112
1993,2,9,2870,1218,1652,1993-2-9,-434
1993,2,10,2716,924,1792,1993-2-10,-868
1993,2,11,2338,756,1582,1993-2-11,-826
1993,2,12,1974,700,1274,1993-2-12,-574
1993,2,13,1652,658,994,1993-2-13,-336
1993,2,14,1386,448,938,1993-2-14,-490
1993,2,15,1134,210,924,1993-2-15,-714
1993,2,16,1036,196,840,1993-2-16,-644
1993,2,17,644,266,378,1993-2-17,-112
1993,2,18,560,224,336,1993-2-18,-112
1993,2,19,700,224,476,1993-2-19,-252
1993,2,20,672,182,490,1993-2-20,-308
1993,2,21,1148,532,616,1993-2-21,-84
1993,2,22,1456,728,728,1993-2-22,0
1993,2,23,1428,686,742,1993-2-23,-56
1993,2,24,1400,742,658,1993-2-24,84
1993,2,25,1050,574,476,1993-2-25,98
1993,2,26,1022,532,490,1993-2-26,42
1993,2,27,966,560,406,1993-2-27,154
1993,2,28,812,518,294,1993-2-28,224
1993,3,1,658,364,294,1993-3-1,70
1993,3,2,1078,504,574,1993-3-2,-70
1993,3,3,1792,574,1218,1993-3-3,-644
1993,3,4,1820,546,1274,1993-3-4,-728
1993,3,5,1946,546,1400,1993-3-5,-854
1993,3,6,1554,420,1134,1993-3-6,-714
1993,3,7,1540,294,1246,1993-3-7,-952
1993,3,8,1484,224,1260,1993-3-8,-1036
1993,3,9,1302,140,1162,1993-3-9,-1022
1993,3,10,1372,154,1218,1993-3-10,-1064
1993,3,11,1540,378,1162,1993-3-11,-784
1993,3,12,1708,490,1218,1993-3-12,-728
1993,3,13,1666,336,1330,1993-3-13,-994
1993,3,14,896,308,588,1993-3-14,-280
1993,3,15,588,266,322,1993-3-15,-56
1993,3,16,560,224,336,1993-3-16,-112
1993,3,17,798,238,560,1993-3-17,-322
1993,3,18,602,350,252,1993-3-18,98
1993,3,19,728,420,308,1993-3-19,112
1993,3,20,644,406,238,1993-3-20,168
1993,3,21,700,448,252,1993-3-21,196
1993,3,22,728,462,266,1993-3-22,196
1993,3,23,420,196,224,1993-3-23,-28
1993,3,24,210,56,154,1993-3-24,-98
1993,3,25,476,196,280,1993-3-25,-84
1993,3,26,546,336,210,1993-3-26,126
1993,3,27,770,518,252,1993-3-27,266
1993,3,28,672,518,154,1993-3-28,364
1993,3,29,742,560,182,1993-3-29,378
1993,3,30,728,322,406,1993-3-30,-84
1993,3,31,770,350,420,1993-3-31,-70
1993,4,1,826,364,462,1993-4-1,-98
1993,4,2,868,336,532,1993-4-2,-196
1993,4,3,840,224,616,1993-4-3,-392
1993,4,4,770,168,602,1993-4-4,-434
1993,4,5,896,140,756,1993-4-5,-616
1993,4,6,1190,112,1078,1993-4-6,-966
1993,4,7,1092,0,1092,1993-4-7,-1092
1993,4,8,1078,14,1064,1993-4-8,-1050
1993,4,9,1372,126,1246,1993-4-9,-1120
1993,4,10,980,168,812,1993-4-10,-644
1993,4,11,784,280,504,1993-4-11,-224
1993,4,12,392,224,168,1993-4-12,56
1993,4,13,140,56,84,1993-4-13,-28
1993,4,14,28,28,0,1993-4-14,28
1993,4,15,56,56,0,1993-4-15,56
1993,4,16,112,112,0,1993-4-16,112
1993,4,17,224,210,14,1993-4-17,196
1993,4,18,546,406,140,1993-4-18,266
1993,4,19,588,406,182,1993-4-19,224
1993,4,20,882,616,266,1993-4-20,350
1993,4,21,896,616,280,1993-4-21,336
1993,4,22,896,532,364,1993-4-22,168
1993,4,23,966,504,462,1993-4-23,42
1993,4,24,826,378,448,1993-4-24,-70
1993,4,25,756,434,322,1993-4-25,112
1993,4,26,868,504,364,1993-4-26,140
1993,4,27,882,504,378,1993-4-27,126
1993,4,28,462,280,182,1993-4-28,98
1993,4,29,224,98,126,1993-4-29,-28
1993,4,30,196,112,84,1993-4-30,28
1993,5,1,154,84,70,1993-5-1,14
1993,5,2,98,56,42,1993-5-2,14
1993,5,3,126,42,84,1993-5-3,-42
1993,5,4,406,252,154,1993-5-4,98
1993,5,5,770,644,126,1993-5-5,518
1993,5,6,1092,882,210,1993-5-6,672
1993,5,7,1134,1008,126,1993-5-7,882
1993,5,8,994,910,84,1993-5-8,826
1993,5,9,1232,1092,140,1993-5-9,952
1993,5,10,1470,1288,182,1993-5-10,1106
1993,5,11,1568,1316,252,1993-5-11,1064
1993,5,12,1246,1092,154,1993-5-12,938
1993,5,13,840,840,0,1993-5-13,840
1993,5,14,630,630,0,1993-5-14,630
1993,5,15,350,350,0,1993-5-15,350
1993,5,16,238,238,0,1993-5-16,238
1993,5,17,112,112,0,1993-5-17,112
1993,5,18,112,112,0,1993-5-18,112
1993,5,19,70,70,0,1993-5-19,70
1993,5,20,84,70,14,1993-5-20,56
1993,5,21,70,56,14,1993-5-21,42
1993,5,22,14,0,14,1993-5-22,-14
1993,5,23,14,0,14,1993-5-23,-14
1993,5,24,42,28,14,1993-5-24,14
1993,5,25,196,182,14,1993-5-25,168
1993,5,26,420,406,14,1993-5-26,392
1993,5,27,630,630,0,1993-5-27,630
1993,5,28,798,798,0,1993-5-28,798
1993,5,29,742,742,0,1993-5-29,742
1993,5,30,868,868,0,1993-5-30,868
1993,5,31,1106,1022,84,1993-5-31,938
1993,6,1,1134,966,168,1993-6-1,798
1993,6,2,1232,980,252,1993-6-2,728
1993,6,3,1218,910,308,1993-6-3,602
1993,6,4,1120,784,336,1993-6-4,448
1993,6,5,994,644,350,1993-6-5,294
1993,6,6,1036,462,574,1993-6-6,-112
1993,6,7,770,126,644,1993-6-7,-518
1993,6,8,980,238,742,1993-6-8,-504
1993,6,9,1022,224,798,1993-6-9,-574
1993,6,10,1022,210,812,1993-6-10,-602
1993,6,11,616,196,420,1993-6-11,-224
1993,6,12,140,140,0,1993-6-12,140
1993,6,13,140,140,0,1993-6-13,140
1993,6,14,140,140,0,1993-6-14,140
1993,6,15,126,126,0,1993-6-15,126
1993,6,16,140,140,0,1993-6-16,140
1993,6,17,140,140,0,1993-6-17,140
1993,6,18,70,70,0,1993-6-18,70
1993,6,19,28,28,0,1993-6-19,28
1993,6,20,56,14,42,1993-6-20,-28
1993,6,21,140,28,112,1993-6-21,-84
1993,6,22,126,0,126,1993-6-22,-126
1993,6,23,434,84,350,1993-6-23,-266
1993,6,24,518,182,336,1993-6-24,-154
1993,6,25,574,168,406,1993-6-25,-238
1993,6,26,616,140,476,1993-6-26,-336
1993,6,27,826,140,686,1993-6-27,-546
1993,6,28,882,112,770,1993-6-28,-658
1993,6,29,896,70,826,1993-6-29,-756
1993,6,30,728,0,728,1993-6-30,-728
1993,7,1,602,14,588,1993-7-1,-574
1993,7,2,504,14,490,1993-7-2,-476
1993,7,3,616,14,602,1993-7-3,-588
1993,7,4,728,70,658,1993-7-4,-588
1993,7,5,784,280,504,1993-7-5,-224
1993,7,6,574,238,336,1993-7-6,-98
1993,7,7,420,224,196,1993-7-7,28
1993,7,8,280,210,70,1993-7-8,140
1993,7,9,294,210,84,1993-7-9,126
1993,7,10,224,210,14,1993-7-10,196
1993,7,11,336,308,28,1993-7-11,280
1993,7,12,238,224,14,1993-7-12,210
1993,7,13,252,196,56,1993-7-13,140
1993,7,14,406,154,252,1993-7-14,-98
1993,7,15,700,350,350,1993-7-15,0
1993,7,16,784,322,462,1993-7-16,-140
1993,7,17,770,336,434,1993-7-17,-98
1993,7,18,672,210,462,1993-7-18,-252
1993,7,19,630,182,448,1993-7-19,-266
1993,7,20,546,154,392,1993-7-20,-238
1993,7,21,546,84,462,1993-7-21,-378
1993,7,22,546,98,448,1993-7-22,-350
1993,7,23,490,182,308,1993-7-23,-126
1993,7,24,560,182,378,1993-7-24,-196
1993,7,25,392,126,266,1993-7-25,-140
1993,7,26,322,140,182,1993-7-26,-42
1993,7,27,532,210,322,1993-7-27,-112
1993,7,28,504,210,294,1993-7-28,-84
1993,7,29,280,154,126,1993-7-29,28
1993,7,30,210,140,70,1993-7-30,70
1993,7,31,196,168,28,1993-7-31,140
1993,8,1,336,252,84,1993-8-1,168
1993,8,2,350,252,98,1993-8-2,154
1993,8,3,658,602,56,1993-8-3,546
1993,8,4,462,434,28,1993-8-4,406
1993,8,5,350,322,28,1993-8-5,294
1993,8,6,336,308,28,1993-8-6,280
1993,8,7,336,336,0,1993-8-7,336
1993,8,8,252,252,0,1993-8-8,252
1993,8,9,448,434,14,1993-8-9,420
1993,8,10,490,350,140,1993-8-10,210
1993,8,11,770,462,308,1993-8-11,154
1993,8,12,812,490,322,1993-8-12,168
1993,8,13,756,420,336,1993-8-13,84
1993,8,14,406,112,294,1993-8-14,-182
1993,8,15,238,0,238,1993-8-15,-238
1993,8,16,224,0,224,1993-8-16,-224
1993,8,17,252,0,252,1993-8-17,-252
1993,8,18,364,0,364,1993-8-18,-364
1993,8,19,434,0,434,1993-8-19,-434
1993,8,20,350,0,350,1993-8-20,-350
1993,8,21,434,56,378,1993-8-21,-322
1993,8,22,406,84,322,1993-8-22,-238
1993,8,23,420,84,336,1993-8-23,-252
1993,8,24,490,168,322,1993-8-24,-154
1993,8,25,434,210,224,1993-8-25,-14
1993,8,26,406,238,168,1993-8-26,70
1993,8,27,336,196,140,1993-8-27,56
1993,8,28,406,266,140,1993-8-28,126
1993,8,29,238,182,56,1993-8-29,126
1993,8,30,224,196,28,1993-8-30,168
1993,8,31,266,266,0,1993-8-31,266
1993,9,1,182,182,0,1993-9-1,182
1993,9,2,154,154,0,1993-9-2,154
1993,9,3,154,154,0,1993-9-3,154
1993,9,4,126,112,14,1993-9-4,98
1993,9,5,98,56,42,1993-9-5,14
1993,9,6,14,14,0,1993-9-6,14
1993,9,7,14,14,0,1993-9-7,14
1993,9,8,28,28,0,1993-9-8,28
1993,9,9,0,0,0,1993-9-9,0
1993,9,10,0,0,0,1993-9-10,0
1993,9,11,0,0,0,1993-9-11,0
1993,9,12,0,0,0,1993-9-12,0
1993,9,13,0,0,0,1993-9-13,0
1993,9,14,0,0,0,1993-9-14,0
1993,9,15,56,0,56,1993-9-15,-56
1993,9,16,84,14,70,1993-9-16,-56
1993,9,17,84,0,84,1993-9-17,-84
1993,9,18,98,0,98,1993-9-18,-98
1993,9,19,56,0,56,1993-9-19,-56
1993,9,20,28,0,28,1993-9-20,-28
1993,9,21,28,0,28,1993-9-21,-28
1993,9,22,0,0,0,1993-9-22,0
1993,9,23,42,0,42,1993-9-23,-42
1993,9,24,280,0,280,1993-9-24,-280
1993,9,25,420,56,364,1993-9-25,-308
1993,9,26,476,56,420,1993-9-26,-364
1993,9,27,1330,952,378,1993-9-27,574
1993,9,28,1932,1582,350,1993-9-28,1232
1993,9,29,1848,1596,252,1993-9-29,1344
1993,9,30,1820,1554,266,1993-9-30,1288
1993,10,1,1666,1386,280,1993-10-1,1106
1993,10,2,1960,1260,700,1993-10-2,560
1993,10,3,2310,1470,840,1993-10-3,630
1993,10,4,2002,1176,826,1993-10-4,350
1993,10,5,1862,980,882,1993-10-5,98
1993,10,6,1526,770,756,1993-10-6,14
1993,10,7,1512,770,742,1993-10-7,28
1993,10,8,1554,728,826,1993-10-8,-98
1993,10,9,1232,378,854,1993-10-9,-476
1993,10,10,952,0,952,1993-10-10,-952
1993,10,11,1050,98,952,1993-10-11,-854
1993,10,12,672,70,602,1993-10-12,-532
1993,10,13,322,28,294,1993-10-13,-266
1993,10,14,280,28,252,1993-10-14,-224
1993,10,15,420,70,350,1993-10-15,-280
1993,10,16,364,70,294,1993-10-16,-224
1993,10,17,322,56,266,1993-10-17,-210
1993,10,18,210,28,182,1993-10-18,-154
1993,10,19,280,56,224,1993-10-19,-168
1993,10,20,504,294,210,1993-10-20,84
1993,10,21,518,182,336,1993-10-21,-154
1993,10,22,322,42,280,1993-10-22,-238
1993,10,23,364,84,280,1993-10-23,-196
1993,10,24,322,154,168,1993-10-24,-14
1993,10,25,224,154,70,1993-10-25,84
1993,10,26,98,84,14,1993-10-26,70
1993,10,27,126,84,42,1993-10-27,42
1993,10,28,42,28,14,1993-10-28,14
1993,10,29,448,28,420,1993-10-29,-392
1993,10,30,490,42,448,1993-10-30,-406
1993,10,31,784,28,756,1993-10-31,-728
1993,11,1,770,0,770,1993-11-1,-770
1993,11,2,714,0,714,1993-11-2,-714
1993,11,3,728,0,728,1993-11-3,-728
1993,11,4,868,0,868,1993-11-4,-868
1993,11,5,812,28,784,1993-11-5,-756
1993,11,6,784,0,784,1993-11-6,-784
1993,11,7,756,0,756,1993-11-7,-756
1993,11,8,700,0,700,1993-11-8,-700
1993,11,9,532,0,532,1993-11-9,-532
1993,11,10,490,0,490,1993-11-10,-490
1993,11,11,168,14,154,1993-11-11,-140
1993,11,12,490,490,0,1993-11-12,490
1993,11,13,518,518,0,1993-11-13,518
1993,11,14,602,602,0,1993-11-14,602
1993,11,15,728,728,0,1993-11-15,728
1993,11,16,812,812,0,1993-11-16,812
1993,11,17,910,910,0,1993-11-17,910
1993,11,18,1036,1036,0,1993-11-18,1036
1993,11,19,1050,1050,0,1993-11-19,1050
1993,11,20,812,812,0,1993-11-20,812
1993,11,21,756,756,0,1993-11-21,756
1993,11,22,672,672,0,1993-11-22,672
1993,11,23,756,756,0,1993-11-23,756
1993,11,24,728,728,0,1993-11-24,728
1993,11,25,378,378,0,1993-11-25,378
1993,11,26,490,448,42,1993-11-26,406
1993,11,27,322,280,42,1993-11-27,238
1993,11,28,392,336,56,1993-11-28,280
1993,11,29,434,266,168,1993-11-29,98
1993,11,30,448,126,322,1993-11-30,-196
1993,12,1,686,350,336,1993-12-1,14
1993,12,2,602,350,252,1993-12-2,98
1993,12,3,742,322,420,1993-12-3,-98
1993,12,4,672,238,434,1993-12-4,-196
1993,12,5,728,252,476,1993-12-5,-224
1993,12,6,504,0,504,1993-12-6,-504
1993,12,7,406,0,406,1993-12-7,-406
1993,12,8,364,0,364,1993-12-8,-364
1993,12,9,238,0,238,1993-12-9,-238
1993,12,10,210,28,182,1993-12-10,-154
1993,12,11,210,0,210,1993-12-11,-210
1993,12,12,84,0,84,1993-12-12,-84
1993,12,13,56,0,56,1993-12-13,-56
1993,12,14,126,84,42,1993-12-14,42
1993,12,15,84,84,0,1993-12-15,84
1993,12,16,126,126,0,1993-12-16,126
1993,12,17,140,140,0,1993-12-17,140
1993,12,18,112,112,0,1993-12-18,112
1993,12,19,70,70,0,1993-12-19,70
1993,12,20,280,280,0,1993-12-20,280
1993,12,21,574,574,0,1993-12-21,574
1993,12,22,686,686,0,1993-12-22,686
1993,12,23,798,798,0,1993-12-23,798
1993,12,24,868,868,0,1993-12-24,868
1993,12,25,1022,1022,0,1993-12-25,1022
1993,12,26,1036,1036,0,1993-12-26,1036
1993,12,27,924,924,0,1993-12-27,924
1993,12,28,1316,1260,56,1993-12-28,1204
1993,12,29,2058,1820,238,1993-12-29,1582
1993,12,30,2702,2296,406,1993-12-30,1890
1993,12,31,2688,2184,504,1993-12-31,1680
1994,1,1,2450,1736,714,1994-1-1,1022
1994,1,2,1820,840,980,1994-1-2,-140
1994,1,3,2016,938,1078,1994-1-3,-140
1994,1,4,1624,658,966,1994-1-4,-308
1994,1,5,1792,812,980,1994-1-5,-168
1994,1,6,1708,938,770,1994-1-6,168
1994,1,7,1470,826,644,1994-1-7,182
1994,1,8,980,602,378,1994-1-8,224
1994,1,9,896,630,266,1994-1-9,364
1994,1,10,742,658,84,1994-1-10,574
1994,1,11,504,504,0,1994-1-11,504
1994,1,12,476,462,14,1994-1-12,448
1994,1,13,504,448,56,1994-1-13,392
1994,1,14,406,364,42,1994-1-14,322
1994,1,15,154,140,14,1994-1-15,126
1994,1,16,910,910,0,1994-1-16,910
1994,1,17,994,994,0,1994-1-17,994
1994,1,18,966,966,0,1994-1-18,966
1994,1,19,966,966,0,1994-1-19,966
1994,1,20,938,938,0,1994-1-20,938
1994,1,21,994,994,0,1994-1-21,994
1994,1,22,1120,1106,14,1994-1-22,1092
1994,1,23,1078,1064,14,1994-1-23,1050
1994,1,24,1190,1176,14,1994-1-24,1162
1994,1,25,1400,1400,0,1994-1-25,1400
1994,1,26,1498,1484,14,1994-1-26,1470
1994,1,27,1022,1022,0,1994-1-27,1022
1994,1,28,700,644,56,1994-1-28,588
1994,1,29,196,168,28,1994-1-29,140
1994,1,30,210,140,70,1994-1-30,70
1994,1,31,210,112,98,1994-1-31,14
1994,2,1,224,126,98,1994-2-1,28
1994,2,2,168,140,28,1994-2-2,112
1994,2,3,252,252,0,1994-2-3,252
1994,2,4,322,294,28,1994-2-4,266
1994,2,5,308,252,56,1994-2-5,196
1994,2,6,322,238,84,1994-2-6,154
1994,2,7,364,154,210,1994-2-7,-56
1994,2,8,434,238,196,1994-2-8,42
1994,2,9,742,490,252,1994-2-9,238
1994,2,10,686,560,126,1994-2-10,434
1994,2,11,462,462,0,1994-2-11,462
1994,2,12,350,350,0,1994-2-12,350
1994,2,13,238,238,0,1994-2-13,238
1994,2,14,714,714,0,1994-2-14,714
1994,2,15,686,686,0,1994-2-15,686
1994,2,16,700,700,0,1994-2-16,700
1994,2,17,686,686,0,1994-2-17,686
1994,2,18,630,630,0,1994-2-18,630
1994,2,19,476,476,0,1994-2-19,476
1994,2,20,392,392,0,1994-2-20,392
1994,2,21,406,406,0,1994-2-21,406
1994,2,22,518,462,56,1994-2-22,406
1994,2,23,518,420,98,1994-2-23,322
1994,2,24,434,294,140,1994-2-24,154
1994,2,25,462,280,182,1994-2-25,98
1994,2,26,126,56,70,1994-2-26,-14
1994,2,27,238,28,210,1994-2-27,-182
1994,2,28,406,14,392,1994-2-28,-378
1994,3,1,308,0,308,1994-3-1,-308
1994,3,2,280,0,280,1994-3-2,-280
1994,3,3,252,0,252,1994-3-3,-252
1994,3,4,294,0,294,1994-3-4,-294
1994,3,5,252,0,252,1994-3-5,-252
1994,3,6,392,98,294,1994-3-6,-196
1994,3,7,280,98,182,1994-3-7,-84
1994,3,8,154,56,98,1994-3-8,-42
1994,3,9,224,42,182,1994-3-9,-140
1994,3,10,98,0,98,1994-3-10,-98
1994,3,11,126,42,84,1994-3-11,-42
1994,3,12,266,126,140,1994-3-12,-14
1994,3,13,238,154,84,1994-3-13,70
1994,3,14,196,182,14,1994-3-14,168
1994,3,15,196,196,0,1994-3-15,196
1994,3,16,266,266,0,1994-3-16,266
1994,3,17,182,182,0,1994-3-17,182
1994,3,18,98,98,0,1994-3-18,98
1994,3,19,84,84,0,1994-3-19,84
1994,3,20,56,56,0,1994-3-20,56
1994,3,21,112,112,0,1994-3-21,112
1994,3,22,140,140,0,1994-3-22,140
1994,3,23,126,126,0,1994-3-23,126
1994,3,24,126,98,28,1994-3-24,70
1994,3,25,70,42,28,1994-3-25,14
1994,3,26,70,42,28,1994-3-26,14
1994,3,27,42,0,42,1994-3-27,-42
1994,3,28,70,0,70,1994-3-28,-70
1994,3,29,84,0,84,1994-3-29,-84
1994,3,30,56,0,56,1994-3-30,-56
1994,3,31,168,0,168,1994-3-31,-168
1994,4,1,84,0,84,1994-4-1,-84
1994,4,2,0,0,0,1994-4-2,0
1994,4,3,0,0,0,1994-4-3,0
1994,4,4,0,0,0,1994-4-4,0
1994,4,5,0,0,0,1994-4-5,0
1994,4,6,0,0,0,1994-4-6,0
1994,4,7,0,0,0,1994-4-7,0
1994,4,8,14,14,0,1994-4-8,14
1994,4,9,28,28,0,1994-4-9,28
1994,4,10,42,42,0,1994-4-10,42
1994,4,11,42,42,0,1994-4-11,42
1994,4,12,42,42,0,1994-4-12,42
1994,4,13,42,42,0,1994-4-13,42
1994,4,14,84,84,0,1994-4-14,84
1994,4,15,266,266,0,1994-4-15,266
1994,4,16,196,196,0,1994-4-16,196
1994,4,17,168,168,0,1994-4-17,168
1994,4,18,168,168,0,1994-4-18,168
1994,4,19,182,154,28,1994-4-19,126
1994,4,20,252,238,14,1994-4-20,224
1994,4,21,224,224,0,1994-4-21,224
1994,4,22,280,266,14,1994-4-22,252
1994,4,23,322,322,0,1994-4-23,322
1994,4,24,406,392,14,1994-4-24,378
1994,4,25,210,210,0,1994-4-25,210
1994,4,26,266,238,28,1994-4-26,210
1994,4,27,126,126,0,1994-4-27,126
1994,4,28,84,84,0,1994-4-28,84
1994,4,29,42,0,42,1994-4-29,-42
1994,4,30,56,0,56,1994-4-30,-56
1994,5,1,84,56,28,1994-5-1,28
1994,5,2,112,84,28,1994-5-2,56
1994,5,3,56,56,0,1994-5-3,56
1994,5,4,28,14,14,1994-5-4,0
1994,5,5,14,0,14,1994-5-5,-14
1994,5,6,70,14,56,1994-5-6,-42
1994,5,7,56,0,56,1994-5-7,-56
1994,5,8,56,0,56,1994-5-8,-56
1994,5,9,28,0,28,1994-5-9,-28
1994,5,10,70,0,70,1994-5-10,-70
1994,5,11,420,378,42,1994-5-11,336
1994,5,12,490,490,0,1994-5-12,490
1994,5,13,560,560,0,1994-5-13,560
1994,5,14,476,476,0,1994-5-14,476
1994,5,15,504,504,0,1994-5-15,504
1994,5,16,560,560,0,1994-5-16,560
1994,5,17,560,560,0,1994-5-17,560
1994,5,18,686,686,0,1994-5-18,686
1994,5,19,616,616,0,1994-5-19,616
1994,5,20,546,546,0,1994-5-20,546
1994,5,21,546,546,0,1994-5-21,546
1994,5,22,476,476,0,1994-5-22,476
1994,5,23,420,420,0,1994-5-23,420
1994,5,24,350,350,0,1994-5-24,350
1994,5,25,14,0,14,1994-5-25,-14
1994,5,26,0,0,0,1994-5-26,0
1994,5,27,0,0,0,1994-5-27,0
1994,5,28,0,0,0,1994-5-28,0
1994,5,29,0,0,0,1994-5-29,0
1994,5,30,0,0,0,1994-5-30,0
1994,5,31,0,0,0,1994-5-31,0
1994,6,1,0,0,0,1994-6-1,0
1994,6,2,0,0,0,1994-6-2,0
1994,6,3,0,0,0,1994-6-3,0
1994,6,4,0,0,0,1994-6-4,0
1994,6,5,0,0,0,1994-6-5,0
1994,6,6,98,0,98,1994-6-6,-98
1994,6,7,406,98,308,1994-6-7,-210
1994,6,8,560,168,392,1994-6-8,-224
1994,6,9,420,196,224,1994-6-9,-28
1994,6,10,476,238,238,1994-6-10,0
1994,6,11,350,196,154,1994-6-11,42
1994,6,12,350,168,182,1994-6-12,-14
1994,6,13,392,140,252,1994-6-13,-112
1994,6,14,294,126,168,1994-6-14,-42
1994,6,15,294,224,70,1994-6-15,154
1994,6,16,420,336,84,1994-6-16,252
1994,6,17,476,420,56,1994-6-17,364
1994,6,18,182,140,42,1994-6-18,98
1994,6,19,42,0,42,1994-6-19,-42
1994,6,20,28,0,28,1994-6-20,-28
1994,6,21,14,0,14,1994-6-21,-14
1994,6,22,42,0,42,1994-6-22,-42
1994,6,23,56,0,56,1994-6-23,-56
1994,6,24,84,0,84,1994-6-24,-84
1994,6,25,56,14,42,1994-6-25,-28
1994,6,26,28,14,14,1994-6-26,0
1994,6,27,70,0,70,1994-6-27,-70
1994,6,28,112,0,112,1994-6-28,-112
1994,6,29,294,0,294,1994-6-29,-294
1994,6,30,336,0,336,1994-6-30,-336
1994,7,1,322,0,322,1994-7-1,-322
1994,7,2,448,168,280,1994-7-2,-112
1994,7,3,406,154,252,1994-7-3,-98
1994,7,4,406,252,154,1994-7-4,98
1994,7,5,406,266,140,1994-7-5,126
1994,7,6,448,294,154,1994-7-6,140
1994,7,7,378,224,154,1994-7-7,70
1994,7,8,476,182,294,1994-7-8,-112
1994,7,9,350,210,140,1994-7-9,70
1994,7,10,406,182,224,1994-7-10,-42
1994,7,11,518,196,322,1994-7-11,-126
1994,7,12,882,630,252,1994-7-12,378
1994,7,13,294,126,168,1994-7-13,-42
1994,7,14,168,84,84,1994-7-14,0
1994,7,15,168,28,140,1994-7-15,-112
1994,7,16,280,168,112,1994-7-16,56
1994,7,17,308,238,70,1994-7-17,168
1994,7,18,280,238,42,1994-7-18,196
1994,7,19,280,238,42,1994-7-19,196
1994,7,20,280,238,42,1994-7-20,196
1994,7,21,238,238,0,1994-7-21,238
1994,7,22,210,210,0,1994-7-22,210
1994,7,23,210,210,0,1994-7-23,210
1994,7,24,224,224,0,1994-7-24,224
1994,7,25,196,196,0,1994-7-25,196
1994,7,26,182,182,0,1994-7-26,182
1994,7,27,210,210,0,1994-7-27,210
1994,7,28,140,140,0,1994-7-28,140
1994,7,29,0,0,0,1994-7-29,0
1994,7,30,14,0,14,1994-7-30,-14
1994,7,31,28,0,28,1994-7-31,-28
1994,8,1,0,0,0,1994-8-1,0
1994,8,2,56,56,0,1994-8-2,56
1994,8,3,224,224,0,1994-8-3,224
1994,8,4,140,140,0,1994-8-4,140
1994,8,5,126,126,0,1994-8-5,126
1994,8,6,140,140,0,1994-8-6,140
1994,8,7,140,140,0,1994-8-7,140
1994,8,8,140,140,0,1994-8-8,140
1994,8,9,126,126,0,1994-8-9,126
1994,8,10,154,154,0,1994-8-10,154
1994,8,11,224,140,84,1994-8-11,56
1994,8,12,308,140,168,1994-8-12,-28
1994,8,13,476,126,350,1994-8-13,-224
1994,8,14,686,140,546,1994-8-14,-406
1994,8,15,420,28,392,1994-8-15,-364
1994,8,16,378,28,350,1994-8-16,-322
1994,8,17,364,14,350,1994-8-17,-336
1994,8,18,294,0,294,1994-8-18,-294
1994,8,19,224,0,224,1994-8-19,-224
1994,8,20,210,0,210,1994-8-20,-210
1994,8,21,70,0,70,1994-8-21,-70
1994,8,22,28,0,28,1994-8-22,-28
1994,8,23,98,0,98,1994-8-23,-98
1994,8,24,98,0,98,1994-8-24,-98
1994,8,25,56,0,56,1994-8-25,-56
1994,8,26,28,0,28,1994-8-26,-28
1994,8,27,14,0,14,1994-8-27,-14
1994,8,28,70,70,0,1994-8-28,70
1994,8,29,98,84,14,1994-8-29,70
1994,8,30,504,112,392,1994-8-30,-280
1994,8,31,826,126,700,1994-8-31,-574
1994,9,1,756,98,658,1994-9-1,-560
1994,9,2,952,112,840,1994-9-2,-728
1994,9,3,1176,140,1036,1994-9-3,-896
1994,9,4,1176,140,1036,1994-9-4,-896
1994,9,5,1064,126,938,1994-9-5,-812
1994,9,6,1064,140,924,1994-9-6,-784
1994,9,7,994,210,784,1994-9-7,-574
1994,9,8,868,182,686,1994-9-8,-504
1994,9,9,728,154,574,1994-9-9,-420
1994,9,10,406,0,406,1994-9-10,-406
1994,9,11,406,0,406,1994-9-11,-406
1994,9,12,252,0,252,1994-9-12,-252
1994,9,13,224,0,224,1994-9-13,-224
1994,9,14,168,0,168,1994-9-14,-168
1994,9,15,168,0,168,1994-9-15,-168
1994,9,16,0,0,0,1994-9-16,0
1994,9,17,42,42,0,1994-9-17,42
1994,9,18,112,28,84,1994-9-18,-56
1994,9,19,56,14,42,1994-9-19,-28
1994,9,20,0,0,0,1994-9-20,0
1994,9,21,0,0,0,1994-9-21,0
1994,9,22,28,0,28,1994-9-22,-28
1994,9,23,42,0,42,1994-9-23,-42
1994,9,24,56,0,56,1994-9-24,-56
1994,9,25,84,14,70,1994-9-25,-56
1994,9,26,210,28,182,1994-9-26,-154
1994,9,27,154,28,126,1994-9-27,-98
1994,9,28,168,0,168,1994-9-28,-168
1994,9,29,154,0,154,1994-9-29,-154
1994,9,30,196,0,196,1994-9-30,-196
1994,10,1,280,0,280,1994-10-1,-280
1994,10,2,210,0,210,1994-10-2,-210
1994,10,3,210,0,210,1994-10-3,-210
1994,10,4,252,0,252,1994-10-4,-252
1994,10,5,266,14,252,1994-10-5,-238
1994,10,6,350,70,280,1994-10-6,-210
1994,10,7,350,98,252,1994-10-7,-154
1994,10,8,364,154,210,1994-10-8,-56
1994,10,9,532,336,196,1994-10-9,140
1994,10,10,714,420,294,1994-10-10,126
1994,10,11,560,434,126,1994-10-11,308
1994,10,12,714,686,28,1994-10-12,658
1994,10,13,952,952,0,1994-10-13,952
1994,10,14,882,854,28,1994-10-14,826
1994,10,15,784,756,28,1994-10-15,728
1994,10,16,770,770,0,1994-10-16,770
1994,10,17,490,490,0,1994-10-17,490
1994,10,18,532,406,126,1994-10-18,280
1994,10,19,924,420,504,1994-10-19,-84
1994,10,20,798,364,434,1994-10-20,-70
1994,10,21,602,280,322,1994-10-21,-42
1994,10,22,476,322,154,1994-10-22,168
1994,10,23,266,168,98,1994-10-23,70
1994,10,24,154,84,70,1994-10-24,14
1994,10,25,224,182,42,1994-10-25,140
1994,10,26,462,322,140,1994-10-26,182
1994,10,27,546,420,126,1994-10-27,294
1994,10,28,574,462,112,1994-10-28,350
1994,10,29,700,448,252,1994-10-29,196
1994,10,30,714,392,322,1994-10-30,70
1994,10,31,588,308,280,1994-10-31,28
1994,11,1,504,266,238,1994-11-1,28
1994,11,2,476,210,266,1994-11-2,-56
1994,11,3,294,112,182,1994-11-3,-70
1994,11,4,238,56,182,1994-11-4,-126
1994,11,5,238,98,140,1994-11-5,-42
1994,11,6,210,84,126,1994-11-6,-42
1994,11,7,154,42,112,1994-11-7,-70
1994,11,8,154,70,84,1994-11-8,-14
1994,11,9,84,42,42,1994-11-9,0
1994,11,10,28,28,0,1994-11-10,28
1994,11,11,28,28,0,1994-11-11,28
1994,11,12,0,0,0,1994-11-12,0
1994,11,13,0,0,0,1994-11-13,0
1994,11,14,0,0,0,1994-11-14,0
1994,11,15,0,0,0,1994-11-15,0
1994,11,16,0,0,0,1994-11-16,0
1994,11,17,84,0,84,1994-11-17,-84
1994,11,18,98,0,98,1994-11-18,-98
1994,11,19,14,0,14,1994-11-19,-14
1994,11,20,28,28,0,1994-11-20,28
1994,11,21,42,42,0,1994-11-21,42
1994,11,22,70,70,0,1994-11-22,70
1994,11,23,28,28,0,1994-11-23,28
1994,11,24,28,28,0,1994-11-24,28
1994,11,25,70,0,70,1994-11-25,-70
1994,11,26,126,0,126,1994-11-26,-126
1994,11,27,140,0,140,1994-11-27,-140
1994,11,28,112,0,112,1994-11-28,-112
1994,11,29,56,0,56,1994-11-29,-56
1994,11,30,98,0,98,1994-11-30,-98
1994,12,1,140,0,140,1994-12-1,-140
1994,12,2,0,0,0,1994-12-2,0
1994,12,3,42,0,42,1994-12-3,-42
1994,12,4,112,0,112,1994-12-4,-112
1994,12,5,182,0,182,1994-12-5,-182
1994,12,6,70,0,70,1994-12-6,-70
1994,12,7,126,0,126,1994-12-7,-126
1994,12,8,98,0,98,1994-12-8,-98
1994,12,9,252,0,252,1994-12-9,-252
1994,12,10,476,0,476,1994-12-10,-476
1994,12,11,630,0,630,1994-12-11,-630
1994,12,12,952,0,952,1994-12-12,-952
1994,12,13,1022,0,1022,1994-12-13,-1022
1994,12,14,896,0,896,1994-12-14,-896
1994,12,15,798,0,798,1994-12-15,-798
1994,12,16,756,0,756,1994-12-16,-756
1994,12,17,840,196,644,1994-12-17,-448
1994,12,18,742,252,490,1994-12-18,-238
1994,12,19,448,0,448,1994-12-19,-448
1994,12,20,280,0,280,1994-12-20,-280
1994,12,21,210,0,210,1994-12-21,-210
1994,12,22,224,224,0,1994-12-22,224
1994,12,23,252,14,238,1994-12-23,-224
1994,12,24,210,0,210,1994-12-24,-210
1994,12,25,196,0,196,1994-12-25,-196
1994,12,26,210,154,56,1994-12-26,98
1994,12,27,112,84,28,1994-12-27,56
1994,12,28,98,70,28,1994-12-28,42
1994,12,29,70,28,42,1994-12-29,-14
1994,12,30,14,0,14,1994-12-30,-14
1994,12,31,0,0,0,1994-12-31,0
1995,1,1,0,0,0,1995-1-1,0
1995,1,2,14,0,14,1995-1-2,-14
1995,1,3,42,0,42,1995-1-3,-42
1995,1,4,42,42,0,1995-1-4,42
1995,1,5,42,42,0,1995-1-5,42
1995,1,6,28,28,0,1995-1-6,28
1995,1,7,0,0,0,1995-1-7,0
1995,1,8,0,0,0,1995-1-8,0
1995,1,9,0,0,0,1995-1-9,0
1995,1,10,14,0,14,1995-1-10,-14
1995,1,11,0,0,0,1995-1-11,0
1995,1,12,14,0,14,1995-1-12,-14
1995,1,13,0,0,0,1995-1-13,0
1995,1,14,98,0,98,1995-1-14,-98
1995,1,15,126,0,126,1995-1-15,-126
1995,1,16,154,0,154,1995-1-16,-154
1995,1,17,294,0,294,1995-1-17,-294
1995,1,18,476,0,476,1995-1-18,-476
1995,1,19,532,42,490,1995-1-19,-448
1995,1,20,574,98,476,1995-1-20,-378
1995,1,21,420,154,266,1995-1-21,-112
1995,1,22,350,182,168,1995-1-22,14
1995,1,23,378,224,154,1995-1-23,70
1995,1,24,378,266,112,1995-1-24,154
1995,1,25,252,196,56,1995-1-25,140
1995,1,26,252,196,56,1995-1-26,140
1995,1,27,168,140,28,1995-1-27,112
1995,1,28,196,126,70,1995-1-28,56
1995,1,29,266,196,70,1995-1-29,126
1995,1,30,266,0,266,1995-1-30,-266
1995,1,31,378,0,378,1995-1-31,-378
1995,2,1,378,0,378,1995-2-1,-378
1995,2,2,322,0,322,1995-2-2,-322
1995,2,3,238,0,238,1995-2-3,-238
1995,2,4,196,0,196,1995-2-4,-196
1995,2,5,210,42,168,1995-2-5,-126
1995,2,6,182,14,168,1995-2-6,-154
1995,2,7,140,0,140,1995-2-7,-140
1995,2,8,98,0,98,1995-2-8,-98
1995,2,9,140,126,14,1995-2-9,112
1995,2,10,168,140,28,1995-2-10,112
1995,2,11,154,140,14,1995-2-11,126
1995,2,12,168,154,14,1995-2-12,140
1995,2,13,168,154,14,1995-2-13,140
1995,2,14,210,168,42,1995-2-14,126
1995,2,15,210,126,84,1995-2-15,42
1995,2,16,196,112,84,1995-2-16,28
1995,2,17,252,98,154,1995-2-17,-56
1995,2,18,280,84,196,1995-2-18,-112
1995,2,19,350,126,224,1995-2-19,-98
1995,2,20,448,126,322,1995-2-20,-196
1995,2,21,336,112,224,1995-2-21,-112
1995,2,22,238,42,196,1995-2-22,-154
1995,2,23,322,56,266,1995-2-23,-210
1995,2,24,126,42,84,1995-2-24,-42
1995,2,25,154,70,84,1995-2-25,-14
1995,2,26,196,28,168,1995-2-26,-140
1995,2,27,308,0,308,1995-2-27,-308
1995,2,28,406,0,406,1995-2-28,-406
1995,3,1,616,0,616,1995-3-1,-616
1995,3,2,574,0,574,1995-3-2,-574
1995,3,3,700,0,700,1995-3-3,-700
1995,3,4,574,0,574,1995-3-4,-574
1995,3,5,518,0,518,1995-3-5,-518
1995,3,6,336,0,336,1995-3-6,-336
1995,3,7,350,0,350,1995-3-7,-350
1995,3,8,224,0,224,1995-3-8,-224
1995,3,9,70,0,70,1995-3-9,-70
1995,3,10,0,0,0,1995-3-10,0
1995,3,11,0,0,0,1995-3-11,0
1995,3,12,14,0,14,1995-3-12,-14
1995,3,13,28,14,14,1995-3-13,0
1995,3,14,182,0,182,1995-3-14,-182
1995,3,15,308,0,308,1995-3-15,-308
1995,3,16,308,0,308,1995-3-16,-308
1995,3,17,308,0,308,1995-3-17,-308
1995,3,18,364,84,280,1995-3-18,-196
1995,3,19,392,112,280,1995-3-19,-168
1995,3,20,364,98,266,1995-3-20,-168
1995,3,21,378,168,210,1995-3-21,-42
1995,3,22,378,182,196,1995-3-22,-14
1995,3,23,378,126,252,1995-3-23,-126
1995,3,24,406,126,280,1995-3-24,-154
1995,3,25,322,84,238,1995-3-25,-154
1995,3,26,434,70,364,1995-3-26,-294
1995,3,27,308,0,308,1995-3-27,-308
1995,3,28,280,0,280,1995-3-28,-280
1995,3,29,252,0,252,1995-3-29,-252
1995,3,30,210,0,210,1995-3-30,-210
1995,3,31,196,0,196,1995-3-31,-196
1995,4,1,140,0,140,1995-4-1,-140
1995,4,2,98,0,98,1995-4-2,-98
1995,4,3,56,0,56,1995-4-3,-56
1995,4,4,14,14,0,1995-4-4,14
1995,4,5,0,0,0,1995-4-5,0
1995,4,6,0,0,0,1995-4-6,0
1995,4,7,0,0,0,1995-4-7,0
1995,4,8,0,0,0,1995-4-8,0
1995,4,9,0,0,0,1995-4-9,0
1995,4,10,14,0,14,1995-4-10,-14
1995,4,11,154,0,154,1995-4-11,-154
1995,4,12,154,0,154,1995-4-12,-154
1995,4,13,294,14,280,1995-4-13,-266
1995,4,14,420,56,364,1995-4-14,-308
1995,4,15,518,126,392,1995-4-15,-266
1995,4,16,392,112,280,1995-4-16,-168
1995,4,17,462,112,350,1995-4-17,-238
1995,4,18,336,98,238,1995-4-18,-140
1995,4,19,420,112,308,1995-4-19,-196
1995,4,20,280,0,280,1995-4-20,-280
1995,4,21,392,0,392,1995-4-21,-392
1995,4,22,140,0,140,1995-4-22,-140
1995,4,23,0,0,0,1995-4-23,0
1995,4,24,0,0,0,1995-4-24,0
1995,4,25,0,0,0,1995-4-25,0
1995,4,26,0,0,0,1995-4-26,0
1995,4,27,0,0,0,1995-4-27,0
1995,4,28,0,0,0,1995-4-28,0
1995,4,29,0,0,0,1995-4-29,0
1995,4,30,0,0,0,1995-4-30,0
1995,5,1,14,14,0,1995-5-1,14
1995,5,2,0,0,0,1995-5-2,0
1995,5,3,0,0,0,1995-5-3,0
1995,5,4,14,0,14,1995-5-4,-14
1995,5,5,14,0,14,1995-5-5,-14
1995,5,6,140,0,140,1995-5-6,-140
1995,5,7,168,0,168,1995-5-7,-168
1995,5,8,210,0,210,1995-5-8,-210
1995,5,9,196,0,196,1995-5-9,-196
1995,5,10,154,0,154,1995-5-10,-154
1995,5,11,112,0,112,1995-5-11,-112
1995,5,12,126,28,98,1995-5-12,-70
1995,5,13,238,182,56,1995-5-13,126
1995,5,14,224,182,42,1995-5-14,140
1995,5,15,252,210,42,1995-5-15,168
1995,5,16,490,308,182,1995-5-16,126
1995,5,17,784,378,406,1995-5-17,-28
1995,5,18,966,420,546,1995-5-18,-126
1995,5,19,756,266,490,1995-5-19,-224
1995,5,20,448,56,392,1995-5-20,-336
1995,5,21,350,0,350,1995-5-21,-350
1995,5,22,154,0,154,1995-5-22,-154
1995,5,23,0,0,0,1995-5-23,0
1995,5,24,0,0,0,1995-5-24,0
1995,5,25,0,0,0,1995-5-25,0
1995,5,26,0,0,0,1995-5-26,0
1995,5,27,0,0,0,1995-5-27,0
1995,5,28,14,14,0,1995-5-28,14
1995,5,29,42,42,0,1995-5-29,42
1995,5,30,14,14,0,1995-5-30,14
1995,5,31,0,0,0,1995-5-31,0
1995,6,1,0,0,0,1995-6-1,0
1995,6,2,14,14,0,1995-6-2,14
1995,6,3,14,14,0,1995-6-3,14
1995,6,4,56,56,0,1995-6-4,56
1995,6,5,252,252,0,1995-6-5,252
1995,6,6,238,238,0,1995-6-6,238
1995,6,7,350,126,224,1995-6-7,-98
1995,6,8,420,280,140,1995-6-8,140
1995,6,9,294,294,0,1995-6-9,294
1995,6,10,336,322,14,1995-6-10,308
1995,6,11,308,308,0,1995-6-11,308
1995,6,12,238,238,0,1995-6-12,238
1995,6,13,168,168,0,1995-6-13,168
1995,6,14,98,98,0,1995-6-14,98
1995,6,15,0,0,0,1995-6-15,0
1995,6,16,0,0,0,1995-6-16,0
1995,6,17,0,0,0,1995-6-17,0
1995,6,18,126,126,0,1995-6-18,126
1995,6,19,168,168,0,1995-6-19,168
1995,6,20,154,154,0,1995-6-20,154
1995,6,21,182,182,0,1995-6-21,182
1995,6,22,84,84,0,1995-6-22,84
1995,6,23,84,84,0,1995-6-23,84
1995,6,24,112,112,0,1995-6-24,112
1995,6,25,84,84,0,1995-6-25,84
1995,6,26,56,56,0,1995-6-26,56
1995,6,27,14,14,0,1995-6-27,14
1995,6,28,14,14,0,1995-6-28,14
1995,6,29,14,14,0,1995-6-29,14
1995,6,30,224,224,0,1995-6-30,224
1995,7,1,336,336,0,1995-7-1,336
1995,7,2,308,308,0,1995-7-2,308
1995,7,3,294,294,0,1995-7-3,294
1995,7,4,252,252,0,1995-7-4,252
1995,7,5,266,266,0,1995-7-5,266
1995,7,6,364,238,126,1995-7-6,112
1995,7,7,406,238,168,1995-7-7,70
1995,7,8,336,266,70,1995-7-8,196
1995,7,9,350,252,98,1995-7-9,154
1995,7,10,210,182,28,1995-7-10,154
1995,7,11,252,210,42,1995-7-11,168
1995,7,12,182,168,14,1995-7-12,154
1995,7,13,98,98,0,1995-7-13,98
1995,7,14,98,98,0,1995-7-14,98
1995,7,15,238,238,0,1995-7-15,238
1995,7,16,210,210,0,1995-7-16,210
1995,7,17,126,126,0,1995-7-17,126
1995,7,18,98,98,0,1995-7-18,98
1995,7,19,98,98,0,1995-7-19,98
1995,7,20,42,28,14,1995-7-20,14
1995,7,21,14,14,0,1995-7-21,14
1995,7,22,14,14,0,1995-7-22,14
1995,7,23,0,0,0,1995-7-23,0
1995,7,24,0,0,0,1995-7-24,0
1995,7,25,0,0,0,1995-7-25,0
1995,7,26,14,0,14,1995-7-26,-14
1995,7,27,0,0,0,1995-7-27,0
1995,7,28,0,0,0,1995-7-28,0
1995,7,29,0,0,0,1995-7-29,0
1995,7,30,0,0,0,1995-7-30,0
1995,7,31,14,14,0,1995-7-31,14
1995,8,1,56,56,0,1995-8-1,56
1995,8,2,42,42,0,1995-8-2,42
1995,8,3,56,56,0,1995-8-3,56
1995,8,4,42,42,0,1995-8-4,42
1995,8,5,14,14,0,1995-8-5,14
1995,8,6,126,112,14,1995-8-6,98
1995,8,7,56,56,0,1995-8-7,56
1995,8,8,14,14,0,1995-8-8,14
1995,8,9,0,0,0,1995-8-9,0
1995,8,10,42,42,0,1995-8-10,42
1995,8,11,28,28,0,1995-8-11,28
1995,8,12,14,0,14,1995-8-12,-14
1995,8,13,0,0,0,1995-8-13,0
1995,8,14,0,0,0,1995-8-14,0
1995,8,15,42,28,14,1995-8-15,14
1995,8,16,56,42,14,1995-8-16,28
1995,8,17,28,28,0,1995-8-17,28
1995,8,18,0,0,0,1995-8-18,0
1995,8,19,0,0,0,1995-8-19,0
1995,8,20,0,0,0,1995-8-20,0
1995,8,21,0,0,0,1995-8-21,0
1995,8,22,0,0,0,1995-8-22,0
1995,8,23,42,42,0,1995-8-23,42
1995,8,24,126,98,28,1995-8-24,70
1995,8,25,364,308,56,1995-8-25,252
1995,8,26,350,308,42,1995-8-26,266
1995,8,27,350,322,28,1995-8-27,294
1995,8,28,224,224,0,1995-8-28,224
1995,8,29,182,182,0,1995-8-29,182
1995,8,30,140,140,0,1995-8-30,140
1995,8,31,154,154,0,1995-8-31,154
1995,9,1,140,140,0,1995-9-1,140
1995,9,2,112,112,0,1995-9-2,112
1995,9,3,98,98,0,1995-9-3,98
1995,9,4,140,140,0,1995-9-4,140
1995,9,5,112,112,0,1995-9-5,112
1995,9,6,98,98,0,1995-9-6,98
1995,9,7,0,0,0,1995-9-7,0
1995,9,8,0,0,0,1995-9-8,0
1995,9,9,0,0,0,1995-9-9,0
1995,9,10,0,0,0,1995-9-10,0
1995,9,11,0,0,0,1995-9-11,0
1995,9,12,0,0,0,1995-9-12,0
1995,9,13,0,0,0,1995-9-13,0
1995,9,14,0,0,0,1995-9-14,0
1995,9,15,28,0,28,1995-9-15,-28
1995,9,16,0,0,0,1995-9-16,0
1995,9,17,0,0,0,1995-9-17,0
1995,9,18,0,0,0,1995-9-18,0
1995,9,19,140,140,0,1995-9-19,140
1995,9,20,168,168,0,1995-9-20,168
1995,9,21,126,126,0,1995-9-21,126
1995,9,22,154,154,0,1995-9-22,154
1995,9,23,112,112,0,1995-9-23,112
1995,9,24,84,84,0,1995-9-24,84
1995,9,25,42,42,0,1995-9-25,42
1995,9,26,42,42,0,1995-9-26,42
1995,9,27,42,28,14,1995-9-27,14
1995,9,28,0,0,0,1995-9-28,0
1995,9,29,0,0,0,1995-9-29,0
1995,9,30,0,0,0,1995-9-30,0
1995,10,1,0,0,0,1995-10-1,0
1995,10,2,0,0,0,1995-10-2,0
1995,10,3,0,0,0,1995-10-3,0
1995,10,4,0,0,0,1995-10-4,0
1995,10,5,0,0,0,1995-10-5,0
1995,10,6,0,0,0,1995-10-6,0
1995,10,7,168,0,168,1995-10-7,-168
1995,10,8,266,14,252,1995-10-8,-238
1995,10,9,266,28,238,1995-10-9,-210
1995,10,10,336,56,280,1995-10-10,-224
1995,10,11,644,98,546,1995-10-11,-448
1995,10,12,966,70,896,1995-10-12,-826
1995,10,13,784,56,728,1995-10-13,-672
1995,10,14,630,28,602,1995-10-14,-574
1995,10,15,504,0,504,1995-10-15,-504
1995,10,16,518,28,490,1995-10-16,-462
1995,10,17,546,42,504,1995-10-17,-462
1995,10,18,490,0,490,1995-10-18,-490
1995,10,19,336,0,336,1995-10-19,-336
1995,10,20,364,154,210,1995-10-20,-56
1995,10,21,420,182,238,1995-10-21,-56
1995,10,22,448,252,196,1995-10-22,56
1995,10,23,224,168,56,1995-10-23,112
1995,10,24,154,126,28,1995-10-24,98
1995,10,25,140,112,28,1995-10-25,84
1995,10,26,70,70,0,1995-10-26,70
1995,10,27,42,42,0,1995-10-27,42
1995,10,28,28,28,0,1995-10-28,28
1995,10,29,14,14,0,1995-10-29,14
1995,10,30,0,0,0,1995-10-30,0
1995,10,31,0,0,0,1995-10-31,0
1995,11,1,0,0,0,1995-11-1,0
1995,11,2,0,0,0,1995-11-2,0
1995,11,3,0,0,0,1995-11-3,0
1995,11,4,0,0,0,1995-11-4,0
1995,11,5,0,0,0,1995-11-5,0
1995,11,6,98,0,98,1995-11-6,-98
1995,11,7,168,0,168,1995-11-7,-168
1995,11,8,196,0,196,1995-11-8,-196
1995,11,9,168,0,168,1995-11-9,-168
1995,11,10,182,0,182,1995-11-10,-182
1995,11,11,168,0,168,1995-11-11,-168
1995,11,12,168,0,168,1995-11-12,-168
1995,11,13,154,0,154,1995-11-13,-154
1995,11,14,196,0,196,1995-11-14,-196
1995,11,15,210,0,210,1995-11-15,-210
1995,11,16,280,42,238,1995-11-16,-196
1995,11,17,252,70,182,1995-11-17,-112
1995,11,18,238,84,154,1995-11-18,-70
1995,11,19,56,56,0,1995-11-19,56
1995,11,20,42,42,0,1995-11-20,42
1995,11,21,14,14,0,1995-11-21,14
1995,11,22,14,14,0,1995-11-22,14
1995,11,23,0,0,0,1995-11-23,0
1995,11,24,0,0,0,1995-11-24,0
1995,11,25,0,0,0,1995-11-25,0
1995,11,26,0,0,0,1995-11-26,0
1995,11,27,0,0,0,1995-11-27,0
1995,11,28,14,14,0,1995-11-28,14
1995,11,29,28,28,0,1995-11-29,28
1995,11,30,56,56,0,1995-11-30,56
1995,12,1,84,84,0,1995-12-1,84
1995,12,2,56,56,0,1995-12-2,56
1995,12,3,126,28,98,1995-12-3,-70
1995,12,4,84,0,84,1995-12-4,-84
1995,12,5,112,14,98,1995-12-5,-84
1995,12,6,112,0,112,1995-12-6,-112
1995,12,7,140,0,140,1995-12-7,-140
1995,12,8,98,0,98,1995-12-8,-98
1995,12,9,140,0,140,1995-12-9,-140
1995,12,10,140,0,140,1995-12-10,-140
1995,12,11,140,0,140,1995-12-11,-140
1995,12,12,168,0,168,1995-12-12,-168
1995,12,13,140,0,140,1995-12-13,-140
1995,12,14,98,0,98,1995-12-14,-98
1995,12,15,70,0,70,1995-12-15,-70
1995,12,16,0,0,0,1995-12-16,0
1995,12,17,0,0,0,1995-12-17,0
1995,12,18,0,0,0,1995-12-18,0
1995,12,19,0,0,0,1995-12-19,0
1995,12,20,0,0,0,1995-12-20,0
1995,12,21,0,0,0,1995-12-21,0
1995,12,22,0,0,0,1995-12-22,0
1995,12,23,0,0,0,1995-12-23,0
1995,12,24,0,0,0,1995-12-24,0
1995,12,25,14,0,14,1995-12-25,-14
1995,12,26,70,56,14,1995-12-26,42
1995,12,27,140,112,28,1995-12-27,84
1995,12,28,56,42,14,1995-12-28,28
1995,12,29,14,14,0,1995-12-29,14
1995,12,30,0,0,0,1995-12-30,0
1995,12,31,0,0,0,1995-12-31,0
1996,1,1,14,14,0,1996-1-1,14
1996,1,2,0,0,0,1996-1-2,0
1996,1,3,154,154,0,1996-1-3,154
1996,1,4,308,308,0,1996-1-4,308
1996,1,5,574,574,0,1996-1-5,574
1996,1,6,546,546,0,1996-1-6,546
1996,1,7,308,308,0,1996-1-7,308
1996,1,8,252,252,0,1996-1-8,252
1996,1,9,70,70,0,1996-1-9,70
1996,1,10,0,0,0,1996-1-10,0
1996,1,11,0,0,0,1996-1-11,0
1996,1,12,0,0,0,1996-1-12,0
1996,1,13,0,0,0,1996-1-13,0
1996,1,14,0,0,0,1996-1-14,0
1996,1,15,0,0,0,1996-1-15,0
1996,1,16,0,0,0,1996-1-16,0
1996,1,17,0,0,0,1996-1-17,0
1996,1,18,0,0,0,1996-1-18,0
1996,1,19,0,0,0,1996-1-19,0
1996,1,20,0,0,0,1996-1-20,0
1996,1,21,14,14,0,1996-1-21,14
1996,1,22,0,0,0,1996-1-22,0
1996,1,23,0,0,0,1996-1-23,0
1996,1,24,0,0,0,1996-1-24,0
1996,1,25,0,0,0,1996-1-25,0
1996,1,26,0,0,0,1996-1-26,0
1996,1,27,0,0,0,1996-1-27,0
1996,1,28,0,0,0,1996-1-28,0
1996,1,29,0,0,0,1996-1-29,0
1996,1,30,14,14,0,1996-1-30,14
1996,1,31,42,42,0,1996-1-31,42
1996,2,1,112,112,0,1996-2-1,112
1996,2,2,42,42,0,1996-2-2,42
1996,2,3,0,0,0,1996-2-3,0
1996,2,4,0,0,0,1996-2-4,0
1996,2,5,0,0,0,1996-2-5,0
1996,2,6,0,0,0,1996-2-6,0
1996,2,7,0,0,0,1996-2-7,0
1996,2,8,0,0,0,1996-2-8,0
1996,2,9,0,0,0,1996-2-9,0
1996,2,10,0,0,0,1996-2-10,0
1996,2,11,0,0,0,1996-2-11,0
1996,2,12,0,0,0,1996-2-12,0
1996,2,13,0,0,0,1996-2-13,0
1996,2,14,0,0,0,1996-2-14,0
1996,2,15,0,0,0,1996-2-15,0
1996,2,16,0,0,0,1996-2-16,0
1996,2,17,0,0,0,1996-2-17,0
1996,2,18,0,0,0,1996-2-18,0
1996,2,19,0,0,0,1996-2-19,0
1996,2,20,28,28,0,1996-2-20,28
1996,2,21,28,28,0,1996-2-21,28
1996,2,22,28,14,14,1996-2-22,0
1996,2,23,14,14,0,1996-2-23,14
1996,2,24,56,56,0,1996-2-24,56
1996,2,25,84,84,0,1996-2-25,84
1996,2,26,56,56,0,1996-2-26,56
1996,2,27,14,14,0,1996-2-27,14
1996,2,28,0,0,0,1996-2-28,0
1996,2,29,28,0,28,1996-2-29,-28
1996,3,1,0,0,0,1996-3-1,0
1996,3,2,0,0,0,1996-3-2,0
1996,3,3,0,0,0,1996-3-3,0
1996,3,4,0,0,0,1996-3-4,0
1996,3,5,0,0,0,1996-3-5,0
1996,3,6,28,14,14,1996-3-6,0
1996,3,7,0,0,0,1996-3-7,0
1996,3,8,0,0,0,1996-3-8,0
1996,3,9,0,0,0,1996-3-9,0
1996,3,10,0,0,0,1996-3-10,0
1996,3,11,42,0,42,1996-3-11,-42
1996,3,12,112,0,112,1996-3-12,-112
1996,3,13,112,0,112,1996-3-13,-112
1996,3,14,84,0,84,1996-3-14,-84
1996,3,15,84,0,84,1996-3-15,-84
1996,3,16,56,0,56,1996-3-16,-56
1996,3,17,28,0,28,1996-3-17,-28
1996,3,18,0,0,0,1996-3-18,0
1996,3,19,14,0,14,1996-3-19,-14
1996,3,20,0,0,0,1996-3-20,0
1996,3,21,14,14,0,1996-3-21,14
1996,3,22,84,84,0,1996-3-22,84
1996,3,23,154,154,0,1996-3-23,154
1996,3,24,140,140,0,1996-3-24,140
1996,3,25,126,126,0,1996-3-25,126
1996,3,26,168,168,0,1996-3-26,168
1996,3,27,140,140,0,1996-3-27,140
1996,3,28,98,98,0,1996-3-28,98
1996,3,29,42,42,0,1996-3-29,42
1996,3,30,0,0,0,1996-3-30,0
1996,3,31,0,0,0,1996-3-31,0
1996,4,1,14,14,0,1996-4-1,14
1996,4,2,14,14,0,1996-4-2,14
1996,4,3,28,28,0,1996-4-3,28
1996,4,4,14,14,0,1996-4-4,14
1996,4,5,0,0,0,1996-4-5,0
1996,4,6,0,0,0,1996-4-6,0
1996,4,7,0,0,0,1996-4-7,0
1996,4,8,0,0,0,1996-4-8,0
1996,4,9,0,0,0,1996-4-9,0
1996,4,10,0,0,0,1996-4-10,0
1996,4,11,0,0,0,1996-4-11,0
1996,4,12,14,14,0,1996-4-12,14
1996,4,13,14,14,0,1996-4-13,14
1996,4,14,0,0,0,1996-4-14,0
1996,4,15,0,0,0,1996-4-15,0
1996,4,16,0,0,0,1996-4-16,0
1996,4,17,14,14,0,1996-4-17,14
1996,4,18,28,14,14,1996-4-18,0
1996,4,19,28,0,28,1996-4-19,-28
1996,4,20,56,0,56,1996-4-20,-56
1996,4,21,196,0,196,1996-4-21,-196
1996,4,22,196,0,196,1996-4-22,-196
1996,4,23,42,0,42,1996-4-23,-42
1996,4,24,0,0,0,1996-4-24,0
1996,4,25,0,0,0,1996-4-25,0
1996,4,26,0,0,0,1996-4-26,0
1996,4,27,0,0,0,1996-4-27,0
1996,4,28,14,14,0,1996-4-28,14
1996,4,29,0,0,0,1996-4-29,0
1996,4,30,0,0,0,1996-4-30,0
1996,5,1,0,0,0,1996-5-1,0
1996,5,2,0,0,0,1996-5-2,0
1996,5,3,0,0,0,1996-5-3,0
1996,5,4,0,0,0,1996-5-4,0
1996,5,5,0,0,0,1996-5-5,0
1996,5,6,70,14,56,1996-5-6,-42
1996,5,7,154,0,154,1996-5-7,-154
1996,5,8,168,0,168,1996-5-8,-168
1996,5,9,182,0,182,1996-5-9,-182
1996,5,10,182,14,168,1996-5-10,-154
1996,5,11,196,0,196,1996-5-11,-196
1996,5,12,154,0,154,1996-5-12,-154
1996,5,13,140,0,140,1996-5-13,-140
1996,5,14,126,0,126,1996-5-14,-126
1996,5,15,42,0,42,1996-5-15,-42
1996,5,16,42,0,42,1996-5-16,-42
1996,5,17,28,0,28,1996-5-17,-28
1996,5,18,0,0,0,1996-5-18,0
1996,5,19,0,0,0,1996-5-19,0
1996,5,20,0,0,0,1996-5-20,0
1996,5,21,0,0,0,1996-5-21,0
1996,5,22,0,0,0,1996-5-22,0
1996,5,23,0,0,0,1996-5-23,0
1996,5,24,0,0,0,1996-5-24,0
1996,5,25,0,0,0,1996-5-25,0
1996,5,26,0,0,0,1996-5-26,0
1996,5,27,0,0,0,1996-5-27,0
1996,5,28,0,0,0,1996-5-28,0
1996,5,29,0,0,0,1996-5-29,0
1996,5,30,0,0,0,1996-5-30,0
1996,5,31,0,0,0,1996-5-31,0
1996,6,1,0,0,0,1996-6-1,0
1996,6,2,0,0,0,1996-6-2,0
1996,6,3,0,0,0,1996-6-3,0
1996,6,4,14,14,0,1996-6-4,14
1996,6,5,42,42,0,1996-6-5,42
1996,6,6,84,70,14,1996-6-6,56
1996,6,7,112,112,0,1996-6-7,112
1996,6,8,126,126,0,1996-6-8,126
1996,6,9,140,126,14,1996-6-9,112
1996,6,10,84,84,0,1996-6-10,84
1996,6,11,56,56,0,1996-6-11,56
1996,6,12,0,0,0,1996-6-12,0
1996,6,13,0,0,0,1996-6-13,0
1996,6,14,0,0,0,1996-6-14,0
1996,6,15,0,0,0,1996-6-15,0
1996,6,16,0,0,0,1996-6-16,0
1996,6,17,0,0,0,1996-6-17,0
1996,6,18,0,0,0,1996-6-18,0
1996,6,19,112,112,0,1996-6-19,112
1996,6,20,140,140,0,1996-6-20,140
1996,6,21,126,126,0,1996-6-21,126
1996,6,22,140,140,0,1996-6-22,140
1996,6,23,154,154,0,1996-6-23,154
1996,6,24,140,140,0,1996-6-24,140
1996,6,25,126,126,0,1996-6-25,126
1996,6,26,112,112,0,1996-6-26,112
1996,6,27,126,126,0,1996-6-27,126
1996,6,28,448,448,0,1996-6-28,448
1996,6,29,112,112,0,1996-6-29,112
1996,6,30,112,112,0,1996-6-30,112
1996,7,1,70,70,0,1996-7-1,70
1996,7,2,14,14,0,1996-7-2,14
1996,7,3,14,14,0,1996-7-3,14
1996,7,4,14,0,14,1996-7-4,-14
1996,7,5,14,0,14,1996-7-5,-14
1996,7,6,0,0,0,1996-7-6,0
1996,7,7,42,0,42,1996-7-7,-42
1996,7,8,350,0,350,1996-7-8,-350
1996,7,9,560,0,560,1996-7-9,-560
1996,7,10,588,0,588,1996-7-10,-588
1996,7,11,546,0,546,1996-7-11,-546
1996,7,12,420,0,420,1996-7-12,-420
1996,7,13,28,0,28,1996-7-13,-28
1996,7,14,0,0,0,1996-7-14,0
1996,7,15,0,0,0,1996-7-15,0
1996,7,16,0,0,0,1996-7-16,0
1996,7,17,0,0,0,1996-7-17,0
1996,7,18,0,0,0,1996-7-18,0
1996,7,19,14,0,14,1996-7-19,-14
1996,7,20,0,0,0,1996-7-20,0
1996,7,21,0,0,0,1996-7-21,0
1996,7,22,0,0,0,1996-7-22,0
1996,7,23,0,0,0,1996-7-23,0
1996,7,24,0,0,0,1996-7-24,0
1996,7,25,0,0,0,1996-7-25,0
1996,7,26,0,0,0,1996-7-26,0
1996,7,27,280,0,280,1996-7-27,-280
1996,7,28,476,0,476,1996-7-28,-476
1996,7,29,504,0,504,1996-7-29,-504
1996,7,30,560,0,560,1996-7-30,-560
1996,7,31,574,0,574,1996-7-31,-574
1996,8,1,420,0,420,1996-8-1,-420
1996,8,2,448,0,448,1996-8-2,-448
1996,8,3,406,0,406,1996-8-3,-406
1996,8,4,308,0,308,1996-8-4,-308
1996,8,5,308,0,308,1996-8-5,-308
1996,8,6,196,0,196,1996-8-6,-196
1996,8,7,196,14,182,1996-8-7,-168
1996,8,8,168,0,168,1996-8-8,-168
1996,8,9,28,28,0,1996-8-9,28
1996,8,10,56,56,0,1996-8-10,56
1996,8,11,126,126,0,1996-8-11,126
1996,8,12,112,112,0,1996-8-12,112
1996,8,13,70,70,0,1996-8-13,70
1996,8,14,28,28,0,1996-8-14,28
1996,8,15,28,28,0,1996-8-15,28
1996,8,16,28,28,0,1996-8-16,28
1996,8,17,28,28,0,1996-8-17,28
1996,8,18,14,14,0,1996-8-18,14
1996,8,19,14,14,0,1996-8-19,14
1996,8,20,14,14,0,1996-8-20,14
1996,8,21,0,0,0,1996-8-21,0
1996,8,22,28,28,0,1996-8-22,28
1996,8,23,98,28,70,1996-8-23,-42
1996,8,24,140,14,126,1996-8-24,-112
1996,8,25,140,0,140,1996-8-25,-140
1996,8,26,182,0,182,1996-8-26,-182
1996,8,27,84,0,84,1996-8-27,-84
1996,8,28,70,0,70,1996-8-28,-70
1996,8,29,140,0,140,1996-8-29,-140
1996,8,30,84,0,84,1996-8-30,-84
1996,8,31,70,0,70,1996-8-31,-70
1996,9,1,42,0,42,1996-9-1,-42
1996,9,2,42,0,42,1996-9-2,-42
1996,9,3,28,0,28,1996-9-3,-28
1996,9,4,0,0,0,1996-9-4,0
1996,9,5,0,0,0,1996-9-5,0
1996,9,6,0,0,0,1996-9-6,0
1996,9,7,28,0,28,1996-9-7,-28
1996,9,8,14,0,14,1996-9-8,-14
1996,9,9,0,0,0,1996-9-9,0
1996,9,10,0,0,0,1996-9-10,0
1996,9,11,0,0,0,1996-9-11,0
1996,9,12,0,0,0,1996-9-12,0
1996,9,13,0,0,0,1996-9-13,0
1996,9,14,0,0,0,1996-9-14,0
1996,9,15,0,0,0,1996-9-15,0
1996,9,16,0,0,0,1996-9-16,0
1996,9,17,0,0,0,1996-9-17,0
1996,9,18,0,0,0,1996-9-18,0
1996,9,19,0,0,0,1996-9-19,0
1996,9,20,0,0,0,1996-9-20,0
1996,9,21,0,0,0,1996-9-21,0
1996,9,22,0,0,0,1996-9-22,0
1996,9,23,0,0,0,1996-9-23,0
1996,9,24,0,0,0,1996-9-24,0
1996,9,25,0,0,0,1996-9-25,0
1996,9,26,0,0,0,1996-9-26,0
1996,9,27,0,0,0,1996-9-27,0
1996,9,28,0,0,0,1996-9-28,0
1996,9,29,0,0,0,1996-9-29,0
1996,9,30,0,0,0,1996-9-30,0
1996,10,1,0,0,0,1996-10-1,0
1996,10,2,0,0,0,1996-10-2,0
1996,10,3,0,0,0,1996-10-3,0
1996,10,4,0,0,0,1996-10-4,0
1996,10,5,0,0,0,1996-10-5,0
1996,10,6,0,0,0,1996-10-6,0
1996,10,7,0,0,0,1996-10-7,0
1996,10,8,0,0,0,1996-10-8,0
1996,10,9,0,0,0,1996-10-9,0
1996,10,10,0,0,0,1996-10-10,0
1996,10,11,0,0,0,1996-10-11,0
1996,10,12,0,0,0,1996-10-12,0
1996,10,13,0,0,0,1996-10-13,0
1996,10,14,0,0,0,1996-10-14,0
1996,10,15,0,0,0,1996-10-15,0
1996,10,16,0,0,0,1996-10-16,0
1996,10,17,0,0,0,1996-10-17,0
1996,10,18,0,0,0,1996-10-18,0
1996,10,19,0,0,0,1996-10-19,0
1996,10,20,0,0,0,1996-10-20,0
1996,10,21,0,0,0,1996-10-21,0
1996,10,22,0,0,0,1996-10-22,0
1996,10,23,0,0,0,1996-10-23,0
1996,10,24,0,0,0,1996-10-24,0
1996,10,25,14,14,0,1996-10-25,14
1996,10,26,28,0,28,1996-10-26,-28
1996,10,27,14,0,14,1996-10-27,-14
1996,10,28,0,0,0,1996-10-28,0
1996,10,29,0,0,0,1996-10-29,0
1996,10,30,0,0,0,1996-10-30,0
1996,10,31,0,0,0,1996-10-31,0
1996,11,1,0,0,0,1996-11-1,0
1996,11,2,0,0,0,1996-11-2,0
1996,11,3,0,0,0,1996-11-3,0
1996,11,4,0,0,0,1996-11-4,0
1996,11,5,0,0,0,1996-11-5,0
1996,11,6,0,0,0,1996-11-6,0
1996,11,7,0,0,0,1996-11-7,0
1996,11,8,0,0,0,1996-11-8,0
1996,11,9,0,0,0,1996-11-9,0
1996,11,10,14,0,14,1996-11-10,-14
1996,11,11,28,0,28,1996-11-11,-28
1996,11,12,42,42,0,1996-11-12,42
1996,11,13,28,28,0,1996-11-13,28
1996,11,14,14,14,0,1996-11-14,14
1996,11,15,28,28,0,1996-11-15,28
1996,11,16,56,42,14,1996-11-16,28
1996,11,17,28,28,0,1996-11-17,28
1996,11,18,14,14,0,1996-11-18,14
1996,11,19,14,14,0,1996-11-19,14
1996,11,20,0,0,0,1996-11-20,0
1996,11,21,28,0,28,1996-11-21,-28
1996,11,22,168,56,112,1996-11-22,-56
1996,11,23,476,238,238,1996-11-23,0
1996,11,24,728,266,462,1996-11-24,-196
1996,11,25,1554,294,1260,1996-11-25,-966
1996,11,26,1330,196,1134,1996-11-26,-938
1996,11,27,1204,0,1204,1996-11-27,-1204
1996,11,28,966,0,966,1996-11-28,-966
1996,11,29,812,0,812,1996-11-29,-812
1996,11,30,798,0,798,1996-11-30,-798
1996,12,1,630,0,630,1996-12-1,-630
1996,12,2,140,0,140,1996-12-2,-140
1996,12,3,0,0,0,1996-12-3,0
1996,12,4,0,0,0,1996-12-4,0
1996,12,5,0,0,0,1996-12-5,0
1996,12,6,0,0,0,1996-12-6,0
1996,12,7,14,0,14,1996-12-7,-14
1996,12,8,14,0,14,1996-12-8,-14
1996,12,9,70,0,70,1996-12-9,-70
1996,12,10,56,0,56,1996-12-10,-56
1996,12,11,378,196,182,1996-12-11,14
1996,12,12,238,98,140,1996-12-12,-42
1996,12,13,294,98,196,1996-12-13,-98
1996,12,14,294,70,224,1996-12-14,-154
1996,12,15,364,112,252,1996-12-15,-140
1996,12,16,84,84,0,1996-12-16,84
1996,12,17,126,98,28,1996-12-17,70
1996,12,18,266,252,14,1996-12-18,238
1996,12,19,154,154,0,1996-12-19,154
1996,12,20,70,70,0,1996-12-20,70
1996,12,21,84,84,0,1996-12-21,84
1996,12,22,84,84,0,1996-12-22,84
1996,12,23,70,70,0,1996-12-23,70
1996,12,24,0,0,0,1996-12-24,0
1996,12,25,0,0,0,1996-12-25,0
1996,12,26,0,0,0,1996-12-26,0
1996,12,27,0,0,0,1996-12-27,0
1996,12,28,0,0,0,1996-12-28,0
1996,12,29,0,0,0,1996-12-29,0
1996,12,30,0,0,0,1996-12-30,0
1996,12,31,0,0,0,1996-12-31,0
1997,1,1,0,0,0,1997-1-1,0
1997,1,2,0,0,0,1997-1-2,0
1997,1,3,0,0,0,1997-1-3,0
1997,1,4,14,0,14,1997-1-4,-14
1997,1,5,28,0,28,1997-1-5,-28
1997,1,6,14,0,14,1997-1-6,-14
1997,1,7,0,0,0,1997-1-7,0
1997,1,8,0,0,0,1997-1-8,0
1997,1,9,28,28,0,1997-1-9,28
1997,1,10,42,42,0,1997-1-10,42
1997,1,11,28,28,0,1997-1-11,28
1997,1,12,0,0,0,1997-1-12,0
1997,1,13,0,0,0,1997-1-13,0
1997,1,14,0,0,0,1997-1-14,0
1997,1,15,42,0,42,1997-1-15,-42
1997,1,16,28,0,28,1997-1-16,-28
1997,1,17,0,0,0,1997-1-17,0
1997,1,18,0,0,0,1997-1-18,0
1997,1,19,0,0,0,1997-1-19,0
1997,1,20,0,0,0,1997-1-20,0
1997,1,21,0,0,0,1997-1-21,0
1997,1,22,0,0,0,1997-1-22,0
1997,1,23,0,0,0,1997-1-23,0
1997,1,24,28,0,28,1997-1-24,-28
1997,1,25,0,0,0,1997-1-25,0
1997,1,26,0,0,0,1997-1-26,0
1997,1,27,0,0,0,1997-1-27,0
1997,1,28,0,0,0,1997-1-28,0
1997,1,29,28,28,0,1997-1-29,28
1997,1,30,42,42,0,1997-1-30,42
1997,1,31,14,14,0,1997-1-31,14
1997,2,1,28,28,0,1997-2-1,28
1997,2,2,84,42,42,1997-2-2,0
1997,2,3,252,168,84,1997-2-3,84
1997,2,4,238,196,42,1997-2-4,154
1997,2,5,210,168,42,1997-2-5,126
1997,2,6,140,140,0,1997-2-6,140
1997,2,7,42,42,0,1997-2-7,42
1997,2,8,0,0,0,1997-2-8,0
1997,2,9,0,0,0,1997-2-9,0
1997,2,10,0,0,0,1997-2-10,0
1997,2,11,0,0,0,1997-2-11,0
1997,2,12,0,0,0,1997-2-12,0
1997,2,13,0,0,0,1997-2-13,0
1997,2,14,0,0,0,1997-2-14,0
1997,2,15,0,0,0,1997-2-15,0
1997,2,16,0,0,0,1997-2-16,0
1997,2,17,0,0,0,1997-2-17,0
1997,2,18,28,28,0,1997-2-18,28
1997,2,19,14,14,0,1997-2-19,14
1997,2,20,0,0,0,1997-2-20,0
1997,2,21,0,0,0,1997-2-21,0
1997,2,22,0,0,0,1997-2-22,0
1997,2,23,0,0,0,1997-2-23,0
1997,2,24,14,14,0,1997-2-24,14
1997,2,25,14,14,0,1997-2-25,14
1997,2,26,0,0,0,1997-2-26,0
1997,2,27,0,0,0,1997-2-27,0
1997,2,28,0,0,0,1997-2-28,0
1997,3,1,0,0,0,1997-3-1,0
1997,3,2,0,0,0,1997-3-2,0
1997,3,3,0,0,0,1997-3-3,0
1997,3,4,0,0,0,1997-3-4,0
1997,3,5,0,0,0,1997-3-5,0
1997,3,6,168,168,0,1997-3-6,168
1997,3,7,140,140,0,1997-3-7,140
1997,3,8,168,154,14,1997-3-8,140
1997,3,9,98,84,14,1997-3-9,70
1997,3,10,70,70,0,1997-3-10,70
1997,3,11,42,42,0,1997-3-11,42
1997,3,12,42,42,0,1997-3-12,42
1997,3,13,28,28,0,1997-3-13,28
1997,3,14,70,14,56,1997-3-14,-42
1997,3,15,42,14,28,1997-3-15,-14
1997,3,16,42,0,42,1997-3-16,-42
1997,3,17,42,0,42,1997-3-17,-42
1997,3,18,0,0,0,1997-3-18,0
1997,3,19,0,0,0,1997-3-19,0
1997,3,20,0,0,0,1997-3-20,0
1997,3,21,0,0,0,1997-3-21,0
1997,3,22,0,0,0,1997-3-22,0
1997,3,23,0,0,0,1997-3-23,0
1997,3,24,0,0,0,1997-3-24,0
1997,3,25,0,0,0,1997-3-25,0
1997,3,26,0,0,0,1997-3-26,0
1997,3,27,56,0,56,1997-3-27,-56
1997,3,28,112,0,112,1997-3-28,-112
1997,3,29,140,0,140,1997-3-29,-140
1997,3,30,196,0,196,1997-3-30,-196
1997,3,31,126,0,126,1997-3-31,-126
1997,4,1,98,0,98,1997-4-1,-98
1997,4,2,168,0,168,1997-4-2,-168
1997,4,3,224,0,224,1997-4-3,-224
1997,4,4,224,0,224,1997-4-4,-224
1997,4,5,140,0,140,1997-4-5,-140
1997,4,6,84,0,84,1997-4-6,-84
1997,4,7,42,0,42,1997-4-7,-42
1997,4,8,42,0,42,1997-4-8,-42
1997,4,9,42,28,14,1997-4-9,14
1997,4,10,182,182,0,1997-4-10,182
1997,4,11,196,182,14,1997-4-11,168
1997,4,12,112,84,28,1997-4-12,56
1997,4,13,126,42,84,1997-4-13,-42
1997,4,14,154,0,154,1997-4-14,-154
1997,4,15,294,0,294,1997-4-15,-294
1997,4,16,252,0,252,1997-4-16,-252
1997,4,17,56,14,42,1997-4-17,-28
1997,4,18,14,0,14,1997-4-18,-14
1997,4,19,14,14,0,1997-4-19,14
1997,4,20,0,0,0,1997-4-20,0
1997,4,21,0,0,0,1997-4-21,0
1997,4,22,14,14,0,1997-4-22,14
1997,4,23,0,0,0,1997-4-23,0
1997,4,24,0,0,0,1997-4-24,0
1997,4,25,0,0,0,1997-4-25,0
1997,4,26,42,14,28,1997-4-26,-14
1997,4,27,42,0,42,1997-4-27,-42
1997,4,28,42,0,42,1997-4-28,-42
1997,4,29,0,0,0,1997-4-29,0
1997,4,30,0,0,0,1997-4-30,0
1997,5,1,0,0,0,1997-5-1,0
1997,5,2,0,0,0,1997-5-2,0
1997,5,3,14,0,14,1997-5-3,-14
1997,5,4,0,0,0,1997-5-4,0
1997,5,5,168,168,0,1997-5-5,168
1997,5,6,126,126,0,1997-5-6,126
1997,5,7,98,98,0,1997-5-7,98
1997,5,8,126,126,0,1997-5-8,126
1997,5,9,126,126,0,1997-5-9,126
1997,5,10,126,126,0,1997-5-10,126
1997,5,11,126,126,0,1997-5-11,126
1997,5,12,84,84,0,1997-5-12,84
1997,5,13,98,98,0,1997-5-13,98
1997,5,14,98,98,0,1997-5-14,98
1997,5,15,70,70,0,1997-5-15,70
1997,5,16,56,56,0,1997-5-16,56
1997,5,17,14,14,0,1997-5-17,14
1997,5,18,84,84,0,1997-5-18,84
1997,5,19,224,182,42,1997-5-19,140
1997,5,20,210,168,42,1997-5-20,126
1997,5,21,364,336,28,1997-5-21,308
1997,5,22,350,322,28,1997-5-22,294
1997,5,23,238,210,28,1997-5-23,182
1997,5,24,210,168,42,1997-5-24,126
1997,5,25,182,154,28,1997-5-25,126
1997,5,26,140,112,28,1997-5-26,84
1997,5,27,56,42,14,1997-5-27,28
1997,5,28,42,28,14,1997-5-28,14
1997,5,29,70,70,0,1997-5-29,70
1997,5,30,42,42,0,1997-5-30,42
1997,5,31,70,28,42,1997-5-31,-14
1997,6,1,98,28,70,1997-6-1,-42
1997,6,2,168,0,168,1997-6-2,-168
1997,6,3,210,0,210,1997-6-3,-210
1997,6,4,154,0,154,1997-6-4,-154
1997,6,5,168,0,168,1997-6-5,-168
1997,6,6,154,0,154,1997-6-6,-154
1997,6,7,126,0,126,1997-6-7,-126
1997,6,8,42,0,42,1997-6-8,-42
1997,6,9,28,0,28,1997-6-9,-28
1997,6,10,14,14,0,1997-6-10,14
1997,6,11,14,14,0,1997-6-11,14
1997,6,12,56,56,0,1997-6-12,56
1997,6,13,42,42,0,1997-6-13,42
1997,6,14,56,56,0,1997-6-14,56
1997,6,15,42,42,0,1997-6-15,42
1997,6,16,98,98,0,1997-6-16,98
1997,6,17,42,42,0,1997-6-17,42
1997,6,18,56,28,28,1997-6-18,0
1997,6,19,28,0,28,1997-6-19,-28
1997,6,20,14,0,14,1997-6-20,-14
1997,6,21,0,0,0,1997-6-21,0
1997,6,22,14,14,0,1997-6-22,14
1997,6,23,14,14,0,1997-6-23,14
1997,6,24,14,14,0,1997-6-24,14
1997,6,25,56,56,0,1997-6-25,56
1997,6,26,56,56,0,1997-6-26,56
1997,6,27,42,42,0,1997-6-27,42
1997,6,28,14,14,0,1997-6-28,14
1997,6,29,0,0,0,1997-6-29,0
1997,6,30,0,0,0,1997-6-30,0
1997,7,1,0,0,0,1997-7-1,0
1997,7,2,14,0,14,1997-7-2,-14
1997,7,3,0,0,0,1997-7-3,0
1997,7,4,0,0,0,1997-7-4,0
1997,7,5,0,0,0,1997-7-5,0
1997,7,6,0,0,0,1997-7-6,0
1997,7,7,42,14,28,1997-7-7,-14
1997,7,8,14,0,14,1997-7-8,-14
1997,7,9,70,42,28,1997-7-9,14
1997,7,10,14,14,0,1997-7-10,14
1997,7,11,0,0,0,1997-7-11,0
1997,7,12,0,0,0,1997-7-12,0
1997,7,13,0,0,0,1997-7-13,0
1997,7,14,14,0,14,1997-7-14,-14
1997,7,15,0,0,0,1997-7-15,0
1997,7,16,0,0,0,1997-7-16,0
1997,7,17,0,0,0,1997-7-17,0
1997,7,18,0,0,0,1997-7-18,0
1997,7,19,0,0,0,1997-7-19,0
1997,7,20,14,0,14,1997-7-20,-14
1997,7,21,0,0,0,1997-7-21,0
1997,7,22,14,14,0,1997-7-22,14
1997,7,23,84,84,0,1997-7-23,84
1997,7,24,126,126,0,1997-7-24,126
1997,7,25,280,280,0,1997-7-25,280
1997,7,26,252,252,0,1997-7-26,252
1997,7,27,252,252,0,1997-7-27,252
1997,7,28,14,14,0,1997-7-28,14
1997,7,29,0,0,0,1997-7-29,0
1997,7,30,0,0,0,1997-7-30,0
1997,7,31,0,0,0,1997-7-31,0
1997,8,1,0,0,0,1997-8-1,0
1997,8,2,14,14,0,1997-8-2,14
1997,8,3,42,0,42,1997-8-3,-42
1997,8,4,28,0,28,1997-8-4,-28
1997,8,5,42,14,28,1997-8-5,-14
1997,8,6,168,140,28,1997-8-6,112
1997,8,7,196,140,56,1997-8-7,84
1997,8,8,322,238,84,1997-8-8,154
1997,8,9,126,56,70,1997-8-9,-14
1997,8,10,56,14,42,1997-8-10,-28
1997,8,11,308,294,14,1997-8-11,280
1997,8,12,196,182,14,1997-8-12,168
1997,8,13,252,182,70,1997-8-13,112
1997,8,14,196,140,56,1997-8-14,84
1997,8,15,168,154,14,1997-8-15,140
1997,8,16,140,140,0,1997-8-16,140
1997,8,17,84,84,0,1997-8-17,84
1997,8,18,84,84,0,1997-8-18,84
1997,8,19,84,84,0,1997-8-19,84
1997,8,20,70,70,0,1997-8-20,70
1997,8,21,84,84,0,1997-8-21,84
1997,8,22,98,98,0,1997-8-22,98
1997,8,23,28,28,0,1997-8-23,28
1997,8,24,0,0,0,1997-8-24,0
1997,8,25,126,112,14,1997-8-25,98
1997,8,26,224,224,0,1997-8-26,224
1997,8,27,154,154,0,1997-8-27,154
1997,8,28,308,308,0,1997-8-28,308
1997,8,29,392,392,0,1997-8-29,392
1997,8,30,308,308,0,1997-8-30,308
1997,8,31,336,336,0,1997-8-31,336
1997,9,1,336,336,0,1997-9-1,336
1997,9,2,336,336,0,1997-9-2,336
1997,9,3,350,252,98,1997-9-3,154
1997,9,4,448,168,280,1997-9-4,-112
1997,9,5,560,140,420,1997-9-5,-280
1997,9,6,574,98,476,1997-9-6,-378
1997,9,7,896,70,826,1997-9-7,-756
1997,9,8,1400,126,1274,1997-9-8,-1148
1997,9,9,1918,252,1666,1997-9-9,-1414
1997,9,10,2226,378,1848,1997-9-10,-1470
1997,9,11,2030,350,1680,1997-9-11,-1330
1997,9,12,1470,336,1134,1997-9-12,-798
1997,9,13,1316,378,938,1997-9-13,-560
1997,9,14,1106,490,616,1997-9-14,-126
1997,9,15,1078,616,462,1997-9-15,154
1997,9,16,1106,630,476,1997-9-16,154
1997,9,17,686,336,350,1997-9-17,-14
1997,9,18,280,168,112,1997-9-18,56
1997,9,19,126,126,0,1997-9-19,126
1997,9,20,84,84,0,1997-9-20,84
1997,9,21,126,70,56,1997-9-21,14
1997,9,22,322,56,266,1997-9-22,-210
1997,9,23,406,0,406,1997-9-23,-406
1997,9,24,420,0,420,1997-9-24,-420
1997,9,25,448,0,448,1997-9-25,-448
1997,9,26,364,0,364,1997-9-26,-364
1997,9,27,336,0,336,1997-9-27,-336
1997,9,28,364,0,364,1997-9-28,-364
1997,9,29,308,14,294,1997-9-29,-280
1997,9,30,364,0,364,1997-9-30,-364
1997,10,1,224,28,196,1997-10-1,-168
1997,10,2,112,56,56,1997-10-2,0
1997,10,3,126,84,42,1997-10-3,42
1997,10,4,98,56,42,1997-10-4,14
1997,10,5,56,42,14,1997-10-5,28
1997,10,6,28,14,14,1997-10-6,0
1997,10,7,14,14,0,1997-10-7,14
1997,10,8,14,14,0,1997-10-8,14
1997,10,9,28,28,0,1997-10-9,28
1997,10,10,56,56,0,1997-10-10,56
1997,10,11,70,70,0,1997-10-11,70
1997,10,12,126,126,0,1997-10-12,126
1997,10,13,154,154,0,1997-10-13,154
1997,10,14,154,154,0,1997-10-14,154
1997,10,15,252,252,0,1997-10-15,252
1997,10,16,238,238,0,1997-10-16,238
1997,10,17,266,266,0,1997-10-17,266
1997,10,18,182,182,0,1997-10-18,182
1997,10,19,126,126,0,1997-10-19,126
1997,10,20,84,84,0,1997-10-20,84
1997,10,21,70,70,0,1997-10-21,70
1997,10,22,14,14,0,1997-10-22,14
1997,10,23,0,0,0,1997-10-23,0
1997,10,24,0,0,0,1997-10-24,0
1997,10,25,28,28,0,1997-10-25,28
1997,10,26,42,42,0,1997-10-26,42
1997,10,27,196,70,126,1997-10-27,-56
1997,10,28,266,84,182,1997-10-28,-98
1997,10,29,294,14,280,1997-10-29,-266
1997,10,30,350,42,308,1997-10-30,-266
1997,10,31,406,42,364,1997-10-31,-322
1997,11,1,322,14,308,1997-11-1,-294
1997,11,2,476,70,406,1997-11-2,-336
1997,11,3,924,0,924,1997-11-3,-924
1997,11,4,1442,42,1400,1997-11-4,-1358
1997,11,5,1316,56,1260,1997-11-5,-1204
1997,11,6,1176,112,1064,1997-11-6,-952
1997,11,7,966,84,882,1997-11-7,-798
1997,11,8,812,126,686,1997-11-8,-560
1997,11,9,56,42,14,1997-11-9,28
1997,11,10,168,168,0,1997-11-10,168
1997,11,11,224,224,0,1997-11-11,224
1997,11,12,140,140,0,1997-11-12,140
1997,11,13,252,210,42,1997-11-13,168
1997,11,14,490,434,56,1997-11-14,378
1997,11,15,630,560,70,1997-11-15,490
1997,11,16,546,504,42,1997-11-16,462
1997,11,17,630,588,42,1997-11-17,546
1997,11,18,532,490,42,1997-11-18,448
1997,11,19,406,364,42,1997-11-19,322
1997,11,20,434,364,70,1997-11-20,294
1997,11,21,504,462,42,1997-11-21,420
1997,11,22,574,560,14,1997-11-22,546
1997,11,23,490,448,42,1997-11-23,406
1997,11,24,448,420,28,1997-11-24,392
1997,11,25,364,350,14,1997-11-25,336
1997,11,26,504,504,0,1997-11-26,504
1997,11,27,868,868,0,1997-11-27,868
1997,11,28,952,952,0,1997-11-28,952
1997,11,29,1008,1008,0,1997-11-29,1008
1997,11,30,1316,1316,0,1997-11-30,1316
1997,12,1,784,770,14,1997-12-1,756
1997,12,2,854,854,0,1997-12-2,854
1997,12,3,854,840,14,1997-12-3,826
1997,12,4,588,588,0,1997-12-4,588
1997,12,5,490,490,0,1997-12-5,490
1997,12,6,448,448,0,1997-12-6,448
1997,12,7,406,406,0,1997-12-7,406
1997,12,8,378,308,70,1997-12-8,238
1997,12,9,378,210,168,1997-12-9,42
1997,12,10,392,238,154,1997-12-10,84
1997,12,11,322,266,56,1997-12-11,210
1997,12,12,350,280,70,1997-12-12,210
1997,12,13,364,294,70,1997-12-13,224
1997,12,14,322,266,56,1997-12-14,210
1997,12,15,308,266,42,1997-12-15,224
1997,12,16,336,308,28,1997-12-16,280
1997,12,17,280,252,28,1997-12-17,224
1997,12,18,140,140,0,1997-12-18,140
1997,12,19,98,98,0,1997-12-19,98
1997,12,20,154,98,56,1997-12-20,42
1997,12,21,266,56,210,1997-12-21,-154
1997,12,22,364,28,336,1997-12-22,-308
1997,12,23,980,154,826,1997-12-23,-672
1997,12,24,728,224,504,1997-12-24,-280
1997,12,25,658,224,434,1997-12-25,-210
1997,12,26,644,280,364,1997-12-26,-84
1997,12,27,588,266,322,1997-12-27,-56
1997,12,28,574,308,266,1997-12-28,42
1997,12,29,658,350,308,1997-12-29,42
1997,12,30,602,308,294,1997-12-30,14
1997,12,31,602,336,266,1997-12-31,70
1998,1,1,546,294,252,1998-1-1,42
1998,1,2,406,252,154,1998-1-2,98
1998,1,3,224,210,14,1998-1-3,196
1998,1,4,168,154,14,1998-1-4,140
1998,1,5,70,70,0,1998-1-5,70
1998,1,6,28,14,14,1998-1-6,0
1998,1,7,0,0,0,1998-1-7,0
1998,1,8,0,0,0,1998-1-8,0
1998,1,9,0,0,0,1998-1-9,0
1998,1,10,14,0,14,1998-1-10,-14
1998,1,11,56,14,42,1998-1-11,-28
1998,1,12,280,0,280,1998-1-12,-280
1998,1,13,224,0,224,1998-1-13,-224
1998,1,14,266,0,266,1998-1-14,-266
1998,1,15,490,0,490,1998-1-15,-490
1998,1,16,490,42,448,1998-1-16,-406
1998,1,17,462,56,406,1998-1-17,-350
1998,1,18,378,70,308,1998-1-18,-238
1998,1,19,126,14,112,1998-1-19,-98
1998,1,20,42,28,14,1998-1-20,14
1998,1,21,14,14,0,1998-1-21,14
1998,1,22,42,14,28,1998-1-22,-14
1998,1,23,140,0,140,1998-1-23,-140
1998,1,24,350,28,322,1998-1-24,-294
1998,1,25,490,84,406,1998-1-25,-322
1998,1,26,588,70,518,1998-1-26,-448
1998,1,27,588,70,518,1998-1-27,-448
1998,1,28,826,70,756,1998-1-28,-686
1998,1,29,322,42,280,1998-1-29,-238
1998,1,30,196,56,140,1998-1-30,-84
1998,1,31,168,42,126,1998-1-31,-84
1998,2,1,168,14,154,1998-2-1,-140
1998,2,2,154,0,154,1998-2-2,-154
1998,2,3,168,42,126,1998-2-3,-84
1998,2,4,154,70,84,1998-2-4,-14
1998,2,5,126,28,98,1998-2-5,-70
1998,2,6,140,14,126,1998-2-6,-112
1998,2,7,98,0,98,1998-2-7,-98
1998,2,8,112,0,112,1998-2-8,-112
1998,2,9,84,0,84,1998-2-9,-84
1998,2,10,154,0,154,1998-2-10,-154
1998,2,11,112,14,98,1998-2-11,-84
1998,2,12,308,0,308,1998-2-12,-308
1998,2,13,434,0,434,1998-2-13,-434
1998,2,14,546,14,532,1998-2-14,-518
1998,2,15,574,28,546,1998-2-15,-518
1998,2,16,812,56,756,1998-2-16,-700
1998,2,17,756,70,686,1998-2-17,-616
1998,2,18,560,28,532,1998-2-18,-504
1998,2,19,588,28,560,1998-2-19,-532
1998,2,20,504,0,504,1998-2-20,-504
1998,2,21,504,0,504,1998-2-21,-504
1998,2,22,322,0,322,1998-2-22,-322
1998,2,23,196,42,154,1998-2-23,-112
1998,2,24,154,112,42,1998-2-24,70
1998,2,25,280,182,98,1998-2-25,84
1998,2,26,280,168,112,1998-2-26,56
1998,2,27,196,126,70,1998-2-27,56
1998,2,28,140,42,98,1998-2-28,-56
1998,3,1,392,112,280,1998-3-1,-168
1998,3,2,420,42,378,1998-3-2,-336
1998,3,3,434,14,420,1998-3-3,-406
1998,3,4,784,28,756,1998-3-4,-728
1998,3,5,994,70,924,1998-3-5,-854
1998,3,6,560,56,504,1998-3-6,-448
1998,3,7,112,56,56,1998-3-7,0
1998,3,8,182,56,126,1998-3-8,-70
1998,3,9,210,70,140,1998-3-9,-70
1998,3,10,392,42,350,1998-3-10,-308
1998,3,11,518,42,476,1998-3-11,-434
1998,3,12,420,28,392,1998-3-12,-364
1998,3,13,504,0,504,1998-3-13,-504
1998,3,14,588,14,574,1998-3-14,-560
1998,3,15,1260,0,1260,1998-3-15,-1260
1998,3,16,1386,0,1386,1998-3-16,-1386
1998,3,17,1274,0,1274,1998-3-17,-1274
1998,3,18,1302,70,1232,1998-3-18,-1162
1998,3,19,1232,112,1120,1998-3-19,-1008
1998,3,20,1274,28,1246,1998-3-20,-1218
1998,3,21,1134,70,1064,1998-3-21,-994
1998,3,22,1344,70,1274,1998-3-22,-1204
1998,3,23,910,126,784,1998-3-23,-658
1998,3,24,1246,308,938,1998-3-24,-630
1998,3,25,1078,266,812,1998-3-25,-546
1998,3,26,1008,266,742,1998-3-26,-476
1998,3,27,868,182,686,1998-3-27,-504
1998,3,28,812,168,644,1998-3-28,-476
1998,3,29,910,98,812,1998-3-29,-714
1998,3,30,714,0,714,1998-3-30,-714
1998,3,31,854,0,854,1998-3-31,-854
1998,4,1,1008,14,994,1998-4-1,-980
1998,4,2,658,0,658,1998-4-2,-658
1998,4,3,574,0,574,1998-4-3,-574
1998,4,4,280,0,280,1998-4-4,-280
1998,4,5,700,0,700,1998-4-5,-700
1998,4,6,910,0,910,1998-4-6,-910
1998,4,7,1162,42,1120,1998-4-7,-1078
1998,4,8,1316,28,1288,1998-4-8,-1260
1998,4,9,1176,42,1134,1998-4-9,-1092
1998,4,10,1246,0,1246,1998-4-10,-1246
1998,4,11,924,0,924,1998-4-11,-924
1998,4,12,798,0,798,1998-4-12,-798
1998,4,13,602,0,602,1998-4-13,-602
1998,4,14,392,14,378,1998-4-14,-364
1998,4,15,532,140,392,1998-4-15,-252
1998,4,16,294,70,224,1998-4-16,-154
1998,4,17,182,70,112,1998-4-17,-42
1998,4,18,70,70,0,1998-4-18,70
1998,4,19,126,126,0,1998-4-19,126
1998,4,20,140,140,0,1998-4-20,140
1998,4,21,98,98,0,1998-4-21,98
1998,4,22,182,182,0,1998-4-22,182
1998,4,23,126,126,0,1998-4-23,126
1998,4,24,0,0,0,1998-4-24,0
1998,4,25,322,0,322,1998-4-25,-322
1998,4,26,280,0,280,1998-4-26,-280
1998,4,27,280,0,280,1998-4-27,-280
1998,4,28,462,0,462,1998-4-28,-462
1998,4,29,350,0,350,1998-4-29,-350
1998,4,30,434,56,378,1998-4-30,-322
1998,5,1,686,196,490,1998-5-1,-294
1998,5,2,924,280,644,1998-5-2,-364
1998,5,3,1078,420,658,1998-5-3,-238
1998,5,4,1372,714,658,1998-5-4,56
1998,5,5,1638,910,728,1998-5-5,182
1998,5,6,1498,868,630,1998-5-6,238
1998,5,7,1540,868,672,1998-5-7,196
1998,5,8,868,546,322,1998-5-8,224
1998,5,9,742,336,406,1998-5-9,-70
1998,5,10,756,126,630,1998-5-10,-504
1998,5,11,602,28,574,1998-5-11,-546
1998,5,12,644,112,532,1998-5-12,-420
1998,5,13,686,168,518,1998-5-13,-350
1998,5,14,616,210,406,1998-5-14,-196
1998,5,15,588,196,392,1998-5-15,-196
1998,5,16,700,252,448,1998-5-16,-196
1998,5,17,770,182,588,1998-5-17,-406
1998,5,18,518,196,322,1998-5-18,-126
1998,5,19,266,196,70,1998-5-19,126
1998,5,20,168,126,42,1998-5-20,84
1998,5,21,84,84,0,1998-5-21,84
1998,5,22,84,84,0,1998-5-22,84
1998,5,23,56,56,0,1998-5-23,56
1998,5,24,294,280,14,1998-5-24,266
1998,5,25,644,630,14,1998-5-25,616
1998,5,26,770,770,0,1998-5-26,770
1998,5,27,826,784,42,1998-5-27,742
1998,5,28,574,560,14,1998-5-28,546
1998,5,29,294,266,28,1998-5-29,238
1998,5,30,322,238,84,1998-5-30,154
1998,5,31,280,182,98,1998-5-31,84
1998,6,1,266,168,98,1998-6-1,70
1998,6,2,770,168,602,1998-6-2,-434
1998,6,3,840,168,672,1998-6-3,-504
1998,6,4,938,126,812,1998-6-4,-686
1998,6,5,910,126,784,1998-6-5,-658
1998,6,6,756,70,686,1998-6-6,-616
1998,6,7,798,84,714,1998-6-7,-630
1998,6,8,728,84,644,1998-6-8,-560
1998,6,9,644,42,602,1998-6-9,-560
1998,6,10,840,28,812,1998-6-10,-784
1998,6,11,784,14,770,1998-6-11,-756
1998,6,12,966,210,756,1998-6-12,-546
1998,6,13,840,238,602,1998-6-13,-364
1998,6,14,658,280,378,1998-6-14,-98
1998,6,15,378,280,98,1998-6-15,182
1998,6,16,406,294,112,1998-6-16,182
1998,6,17,476,364,112,1998-6-17,252
1998,6,18,364,252,112,1998-6-18,140
1998,6,19,364,252,112,1998-6-19,140
1998,6,20,392,336,56,1998-6-20,280
1998,6,21,490,378,112,1998-6-21,266
1998,6,22,588,476,112,1998-6-22,364
1998,6,23,560,462,98,1998-6-23,364
1998,6,24,616,546,70,1998-6-24,476
1998,6,25,644,518,126,1998-6-25,392
1998,6,26,644,336,308,1998-6-26,28
1998,6,27,756,336,420,1998-6-27,-84
1998,6,28,952,420,532,1998-6-28,-112
1998,6,29,910,308,602,1998-6-29,-294
1998,6,30,1092,406,686,1998-6-30,-280
1998,7,1,1022,476,546,1998-7-1,-70
1998,7,2,910,420,490,1998-7-2,-70
1998,7,3,896,448,448,1998-7-3,0
1998,7,4,896,322,574,1998-7-4,-252
1998,7,5,756,266,490,1998-7-5,-224
1998,7,6,574,224,350,1998-7-6,-126
1998,7,7,532,238,294,1998-7-7,-56
1998,7,8,434,196,238,1998-7-8,-42
1998,7,9,434,140,294,1998-7-9,-154
1998,7,10,406,140,266,1998-7-10,-126
1998,7,11,490,182,308,1998-7-11,-126
1998,7,12,378,154,224,1998-7-12,-70
1998,7,13,154,14,140,1998-7-13,-126
1998,7,14,224,28,196,1998-7-14,-168
1998,7,15,224,14,210,1998-7-15,-196
1998,7,16,266,28,238,1998-7-16,-210
1998,7,17,336,14,322,1998-7-17,-308
1998,7,18,182,0,182,1998-7-18,-182
1998,7,19,224,0,224,1998-7-19,-224
1998,7,20,294,14,280,1998-7-20,-266
1998,7,21,630,14,616,1998-7-21,-602
1998,7,22,896,98,798,1998-7-22,-700
1998,7,23,896,112,784,1998-7-23,-672
1998,7,24,1148,364,784,1998-7-24,-420
1998,7,25,1246,644,602,1998-7-25,42
1998,7,26,1456,826,630,1998-7-26,196
1998,7,27,1344,812,532,1998-7-27,280
1998,7,28,1106,686,420,1998-7-28,266
1998,7,29,1134,658,476,1998-7-29,182
1998,7,30,952,504,448,1998-7-30,56
1998,7,31,952,434,518,1998-7-31,-84
1998,8,1,798,280,518,1998-8-1,-238
1998,8,2,728,294,434,1998-8-2,-140
1998,8,3,644,224,420,1998-8-3,-196
1998,8,4,518,168,350,1998-8-4,-182
1998,8,5,588,126,462,1998-8-5,-336
1998,8,6,1134,476,658,1998-8-6,-182
1998,8,7,1484,826,658,1998-8-7,168
1998,8,8,1820,1120,700,1998-8-8,420
1998,8,9,2338,1344,994,1998-8-9,350
1998,8,10,2436,1344,1092,1998-8-10,252
1998,8,11,2170,1288,882,1998-8-11,406
1998,8,12,2156,1372,784,1998-8-12,588
1998,8,13,1778,1246,532,1998-8-13,714
1998,8,14,1484,1204,280,1998-8-14,924
1998,8,15,1498,1190,308,1998-8-15,882
1998,8,16,1638,1218,420,1998-8-16,798
1998,8,17,1330,994,336,1998-8-17,658
1998,8,18,1456,994,462,1998-8-18,532
1998,8,19,1610,1176,434,1998-8-19,742
1998,8,20,1162,826,336,1998-8-20,490
1998,8,21,1148,854,294,1998-8-21,560
1998,8,22,1134,924,210,1998-8-22,714
1998,8,23,938,770,168,1998-8-23,602
1998,8,24,896,728,168,1998-8-24,560
1998,8,25,980,784,196,1998-8-25,588
1998,8,26,910,728,182,1998-8-26,546
1998,8,27,644,504,140,1998-8-27,364
1998,8,28,742,574,168,1998-8-28,406
1998,8,29,1134,630,504,1998-8-29,126
1998,8,30,2282,1134,1148,1998-8-30,-14
1998,8,31,2548,1302,1246,1998-8-31,56
1998,9,1,2814,1092,1722,1998-9-1,-630
1998,9,2,3150,1148,2002,1998-9-2,-854
1998,9,3,2604,560,2044,1998-9-3,-1484
1998,9,4,2296,322,1974,1998-9-4,-1652
1998,9,5,2142,350,1792,1998-9-5,-1442
1998,9,6,2436,546,1890,1998-9-6,-1344
1998,9,7,2100,518,1582,1998-9-7,-1064
1998,9,8,2086,700,1386,1998-9-8,-686
1998,9,9,1344,602,742,1998-9-9,-140
1998,9,10,896,602,294,1998-9-10,308
1998,9,11,966,770,196,1998-9-11,574
1998,9,12,1218,840,378,1998-9-12,462
1998,9,13,1316,826,490,1998-9-13,336
1998,9,14,882,490,392,1998-9-14,98
1998,9,15,560,210,350,1998-9-15,-140
1998,9,16,392,154,238,1998-9-16,-84
1998,9,17,546,322,224,1998-9-17,98
1998,9,18,980,700,280,1998-9-18,420
1998,9,19,1120,812,308,1998-9-19,504
1998,9,20,1106,812,294,1998-9-20,518
1998,9,21,1274,994,280,1998-9-21,714
1998,9,22,1008,756,252,1998-9-22,504
1998,9,23,1064,840,224,1998-9-23,616
1998,9,24,1120,924,196,1998-9-24,728
1998,9,25,952,742,210,1998-9-25,532
1998,9,26,1078,700,378,1998-9-26,322
1998,9,27,868,616,252,1998-9-27,364
1998,9,28,770,602,168,1998-9-28,434
1998,9,29,462,378,84,1998-9-29,294
1998,9,30,406,322,84,1998-9-30,238
1998,10,1,196,140,56,1998-10-1,84
1998,10,2,406,364,42,1998-10-2,322
1998,10,3,378,364,14,1998-10-3,350
1998,10,4,364,364,0,1998-10-4,364
1998,10,5,350,336,14,1998-10-5,322
1998,10,6,462,434,28,1998-10-6,406
1998,10,7,938,392,546,1998-10-7,-154
1998,10,8,630,280,350,1998-10-8,-70
1998,10,9,490,252,238,1998-10-9,14
1998,10,10,476,224,252,1998-10-10,-28
1998,10,11,280,126,154,1998-10-11,-28
1998,10,12,336,112,224,1998-10-12,-112
1998,10,13,336,168,168,1998-10-13,0
1998,10,14,448,196,252,1998-10-14,-56
1998,10,15,630,224,406,1998-10-15,-182
1998,10,16,798,322,476,1998-10-16,-154
1998,10,17,1022,476,546,1998-10-17,-70
1998,10,18,1148,714,434,1998-10-18,280
1998,10,19,798,532,266,1998-10-19,266
1998,10,20,406,210,196,1998-10-20,14
1998,10,21,308,140,168,1998-10-21,-28
1998,10,22,588,140,448,1998-10-22,-308
1998,10,23,546,56,490,1998-10-23,-434
1998,10,24,364,28,336,1998-10-24,-308
1998,10,25,126,70,56,1998-10-25,14
1998,10,26,126,98,28,1998-10-26,70
1998,10,27,56,56,0,1998-10-27,56
1998,10,28,140,126,14,1998-10-28,112
1998,10,29,462,350,112,1998-10-29,238
1998,10,30,504,434,70,1998-10-30,364
1998,10,31,434,406,28,1998-10-31,378
1998,11,1,448,420,28,1998-11-1,392
1998,11,2,490,476,14,1998-11-2,462
1998,11,3,756,728,28,1998-11-3,700
1998,11,4,868,756,112,1998-11-4,644
1998,11,5,952,826,126,1998-11-5,700
1998,11,6,1022,924,98,1998-11-6,826
1998,11,7,1008,868,140,1998-11-7,728
1998,11,8,1708,1470,238,1998-11-8,1232
1998,11,9,1834,1456,378,1998-11-9,1078
1998,11,10,1764,1176,588,1998-11-10,588
1998,11,11,1302,350,952,1998-11-11,-602
1998,11,12,1120,336,784,1998-11-12,-448
1998,11,13,1190,392,798,1998-11-13,-406
1998,11,14,1470,532,938,1998-11-14,-406
1998,11,15,1078,266,812,1998-11-15,-546
1998,11,16,770,28,742,1998-11-16,-714
1998,11,17,672,42,630,1998-11-17,-588
1998,11,18,574,0,574,1998-11-18,-574
1998,11,19,504,0,504,1998-11-19,-504
1998,11,20,602,0,602,1998-11-20,-602
1998,11,21,714,0,714,1998-11-21,-714
1998,11,22,448,0,448,1998-11-22,-448
1998,11,23,350,0,350,1998-11-23,-350
1998,11,24,728,56,672,1998-11-24,-616
1998,11,25,1330,462,868,1998-11-25,-406
1998,11,26,1316,546,770,1998-11-26,-224
1998,11,27,1260,770,490,1998-11-27,280
1998,11,28,1232,784,448,1998-11-28,336
1998,11,29,1386,994,392,1998-11-29,602
1998,11,30,1302,1078,224,1998-11-30,854
1998,12,1,1876,1652,224,1998-12-1,1428
1998,12,2,1330,1190,140,1998-12-2,1050
1998,12,3,1162,1036,126,1998-12-3,910
1998,12,4,1246,1148,98,1998-12-4,1050
1998,12,5,1344,1330,14,1998-12-5,1316
1998,12,6,1456,1190,266,1998-12-6,924
1998,12,7,1330,938,392,1998-12-7,546
1998,12,8,1372,602,770,1998-12-8,-168
1998,12,9,1218,434,784,1998-12-9,-350
1998,12,10,1120,322,798,1998-12-10,-476
1998,12,11,1456,406,1050,1998-12-11,-644
1998,12,12,1036,224,812,1998-12-12,-588
1998,12,13,966,182,784,1998-12-13,-602
1998,12,14,966,98,868,1998-12-14,-770
1998,12,15,910,126,784,1998-12-15,-658
1998,12,16,798,98,700,1998-12-16,-602
1998,12,17,644,84,560,1998-12-17,-476
1998,12,18,714,336,378,1998-12-18,-42
1998,12,19,770,420,350,1998-12-19,70
1998,12,20,476,336,140,1998-12-20,196
1998,12,21,378,378,0,1998-12-21,378
1998,12,22,280,280,0,1998-12-22,280
1998,12,23,350,350,0,1998-12-23,350
1998,12,24,406,308,98,1998-12-24,210
1998,12,25,518,336,182,1998-12-25,154
1998,12,26,770,546,224,1998-12-26,322
1998,12,27,1120,854,266,1998-12-27,588
1998,12,28,1638,1372,266,1998-12-28,1106
1998,12,29,1638,1470,168,1998-12-29,1302
1998,12,30,1778,1582,196,1998-12-30,1386
1998,12,31,1498,1330,168,1998-12-31,1162
1999,1,1,1204,1078,126,1999-1-1,952
1999,1,2,966,840,126,1999-1-2,714
1999,1,3,938,826,112,1999-1-3,714
1999,1,4,770,644,126,1999-1-4,518
1999,1,5,686,546,140,1999-1-5,406
1999,1,6,364,238,126,1999-1-6,112
1999,1,7,364,238,126,1999-1-7,112
1999,1,8,210,112,98,1999-1-8,14
1999,1,9,224,126,98,1999-1-9,28
1999,1,10,294,196,98,1999-1-10,98
1999,1,11,196,168,28,1999-1-11,140
1999,1,12,406,112,294,1999-1-12,-182
1999,1,13,630,210,420,1999-1-13,-210
1999,1,14,784,406,378,1999-1-14,28
1999,1,15,952,574,378,1999-1-15,196
1999,1,16,1008,630,378,1999-1-16,252
1999,1,17,854,560,294,1999-1-17,266
1999,1,18,1022,672,350,1999-1-18,322
1999,1,19,1050,616,434,1999-1-19,182
1999,1,20,1064,658,406,1999-1-20,252
1999,1,21,1232,644,588,1999-1-21,56
1999,1,22,1428,756,672,1999-1-22,84
1999,1,23,1064,504,560,1999-1-23,-56
1999,1,24,714,350,364,1999-1-24,-14
1999,1,25,406,266,140,1999-1-25,126
1999,1,26,140,140,0,1999-1-26,140
1999,1,27,98,84,14,1999-1-27,70
1999,1,28,28,28,0,1999-1-28,28
1999,1,29,42,42,0,1999-1-29,42
1999,1,30,238,238,0,1999-1-30,238
1999,1,31,294,294,0,1999-1-31,294
1999,2,1,112,112,0,1999-2-1,112
1999,2,2,42,0,42,1999-2-2,-42
1999,2,3,140,14,126,1999-2-3,-112
1999,2,4,266,0,266,1999-2-4,-266
1999,2,5,28,0,28,1999-2-5,-28
1999,2,6,70,0,70,1999-2-6,-70
1999,2,7,28,0,28,1999-2-7,-28
1999,2,8,588,210,378,1999-2-8,-168
1999,2,9,868,322,546,1999-2-9,-224
1999,2,10,1554,588,966,1999-2-10,-378
1999,2,11,1778,714,1064,1999-2-11,-350
1999,2,12,1918,868,1050,1999-2-12,-182
1999,2,13,2226,1302,924,1999-2-13,378
1999,2,14,2254,1204,1050,1999-2-14,154
1999,2,15,2394,1190,1204,1999-2-15,-14
1999,2,16,2324,1218,1106,1999-2-16,112
1999,2,17,2044,910,1134,1999-2-17,-224
1999,2,18,1890,812,1078,1999-2-18,-266
1999,2,19,1820,714,1106,1999-2-19,-392
1999,2,20,1428,588,840,1999-2-20,-252
1999,2,21,868,294,574,1999-2-21,-280
1999,2,22,280,238,42,1999-2-22,196
1999,2,23,280,154,126,1999-2-23,28
1999,2,24,182,98,84,1999-2-24,14
1999,2,25,98,42,56,1999-2-25,-14
1999,2,26,224,168,56,1999-2-26,112
1999,2,27,196,140,56,1999-2-27,84
1999,2,28,336,266,70,1999-2-28,196
1999,3,1,518,350,168,1999-3-1,182
1999,3,2,756,546,210,1999-3-2,336
1999,3,3,882,658,224,1999-3-3,434
1999,3,4,924,672,252,1999-3-4,420
1999,3,5,910,644,266,1999-3-5,378
1999,3,6,742,504,238,1999-3-6,266
1999,3,7,588,350,238,1999-3-7,112
1999,3,8,742,252,490,1999-3-8,-238
1999,3,9,728,280,448,1999-3-9,-168
1999,3,10,826,350,476,1999-3-10,-126
1999,3,11,980,434,546,1999-3-11,-112
1999,3,12,1022,560,462,1999-3-12,98
1999,3,13,1064,728,336,1999-3-13,392
1999,3,14,1358,994,364,1999-3-14,630
1999,3,15,1120,1064,56,1999-3-15,1008
1999,3,16,1260,1176,84,1999-3-16,1092
1999,3,17,1148,1064,84,1999-3-17,980
1999,3,18,896,728,168,1999-3-18,560
1999,3,19,770,560,210,1999-3-19,350
1999,3,20,308,182,126,1999-3-20,56
1999,3,21,322,154,168,1999-3-21,-14
1999,3,22,224,154,70,1999-3-22,84
1999,3,23,126,126,0,1999-3-23,126
1999,3,24,252,210,42,1999-3-24,168
1999,3,25,294,294,0,1999-3-25,294
1999,3,26,168,168,0,1999-3-26,168
1999,3,27,182,182,0,1999-3-27,182
1999,3,28,238,224,14,1999-3-28,210
1999,3,29,350,210,140,1999-3-29,70
1999,3,30,378,140,238,1999-3-30,-98
1999,3,31,252,112,140,1999-3-31,-28
1999,4,1,308,154,154,1999-4-1,0
1999,4,2,252,154,98,1999-4-2,56
1999,4,3,224,112,112,1999-4-3,0
1999,4,4,350,140,210,1999-4-4,-70
1999,4,5,784,308,476,1999-4-5,-168
1999,4,6,756,196,560,1999-4-6,-364
1999,4,7,784,280,504,1999-4-7,-224
1999,4,8,714,364,350,1999-4-8,14
1999,4,9,742,294,448,1999-4-9,-154
1999,4,10,658,294,364,1999-4-10,-70
1999,4,11,518,182,336,1999-4-11,-154
1999,4,12,378,98,280,1999-4-12,-182
1999,4,13,294,56,238,1999-4-13,-182
1999,4,14,280,14,266,1999-4-14,-252
1999,4,15,168,0,168,1999-4-15,-168
1999,4,16,280,28,252,1999-4-16,-224
1999,4,17,420,56,364,1999-4-17,-308
1999,4,18,308,42,266,1999-4-18,-224
1999,4,19,378,126,252,1999-4-19,-126
1999,4,20,434,154,280,1999-4-20,-126
1999,4,21,392,98,294,1999-4-21,-196
1999,4,22,336,42,294,1999-4-22,-252
1999,4,23,322,56,266,1999-4-23,-210
1999,4,24,224,28,196,1999-4-24,-168
1999,4,25,378,266,112,1999-4-25,154
1999,4,26,560,434,126,1999-4-26,308
1999,4,27,588,490,98,1999-4-27,392
1999,4,28,616,518,98,1999-4-28,420
1999,4,29,700,616,84,1999-4-29,532
1999,4,30,658,658,0,1999-4-30,658
1999,5,1,658,658,0,1999-5-1,658
1999,5,2,700,686,14,1999-5-2,672
1999,5,3,518,504,14,1999-5-3,490
1999,5,4,448,420,28,1999-5-4,392
1999,5,5,532,434,98,1999-5-5,336
1999,5,6,798,686,112,1999-5-6,574
1999,5,7,966,784,182,1999-5-7,602
1999,5,8,2100,1722,378,1999-5-8,1344
1999,5,9,1526,1246,280,1999-5-9,966
1999,5,10,1260,938,322,1999-5-10,616
1999,5,11,1190,924,266,1999-5-11,658
1999,5,12,826,560,266,1999-5-12,294
1999,5,13,840,644,196,1999-5-13,448
1999,5,14,952,700,252,1999-5-14,448
1999,5,15,1316,1008,308,1999-5-15,700
1999,5,16,1428,1050,378,1999-5-16,672
1999,5,17,1666,1190,476,1999-5-17,714
1999,5,18,1358,1036,322,1999-5-18,714
1999,5,19,882,630,252,1999-5-19,378
1999,5,20,1092,616,476,1999-5-20,140
1999,5,21,1624,896,728,1999-5-21,168
1999,5,22,1470,742,728,1999-5-22,14
1999,5,23,994,462,532,1999-5-23,-70
1999,5,24,1442,826,616,1999-5-24,210
1999,5,25,1274,882,392,1999-5-25,490
1999,5,26,1386,1022,364,1999-5-26,658
1999,5,27,1218,924,294,1999-5-27,630
1999,5,28,1036,812,224,1999-5-28,588
1999,5,29,1190,896,294,1999-5-29,602
1999,5,30,1470,1260,210,1999-5-30,1050
1999,5,31,1386,1218,168,1999-5-31,1050
1999,6,1,1820,1484,336,1999-6-1,1148
1999,6,2,2366,1764,602,1999-6-2,1162
1999,6,3,2506,1848,658,1999-6-3,1190
1999,6,4,2086,1372,714,1999-6-4,658
1999,6,5,1554,812,742,1999-6-5,70
1999,6,6,1260,504,756,1999-6-6,-252
1999,6,7,1582,770,812,1999-6-7,-42
1999,6,8,1414,700,714,1999-6-8,-14
1999,6,9,1540,910,630,1999-6-9,280
1999,6,10,1428,910,518,1999-6-10,392
1999,6,11,1442,798,644,1999-6-11,154
1999,6,12,1736,1008,728,1999-6-12,280
1999,6,13,1876,1134,742,1999-6-13,392
1999,6,14,2156,1344,812,1999-6-14,532
1999,6,15,1778,1078,700,1999-6-15,378
1999,6,16,1316,658,658,1999-6-16,0
1999,6,17,1148,504,644,1999-6-17,-140
1999,6,18,742,392,350,1999-6-18,42
1999,6,19,868,574,294,1999-6-19,280
1999,6,20,1456,1218,238,1999-6-20,980
1999,6,21,1470,1330,140,1999-6-21,1190
1999,6,22,1414,1274,140,1999-6-22,1134
1999,6,23,1400,1162,238,1999-6-23,924
1999,6,24,2142,1708,434,1999-6-24,1274
1999,6,25,2758,2142,616,1999-6-25,1526
1999,6,26,2590,2030,560,1999-6-26,1470
1999,6,27,2380,1680,700,1999-6-27,980
1999,6,28,1624,1092,532,1999-6-28,560
1999,6,29,1540,910,630,1999-6-29,280
1999,6,30,1316,714,602,1999-6-30,112
1999,7,1,1554,770,784,1999-7-1,-14
1999,7,2,1778,826,952,1999-7-2,-126
1999,7,3,1960,770,1190,1999-7-3,-420
1999,7,4,2086,826,1260,1999-7-4,-434
1999,7,5,1834,784,1050,1999-7-5,-266
1999,7,6,1820,966,854,1999-7-6,112
1999,7,7,1792,924,868,1999-7-7,56
1999,7,8,1302,546,756,1999-7-8,-210
1999,7,9,1428,588,840,1999-7-9,-252
1999,7,10,1162,616,546,1999-7-10,70
1999,7,11,1554,686,868,1999-7-11,-182
1999,7,12,1582,812,770,1999-7-12,42
1999,7,13,1316,672,644,1999-7-13,28
1999,7,14,770,476,294,1999-7-14,182
1999,7,15,602,392,210,1999-7-15,182
1999,7,16,952,630,322,1999-7-16,308
1999,7,17,672,350,322,1999-7-17,28
1999,7,18,1036,728,308,1999-7-18,420
1999,7,19,868,686,182,1999-7-19,504
1999,7,20,770,728,42,1999-7-20,686
1999,7,21,812,784,28,1999-7-21,756
1999,7,22,1554,1498,56,1999-7-22,1442
1999,7,23,1694,1568,126,1999-7-23,1442
1999,7,24,1778,1414,364,1999-7-24,1050
1999,7,25,1946,1260,686,1999-7-25,574
1999,7,26,1834,896,938,1999-7-26,-42
1999,7,27,2128,1092,1036,1999-7-27,56
1999,7,28,2156,1134,1022,1999-7-28,112
1999,7,29,2128,1050,1078,1999-7-29,-28
1999,7,30,2268,1078,1190,1999-7-30,-112
1999,7,31,2408,1344,1064,1999-7-31,280
1999,8,1,2366,1484,882,1999-8-1,602
1999,8,2,2982,2030,952,1999-8-2,1078
1999,8,3,2954,1652,1302,1999-8-3,350
1999,8,4,2758,1554,1204,1999-8-4,350
1999,8,5,1904,1274,630,1999-8-5,644
1999,8,6,1442,1106,336,1999-8-6,770
1999,8,7,1302,966,336,1999-8-7,630
1999,8,8,1008,672,336,1999-8-8,336
1999,8,9,770,294,476,1999-8-9,-182
1999,8,10,504,14,490,1999-8-10,-476
1999,8,11,560,0,560,1999-8-11,-560
1999,8,12,448,70,378,1999-8-12,-308
1999,8,13,616,266,350,1999-8-13,-84
1999,8,14,728,504,224,1999-8-14,280
1999,8,15,742,546,196,1999-8-15,350
1999,8,16,686,588,98,1999-8-16,490
1999,8,17,644,546,98,1999-8-17,448
1999,8,18,630,602,28,1999-8-18,574
1999,8,19,686,546,140,1999-8-19,406
1999,8,20,1078,434,644,1999-8-20,-210
1999,8,21,1456,336,1120,1999-8-21,-784
1999,8,22,1638,336,1302,1999-8-22,-966
1999,8,23,1736,322,1414,1999-8-23,-1092
1999,8,24,1442,294,1148,1999-8-24,-854
1999,8,25,1372,322,1050,1999-8-25,-728
1999,8,26,1582,322,1260,1999-8-26,-938
1999,8,27,2030,266,1764,1999-8-27,-1498
1999,8,28,1960,364,1596,1999-8-28,-1232
1999,8,29,2198,784,1414,1999-8-29,-630
1999,8,30,1834,770,1064,1999-8-30,-294
1999,8,31,1260,602,658,1999-8-31,-56
1999,9,1,1036,490,546,1999-9-1,-56
1999,9,2,518,420,98,1999-9-2,322
1999,9,3,336,294,42,1999-9-3,252
1999,9,4,406,392,14,1999-9-4,378
1999,9,5,322,308,14,1999-9-5,294
1999,9,6,252,252,0,1999-9-6,252
1999,9,7,420,252,168,1999-9-7,84
1999,9,8,616,266,350,1999-9-8,-84
1999,9,9,714,210,504,1999-9-9,-294
1999,9,10,644,182,462,1999-9-10,-280
1999,9,11,728,322,406,1999-9-11,-84
1999,9,12,756,434,322,1999-9-12,112
1999,9,13,1120,756,364,1999-9-13,392
1999,9,14,1190,910,280,1999-9-14,630
1999,9,15,1232,1008,224,1999-9-15,784
1999,9,16,1442,1204,238,1999-9-16,966
1999,9,17,1302,966,336,1999-9-17,630
1999,9,18,938,616,322,1999-9-18,294
1999,9,19,798,462,336,1999-9-19,126
1999,9,20,490,336,154,1999-9-20,182
1999,9,21,392,210,182,1999-9-21,28
1999,9,22,406,182,224,1999-9-22,-42
1999,9,23,364,168,196,1999-9-23,-28
1999,9,24,364,140,224,1999-9-24,-84
1999,9,25,294,126,168,1999-9-25,-42
1999,9,26,308,154,154,1999-9-26,0
1999,9,27,308,168,140,1999-9-27,28
1999,9,28,224,154,70,1999-9-28,84
1999,9,29,196,140,56,1999-9-29,84
1999,9,30,182,140,42,1999-9-30,98
1999,10,1,84,70,14,1999-10-1,56
1999,10,2,294,266,28,1999-10-2,238
1999,10,3,518,336,182,1999-10-3,154
1999,10,4,728,448,280,1999-10-4,168
1999,10,5,980,560,420,1999-10-5,140
1999,10,6,882,518,364,1999-10-6,154
1999,10,7,784,462,322,1999-10-7,140
1999,10,8,784,518,266,1999-10-8,252
1999,10,9,826,574,252,1999-10-9,322
1999,10,10,1064,896,168,1999-10-10,728
1999,10,11,1498,1330,168,1999-10-11,1162
1999,10,12,1834,1708,126,1999-10-12,1582
1999,10,13,2436,2338,98,1999-10-13,2240
1999,10,14,1946,1932,14,1999-10-14,1918
1999,10,15,1918,1918,0,1999-10-15,1918
1999,10,16,2142,2142,0,1999-10-16,2142
1999,10,17,2422,2408,14,1999-10-17,2394
1999,10,18,1904,1904,0,1999-10-18,1904
1999,10,19,1442,1372,70,1999-10-19,1302
1999,10,20,1232,1050,182,1999-10-20,868
1999,10,21,1260,840,420,1999-10-21,420
1999,10,22,1190,336,854,1999-10-22,-518
1999,10,23,1666,378,1288,1999-10-23,-910
1999,10,24,1792,434,1358,1999-10-24,-924
1999,10,25,2394,672,1722,1999-10-25,-1050
1999,10,26,2814,686,2128,1999-10-26,-1442
1999,10,27,2436,812,1624,1999-10-27,-812
1999,10,28,2030,714,1316,1999-10-28,-602
1999,10,29,2142,882,1260,1999-10-29,-378
1999,10,30,1974,910,1064,1999-10-30,-154
1999,10,31,1386,588,798,1999-10-31,-210
1999,11,1,1428,462,966,1999-11-1,-504
1999,11,2,952,364,588,1999-11-2,-224
1999,11,3,616,280,336,1999-11-3,-56
1999,11,4,784,322,462,1999-11-4,-140
1999,11,5,1134,560,574,1999-11-5,-14
1999,11,6,1162,672,490,1999-11-6,182
1999,11,7,1400,1162,238,1999-11-7,924
1999,11,8,2016,1932,84,1999-11-8,1848
1999,11,9,2394,2352,42,1999-11-9,2310
1999,11,10,2800,2604,196,1999-11-10,2408
1999,11,11,2926,2450,476,1999-11-11,1974
1999,11,12,2380,1694,686,1999-11-12,1008
1999,11,13,2352,1568,784,1999-11-13,784
1999,11,14,2464,1470,994,1999-11-14,476
1999,11,15,2842,1554,1288,1999-11-15,266
1999,11,16,3150,1624,1526,1999-11-16,98
1999,11,17,3206,1204,2002,1999-11-17,-798
1999,11,18,3164,868,2296,1999-11-18,-1428
1999,11,19,2758,742,2016,1999-11-19,-1274
1999,11,20,2198,476,1722,1999-11-20,-1246
1999,11,21,1806,308,1498,1999-11-21,-1190
1999,11,22,1876,322,1554,1999-11-22,-1232
1999,11,23,1708,168,1540,1999-11-23,-1372
1999,11,24,1526,28,1498,1999-11-24,-1470
1999,11,25,1540,14,1526,1999-11-25,-1512
1999,11,26,1442,0,1442,1999-11-26,-1442
1999,11,27,1624,28,1596,1999-11-27,-1568
1999,11,28,1022,56,966,1999-11-28,-910
1999,11,29,686,126,560,1999-11-29,-434
1999,11,30,798,266,532,1999-11-30,-266
1999,12,1,1050,434,616,1999-12-1,-182
1999,12,2,1750,1092,658,1999-12-2,434
1999,12,3,1232,966,266,1999-12-3,700
1999,12,4,1288,1064,224,1999-12-4,840
1999,12,5,1092,896,196,1999-12-5,700
1999,12,6,1078,1008,70,1999-12-6,938
1999,12,7,1064,1050,14,1999-12-7,1036
1999,12,8,1204,1190,14,1999-12-8,1176
1999,12,9,1232,1134,98,1999-12-9,1036
1999,12,10,1176,1008,168,1999-12-10,840
1999,12,11,1050,910,140,1999-12-11,770
1999,12,12,798,700,98,1999-12-12,602
1999,12,13,616,518,98,1999-12-13,420
1999,12,14,686,266,420,1999-12-14,-154
1999,12,15,756,126,630,1999-12-15,-504
1999,12,16,994,14,980,1999-12-16,-966
1999,12,17,1652,462,1190,1999-12-17,-728
1999,12,18,2058,924,1134,1999-12-18,-210
1999,12,19,2450,1302,1148,1999-12-19,154
1999,12,20,2604,1512,1092,1999-12-20,420
1999,12,21,2408,1358,1050,1999-12-21,308
1999,12,22,2408,1512,896,1999-12-22,616
1999,12,23,2492,1568,924,1999-12-23,644
1999,12,24,2366,1554,812,1999-12-24,742
1999,12,25,2212,1568,644,1999-12-25,924
1999,12,26,2170,1806,364,1999-12-26,1442
1999,12,27,2030,1764,266,1999-12-27,1498
1999,12,28,1582,1344,238,1999-12-28,1106
1999,12,29,1442,1218,224,1999-12-29,994
1999,12,30,742,686,56,1999-12-30,630
1999,12,31,742,686,56,1999-12-31,630
2000,1,1,756,686,70,2000-1-1,616
2000,1,2,644,560,84,2000-1-2,476
2000,1,3,672,490,182,2000-1-3,308
2000,1,4,644,448,196,2000-1-4,252
2000,1,5,574,392,182,2000-1-5,210
2000,1,6,742,476,266,2000-1-6,210
2000,1,7,700,476,224,2000-1-7,252
2000,1,8,644,392,252,2000-1-8,140
2000,1,9,686,336,350,2000-1-9,-14
2000,1,10,658,224,434,2000-1-10,-210
2000,1,11,938,462,476,2000-1-11,-14
2000,1,12,1302,602,700,2000-1-12,-98
2000,1,13,1568,602,966,2000-1-13,-364
2000,1,14,1554,588,966,2000-1-14,-378
2000,1,15,1736,574,1162,2000-1-15,-588
2000,1,16,1610,532,1078,2000-1-16,-546
2000,1,17,1442,476,966,2000-1-17,-490
2000,1,18,1176,532,644,2000-1-18,-112
2000,1,19,1078,532,546,2000-1-19,-14
2000,1,20,1078,448,630,2000-1-20,-182
2000,1,21,1596,490,1106,2000-1-21,-616
2000,1,22,1162,392,770,2000-1-22,-378
2000,1,23,896,350,546,2000-1-23,-196
2000,1,24,616,280,336,2000-1-24,-56
2000,1,25,686,294,392,2000-1-25,-98
2000,1,26,770,462,308,2000-1-26,154
2000,1,27,588,294,294,2000-1-27,0
2000,1,28,812,392,420,2000-1-28,-28
2000,1,29,686,280,406,2000-1-29,-126
2000,1,30,364,28,336,2000-1-30,-308
2000,1,31,364,126,238,2000-1-31,-112
2000,2,1,490,224,266,2000-2-1,-42
2000,2,2,588,196,392,2000-2-2,-196
2000,2,3,896,266,630,2000-2-3,-364
2000,2,4,882,434,448,2000-2-4,-14
2000,2,5,1050,532,518,2000-2-5,14
2000,2,6,812,308,504,2000-2-6,-196
2000,2,7,994,560,434,2000-2-7,126
2000,2,8,1078,588,490,2000-2-8,98
2000,2,9,1036,616,420,2000-2-9,196
2000,2,10,1022,630,392,2000-2-10,238
2000,2,11,1106,490,616,2000-2-11,-126
2000,2,12,756,140,616,2000-2-12,-476
2000,2,13,728,140,588,2000-2-13,-448
2000,2,14,658,112,546,2000-2-14,-434
2000,2,15,616,140,476,2000-2-15,-336
2000,2,16,966,266,700,2000-2-16,-434
2000,2,17,938,252,686,2000-2-17,-434
2000,2,18,980,364,616,2000-2-18,-252
2000,2,19,826,378,448,2000-2-19,-70
2000,2,20,1176,406,770,2000-2-20,-364
2000,2,21,1428,406,1022,2000-2-21,-616
2000,2,22,1470,420,1050,2000-2-22,-630
2000,2,23,1288,588,700,2000-2-23,-112
2000,2,24,1806,966,840,2000-2-24,126
2000,2,25,2716,1176,1540,2000-2-25,-364
2000,2,26,3094,1148,1946,2000-2-26,-798
2000,2,27,3514,1120,2394,2000-2-27,-1274
2000,2,28,3808,1036,2772,2000-2-28,-1736
2000,2,29,4172,1078,3094,2000-2-29,-2016
2000,3,1,3598,896,2702,2000-3-1,-1806
2000,3,2,3528,476,3052,2000-3-2,-2576
2000,3,3,2856,364,2492,2000-3-3,-2128
2000,3,4,2296,308,1988,2000-3-4,-1680
2000,3,5,2450,294,2156,2000-3-5,-1862
2000,3,6,2142,168,1974,2000-3-6,-1806
2000,3,7,2282,14,2268,2000-3-7,-2254
2000,3,8,2702,42,2660,2000-3-8,-2618
2000,3,9,2226,70,2156,2000-3-9,-2086
2000,3,10,2282,140,2142,2000-3-10,-2002
2000,3,11,2128,182,1946,2000-3-11,-1764
2000,3,12,2240,434,1806,2000-3-12,-1372
2000,3,13,2114,350,1764,2000-3-13,-1414
2000,3,14,2226,602,1624,2000-3-14,-1022
2000,3,15,1526,364,1162,2000-3-15,-798
2000,3,16,1526,462,1064,2000-3-16,-602
2000,3,17,1666,644,1022,2000-3-17,-378
2000,3,18,2002,1190,812,2000-3-18,378
2000,3,19,2408,1568,840,2000-3-19,728
2000,3,20,2562,1904,658,2000-3-20,1246
2000,3,21,2548,2072,476,2000-3-21,1596
2000,3,22,3626,2828,798,2000-3-22,2030
2000,3,23,2884,2114,770,2000-3-23,1344
2000,3,24,2408,1400,1008,2000-3-24,392
2000,3,25,1386,714,672,2000-3-25,42
2000,3,26,1946,1050,896,2000-3-26,154
2000,3,27,1680,924,756,2000-3-27,168
2000,3,28,1750,980,770,2000-3-28,210
2000,3,29,1274,658,616,2000-3-29,42
2000,3,30,1274,546,728,2000-3-30,-182
2000,3,31,1330,546,784,2000-3-31,-238
2000,4,1,1974,910,1064,2000-4-1,-154
2000,4,2,2380,1078,1302,2000-4-2,-224
2000,4,3,1540,728,812,2000-4-3,-84
2000,4,4,1652,826,826,2000-4-4,0
2000,4,5,1456,686,770,2000-4-5,-84
2000,4,6,868,280,588,2000-4-6,-308
2000,4,7,1022,322,700,2000-4-7,-378
2000,4,8,1064,378,686,2000-4-8,-308
2000,4,9,882,280,602,2000-4-9,-322
2000,4,10,826,196,630,2000-4-10,-434
2000,4,11,882,182,700,2000-4-11,-518
2000,4,12,1148,224,924,2000-4-12,-700
2000,4,13,1442,392,1050,2000-4-13,-658
2000,4,14,1204,350,854,2000-4-14,-504
2000,4,15,1078,322,756,2000-4-15,-434
2000,4,16,1050,378,672,2000-4-16,-294
2000,4,17,952,322,630,2000-4-17,-308
2000,4,18,952,322,630,2000-4-18,-308
2000,4,19,994,476,518,2000-4-19,-42
2000,4,20,1554,616,938,2000-4-20,-322
2000,4,21,2422,1008,1414,2000-4-21,-406
2000,4,22,3304,1512,1792,2000-4-22,-280
2000,4,23,4004,1918,2086,2000-4-23,-168
2000,4,24,3752,2030,1722,2000-4-24,308
2000,4,25,3528,1862,1666,2000-4-25,196
2000,4,26,3542,1862,1680,2000-4-26,182
2000,4,27,2828,1400,1428,2000-4-27,-28
2000,4,28,3108,1540,1568,2000-4-28,-28
2000,4,29,2282,1078,1204,2000-4-29,-126
2000,4,30,2198,1148,1050,2000-4-30,98
2000,5,1,2142,1246,896,2000-5-1,350
2000,5,2,1764,1134,630,2000-5-2,504
2000,5,3,994,602,392,2000-5-3,210
2000,5,4,322,126,196,2000-5-4,-70
2000,5,5,210,98,112,2000-5-5,-14
2000,5,6,196,70,126,2000-5-6,-56
2000,5,7,182,112,70,2000-5-7,42
2000,5,8,280,238,42,2000-5-8,196
2000,5,9,546,490,56,2000-5-9,434
2000,5,10,868,700,168,2000-5-10,532
2000,5,11,1372,882,490,2000-5-11,392
2000,5,12,2100,1036,1064,2000-5-12,-28
2000,5,13,3598,1232,2366,2000-5-13,-1134
2000,5,14,3794,1190,2604,2000-5-14,-1414
2000,5,15,4914,2030,2884,2000-5-15,-854
2000,5,16,4830,1918,2912,2000-5-16,-994
2000,5,17,4466,1778,2688,2000-5-17,-910
2000,5,18,4228,1554,2674,2000-5-18,-1120
2000,5,19,3864,1792,2072,2000-5-19,-280
2000,5,20,4088,2226,1862,2000-5-20,364
2000,5,21,4130,2310,1820,2000-5-21,490
2000,5,22,3010,1806,1204,2000-5-22,602
2000,5,23,2156,1414,742,2000-5-23,672
2000,5,24,2674,1680,994,2000-5-24,686
2000,5,25,2030,1218,812,2000-5-25,406
2000,5,26,1834,924,910,2000-5-26,14
2000,5,27,1456,546,910,2000-5-27,-364
2000,5,28,1610,266,1344,2000-5-28,-1078
2000,5,29,1554,238,1316,2000-5-29,-1078
2000,5,30,1288,154,1134,2000-5-30,-980
2000,5,31,1148,84,1064,2000-5-31,-980
2000,6,1,1330,406,924,2000-6-1,-518
2000,6,2,1904,1022,882,2000-6-2,140
2000,6,3,2142,1316,826,2000-6-3,490
2000,6,4,2072,1288,784,2000-6-4,504
2000,6,5,2002,1358,644,2000-6-5,714
2000,6,6,2338,1554,784,2000-6-6,770
2000,6,7,1932,1512,420,2000-6-7,1092
2000,6,8,1988,1400,588,2000-6-8,812
2000,6,9,1848,1428,420,2000-6-9,1008
2000,6,10,1624,1148,476,2000-6-10,672
2000,6,11,2016,1442,574,2000-6-11,868
2000,6,12,2492,1946,546,2000-6-12,1400
2000,6,13,2450,2016,434,2000-6-13,1582
2000,6,14,2702,2212,490,2000-6-14,1722
2000,6,15,2674,2212,462,2000-6-15,1750
2000,6,16,2926,2380,546,2000-6-16,1834
2000,6,17,2394,1806,588,2000-6-17,1218
2000,6,18,2030,1694,336,2000-6-18,1358
2000,6,19,1848,1554,294,2000-6-19,1260
2000,6,20,2016,1540,476,2000-6-20,1064
2000,6,21,1722,1162,560,2000-6-21,602
2000,6,22,1764,1092,672,2000-6-22,420
2000,6,23,1834,1036,798,2000-6-23,238
2000,6,24,1708,980,728,2000-6-24,252
2000,6,25,1568,742,826,2000-6-25,-84
2000,6,26,2016,980,1036,2000-6-26,-56
2000,6,27,2268,966,1302,2000-6-27,-336
2000,6,28,2408,1050,1358,2000-6-28,-308
2000,6,29,2492,1050,1442,2000-6-29,-392
2000,6,30,2296,1106,1190,2000-6-30,-84
2000,7,1,1932,742,1190,2000-7-1,-448
2000,7,2,1820,546,1274,2000-7-2,-728
2000,7,3,1652,462,1190,2000-7-3,-728
2000,7,4,1456,406,1050,2000-7-4,-644
2000,7,5,1414,490,924,2000-7-5,-434
2000,7,6,1638,560,1078,2000-7-6,-518
2000,7,7,1610,714,896,2000-7-7,-182
2000,7,8,2436,1134,1302,2000-7-8,-168
2000,7,9,3136,1666,1470,2000-7-9,196
2000,7,10,3388,1862,1526,2000-7-10,336
2000,7,11,3808,2254,1554,2000-7-11,700
2000,7,12,4130,2674,1456,2000-7-12,1218
2000,7,13,3570,2240,1330,2000-7-13,910
2000,7,14,2184,1246,938,2000-7-14,308
2000,7,15,1568,1064,504,2000-7-15,560
2000,7,16,1834,1386,448,2000-7-16,938
2000,7,17,2660,1862,798,2000-7-17,1064
2000,7,18,3010,1918,1092,2000-7-18,826
2000,7,19,3346,2268,1078,2000-7-19,1190
2000,7,20,3990,2562,1428,2000-7-20,1134
2000,7,21,3738,2380,1358,2000-7-21,1022
2000,7,22,2996,1848,1148,2000-7-22,700
2000,7,23,2842,1680,1162,2000-7-23,518
2000,7,24,2548,1498,1050,2000-7-24,448
2000,7,25,2394,1498,896,2000-7-25,602
2000,7,26,1946,1190,756,2000-7-26,434
2000,7,27,1358,980,378,2000-7-27,602
2000,7,28,1176,784,392,2000-7-28,392
2000,7,29,1246,630,616,2000-7-29,14
2000,7,30,952,448,504,2000-7-30,-56
2000,7,31,882,392,490,2000-7-31,-98
2000,8,1,910,406,504,2000-8-1,-98
2000,8,2,840,378,462,2000-8-2,-84
2000,8,3,756,420,336,2000-8-3,84
2000,8,4,854,504,350,2000-8-4,154
2000,8,5,1190,756,434,2000-8-5,322
2000,8,6,1106,658,448,2000-8-6,210
2000,8,7,994,588,406,2000-8-7,182
2000,8,8,1400,1064,336,2000-8-8,728
2000,8,9,1274,952,322,2000-8-9,630
2000,8,10,1078,840,238,2000-8-10,602
2000,8,11,1176,966,210,2000-8-11,756
2000,8,12,1218,980,238,2000-8-12,742
2000,8,13,1218,1022,196,2000-8-13,826
2000,8,14,1358,1064,294,2000-8-14,770
2000,8,15,1316,854,462,2000-8-15,392
2000,8,16,1148,644,504,2000-8-16,140
2000,8,17,1120,476,644,2000-8-17,-168
2000,8,18,1316,672,644,2000-8-18,28
2000,8,19,1008,504,504,2000-8-19,0
2000,8,20,854,322,532,2000-8-20,-210
2000,8,21,798,252,546,2000-8-21,-294
2000,8,22,672,154,518,2000-8-22,-364
2000,8,23,630,154,476,2000-8-23,-322
2000,8,24,784,378,406,2000-8-24,-28
2000,8,25,882,420,462,2000-8-25,-42
2000,8,26,770,308,462,2000-8-26,-154
2000,8,27,1106,434,672,2000-8-27,-238
2000,8,28,1456,742,714,2000-8-28,28
2000,8,29,1582,1036,546,2000-8-29,490
2000,8,30,1386,1008,378,2000-8-30,630
2000,8,31,1358,1064,294,2000-8-31,770
2000,9,1,1274,1064,210,2000-9-1,854
2000,9,2,1064,910,154,2000-9-2,756
2000,9,3,798,574,224,2000-9-3,350
2000,9,4,756,434,322,2000-9-4,112
2000,9,5,1078,476,602,2000-9-5,-126
2000,9,6,1386,588,798,2000-9-6,-210
2000,9,7,1442,644,798,2000-9-7,-154
2000,9,8,1554,742,812,2000-9-8,-70
2000,9,9,1246,644,602,2000-9-9,42
2000,9,10,350,56,294,2000-9-10,-238
2000,9,11,182,14,168,2000-9-11,-154
2000,9,12,42,0,42,2000-9-12,-42
2000,9,13,112,14,98,2000-9-13,-84
2000,9,14,518,196,322,2000-9-14,-126
2000,9,15,1176,616,560,2000-9-15,56
2000,9,16,1120,616,504,2000-9-16,112
2000,9,17,1190,672,518,2000-9-17,154
2000,9,18,2856,2058,798,2000-9-18,1260
2000,9,19,4634,3696,938,2000-9-19,2758
2000,9,20,3920,3094,826,2000-9-20,2268
2000,9,21,4060,2940,1120,2000-9-21,1820
2000,9,22,3878,2870,1008,2000-9-22,1862
2000,9,23,3752,2954,798,2000-9-23,2156
2000,9,24,3654,2884,770,2000-9-24,2114
2000,9,25,3136,2282,854,2000-9-25,1428
2000,9,26,2884,1932,952,2000-9-26,980
2000,9,27,2590,1876,714,2000-9-27,1162
2000,9,28,1960,1204,756,2000-9-28,448
2000,9,29,2142,1092,1050,2000-9-29,42
2000,9,30,1414,420,994,2000-9-30,-574
2000,10,1,1232,168,1064,2000-10-1,-896
2000,10,2,1764,294,1470,2000-10-2,-1176
2000,10,3,1694,196,1498,2000-10-3,-1302
2000,10,4,1736,476,1260,2000-10-4,-784
2000,10,5,1344,350,994,2000-10-5,-644
2000,10,6,1148,448,700,2000-10-6,-252
2000,10,7,742,252,490,2000-10-7,-238
2000,10,8,966,308,658,2000-10-8,-350
2000,10,9,742,224,518,2000-10-9,-294
2000,10,10,490,280,210,2000-10-10,70
2000,10,11,756,560,196,2000-10-11,364
2000,10,12,938,588,350,2000-10-12,238
2000,10,13,1064,630,434,2000-10-13,196
2000,10,14,882,532,350,2000-10-14,182
2000,10,15,672,266,406,2000-10-15,-140
2000,10,16,672,224,448,2000-10-16,-224
2000,10,17,756,294,462,2000-10-17,-168
2000,10,18,672,280,392,2000-10-18,-112
2000,10,19,532,308,224,2000-10-19,84
2000,10,20,882,616,266,2000-10-20,350
2000,10,21,742,560,182,2000-10-21,378
2000,10,22,672,434,238,2000-10-22,196
2000,10,23,574,364,210,2000-10-23,154
2000,10,24,658,434,224,2000-10-24,210
2000,10,25,840,280,560,2000-10-25,-280
2000,10,26,742,154,588,2000-10-26,-434
2000,10,27,672,70,602,2000-10-27,-532
2000,10,28,1134,602,532,2000-10-28,70
2000,10,29,1526,728,798,2000-10-29,-70
2000,10,30,1218,630,588,2000-10-30,42
2000,10,31,952,476,476,2000-10-31,0
2000,11,1,1316,784,532,2000-11-1,252
2000,11,2,1498,980,518,2000-11-2,462
2000,11,3,1526,1092,434,2000-11-3,658
2000,11,4,1554,1008,546,2000-11-4,462
2000,11,5,1372,798,574,2000-11-5,224
2000,11,6,1204,672,532,2000-11-6,140
2000,11,7,1036,658,378,2000-11-7,280
2000,11,8,1274,756,518,2000-11-8,238
2000,11,9,1022,560,462,2000-11-9,98
2000,11,10,1008,462,546,2000-11-10,-84
2000,11,11,770,308,462,2000-11-11,-154
2000,11,12,686,210,476,2000-11-12,-266
2000,11,13,966,336,630,2000-11-13,-294
2000,11,14,1232,392,840,2000-11-14,-448
2000,11,15,1260,378,882,2000-11-15,-504
2000,11,16,1302,490,812,2000-11-16,-322
2000,11,17,1064,406,658,2000-11-17,-252
2000,11,18,952,532,420,2000-11-18,112
2000,11,19,1246,868,378,2000-11-19,490
2000,11,20,1624,1036,588,2000-11-20,448
2000,11,21,1624,952,672,2000-11-21,280
2000,11,22,1610,980,630,2000-11-22,350
2000,11,23,1792,1148,644,2000-11-23,504
2000,11,24,1652,1134,518,2000-11-24,616
2000,11,25,1610,1302,308,2000-11-25,994
2000,11,26,1568,1358,210,2000-11-26,1148
2000,11,27,1568,1344,224,2000-11-27,1120
2000,11,28,1792,1512,280,2000-11-28,1232
2000,11,29,1820,1414,406,2000-11-29,1008
2000,11,30,1582,1050,532,2000-11-30,518
2000,12,1,980,546,434,2000-12-1,112
2000,12,2,784,462,322,2000-12-2,140
2000,12,3,882,532,350,2000-12-3,182
2000,12,4,686,532,154,2000-12-4,378
2000,12,5,448,294,154,2000-12-5,140
2000,12,6,504,336,168,2000-12-6,168
2000,12,7,644,266,378,2000-12-7,-112
2000,12,8,266,182,84,2000-12-8,98
2000,12,9,350,308,42,2000-12-9,266
2000,12,10,196,112,84,2000-12-10,28
2000,12,11,434,336,98,2000-12-11,238
2000,12,12,448,364,84,2000-12-12,280
2000,12,13,728,490,238,2000-12-13,252
2000,12,14,728,490,238,2000-12-14,252
2000,12,15,1386,854,532,2000-12-15,322
2000,12,16,1120,602,518,2000-12-16,84
2000,12,17,1540,924,616,2000-12-17,308
2000,12,18,966,434,532,2000-12-18,-98
2000,12,19,1260,700,560,2000-12-19,140
2000,12,20,1540,1078,462,2000-12-20,616
2000,12,21,1190,840,350,2000-12-21,490
2000,12,22,1428,952,476,2000-12-22,476
2000,12,23,1386,924,462,2000-12-23,462
2000,12,24,1512,1036,476,2000-12-24,560
2000,12,25,1204,686,518,2000-12-25,168
2000,12,26,1316,686,630,2000-12-26,56
2000,12,27,1470,560,910,2000-12-27,-350
2000,12,28,868,490,378,2000-12-28,112
2000,12,29,1820,434,1386,2000-12-29,-952
2000,12,30,1918,434,1484,2000-12-30,-1050
2000,12,31,1750,294,1456,2000-12-31,-1162
2001,1,1,1666,168,1498,2001-1-1,-1330
2001,1,2,1484,224,1260,2001-1-2,-1036
2001,1,3,1302,266,1036,2001-1-3,-770
2001,1,4,1260,308,952,2001-1-4,-644
2001,1,5,1456,630,826,2001-1-5,-196
2001,1,6,1484,532,952,2001-1-6,-420
2001,1,7,1246,616,630,2001-1-7,-14
2001,1,8,1092,672,420,2001-1-8,252
2001,1,9,784,630,154,2001-1-9,476
2001,1,10,672,644,28,2001-1-10,616
2001,1,11,826,798,28,2001-1-11,770
2001,1,12,994,938,56,2001-1-12,882
2001,1,13,1204,1176,28,2001-1-13,1148
2001,1,14,1246,1246,0,2001-1-14,1246
2001,1,15,1008,1008,0,2001-1-15,1008
2001,1,16,756,756,0,2001-1-16,756
2001,1,17,378,378,0,2001-1-17,378
2001,1,18,434,266,168,2001-1-18,98
2001,1,19,728,280,448,2001-1-19,-168
2001,1,20,728,112,616,2001-1-20,-504
2001,1,21,700,70,630,2001-1-21,-560
2001,1,22,798,140,658,2001-1-22,-518
2001,1,23,854,280,574,2001-1-23,-294
2001,1,24,1050,364,686,2001-1-24,-322
2001,1,25,756,168,588,2001-1-25,-420
2001,1,26,812,98,714,2001-1-26,-616
2001,1,27,812,168,644,2001-1-27,-476
2001,1,28,658,182,476,2001-1-28,-294
2001,1,29,532,140,392,2001-1-29,-252
2001,1,30,658,420,238,2001-1-30,182
2001,1,31,602,462,140,2001-1-31,322
2001,2,1,770,602,168,2001-2-1,434
2001,2,2,630,616,14,2001-2-2,602
2001,2,3,798,784,14,2001-2-3,770
2001,2,4,966,784,182,2001-2-4,602
2001,2,5,910,518,392,2001-2-5,126
2001,2,6,938,434,504,2001-2-6,-70
2001,2,7,924,462,462,2001-2-7,0
2001,2,8,756,392,364,2001-2-8,28
2001,2,9,980,518,462,2001-2-9,56
2001,2,10,770,294,476,2001-2-10,-182
2001,2,11,784,280,504,2001-2-11,-224
2001,2,12,658,280,378,2001-2-12,-98
2001,2,13,574,224,350,2001-2-13,-126
2001,2,14,602,252,350,2001-2-14,-98
2001,2,15,658,336,322,2001-2-15,14
2001,2,16,532,294,238,2001-2-16,56
2001,2,17,322,224,98,2001-2-17,126
2001,2,18,476,154,322,2001-2-18,-168
2001,2,19,434,84,350,2001-2-19,-266
2001,2,20,602,224,378,2001-2-20,-154
2001,2,21,658,224,434,2001-2-21,-210
2001,2,22,728,336,392,2001-2-22,-56
2001,2,23,742,280,462,2001-2-23,-182
2001,2,24,812,336,476,2001-2-24,-140
2001,2,25,672,238,434,2001-2-25,-196
2001,2,26,518,224,294,2001-2-26,-70
2001,2,27,280,224,56,2001-2-27,168
2001,2,28,252,154,98,2001-2-28,56
2001,3,1,112,70,42,2001-3-1,28
2001,3,2,196,84,112,2001-3-2,-28
2001,3,3,462,252,210,2001-3-3,42
2001,3,4,644,434,210,2001-3-4,224
2001,3,5,812,588,224,2001-3-5,364
2001,3,6,1344,1232,112,2001-3-6,1120
2001,3,7,1722,1666,56,2001-3-7,1610
2001,3,8,1498,1456,42,2001-3-8,1414
2001,3,9,1022,798,224,2001-3-9,574
2001,3,10,1148,686,462,2001-3-10,224
2001,3,11,1036,504,532,2001-3-11,-28
2001,3,12,952,350,602,2001-3-12,-252
2001,3,13,392,70,322,2001-3-13,-252
2001,3,14,378,28,350,2001-3-14,-322
2001,3,15,546,56,490,2001-3-15,-434
2001,3,16,574,168,406,2001-3-16,-238
2001,3,17,602,140,462,2001-3-17,-322
2001,3,18,392,84,308,2001-3-18,-224
2001,3,19,588,196,392,2001-3-19,-196
2001,3,20,756,336,420,2001-3-20,-84
2001,3,21,1316,882,434,2001-3-21,448
2001,3,22,1078,700,378,2001-3-22,322
2001,3,23,1694,1428,266,2001-3-23,1162
2001,3,24,2464,1596,868,2001-3-24,728
2001,3,25,2618,2044,574,2001-3-25,1470
2001,3,26,3206,2408,798,2001-3-26,1610
2001,3,27,3962,2898,1064,2001-3-27,1834
2001,3,28,5362,4032,1330,2001-3-28,2702
2001,3,29,5516,4326,1190,2001-3-29,3136
2001,3,30,5068,4018,1050,2001-3-30,2968
2001,3,31,4340,3500,840,2001-3-31,2660
2001,4,1,3962,3080,882,2001-4-1,2198
2001,4,2,3892,3164,728,2001-4-2,2436
2001,4,3,3640,2310,1330,2001-4-3,980
2001,4,4,2730,1288,1442,2001-4-4,-154
2001,4,5,2534,1008,1526,2001-4-5,-518
2001,4,6,2506,714,1792,2001-4-6,-1078
2001,4,7,2296,658,1638,2001-4-7,-980
2001,4,8,2100,588,1512,2001-4-8,-924
2001,4,9,1988,504,1484,2001-4-9,-980
2001,4,10,1302,280,1022,2001-4-10,-742
2001,4,11,1470,238,1232,2001-4-11,-994
2001,4,12,1442,168,1274,2001-4-12,-1106
2001,4,13,1218,168,1050,2001-4-13,-882
2001,4,14,1190,406,784,2001-4-14,-378
2001,4,15,1022,406,616,2001-4-15,-210
2001,4,16,462,294,168,2001-4-16,126
2001,4,17,224,112,112,2001-4-17,0
2001,4,18,392,364,28,2001-4-18,336
2001,4,19,1078,1050,28,2001-4-19,1022
2001,4,20,1246,1162,84,2001-4-20,1078
2001,4,21,2002,1428,574,2001-4-21,854
2001,4,22,1932,1358,574,2001-4-22,784
2001,4,23,1988,1470,518,2001-4-23,952
2001,4,24,2128,1596,532,2001-4-24,1064
2001,4,25,2142,1680,462,2001-4-25,1218
2001,4,26,1974,1456,518,2001-4-26,938
2001,4,27,2142,1652,490,2001-4-27,1162
2001,4,28,2072,1610,462,2001-4-28,1148
2001,4,29,1960,1722,238,2001-4-29,1484
2001,4,30,1750,1526,224,2001-4-30,1302
2001,5,1,1722,1512,210,2001-5-1,1302
2001,5,2,1652,1358,294,2001-5-2,1064
2001,5,3,1162,980,182,2001-5-3,798
2001,5,4,1610,1288,322,2001-5-4,966
2001,5,5,1512,1078,434,2001-5-5,644
2001,5,6,980,742,238,2001-5-6,504
2001,5,7,854,504,350,2001-5-7,154
2001,5,8,616,294,322,2001-5-8,-28
2001,5,9,616,266,350,2001-5-9,-84
2001,5,10,910,616,294,2001-5-10,322
2001,5,11,1134,770,364,2001-5-11,406
2001,5,12,1260,798,462,2001-5-12,336
2001,5,13,1176,784,392,2001-5-13,392
2001,5,14,1008,560,448,2001-5-14,112
2001,5,15,966,490,476,2001-5-15,14
2001,5,16,952,560,392,2001-5-16,168
2001,5,17,1064,588,476,2001-5-17,112
2001,5,18,686,392,294,2001-5-18,98
2001,5,19,868,686,182,2001-5-19,504
2001,5,20,1120,868,252,2001-5-20,616
2001,5,21,1232,980,252,2001-5-21,728
2001,5,22,1106,924,182,2001-5-22,742
2001,5,23,1694,1526,168,2001-5-23,1358
2001,5,24,1624,1358,266,2001-5-24,1092
2001,5,25,1078,938,140,2001-5-25,798
2001,5,26,1442,1246,196,2001-5-26,1050
2001,5,27,1274,1106,168,2001-5-27,938
2001,5,28,1218,1050,168,2001-5-28,882
2001,5,29,924,868,56,2001-5-29,812
2001,5,30,504,392,112,2001-5-30,280
2001,5,31,420,322,98,2001-5-31,224
2001,6,1,504,252,252,2001-6-1,0
2001,6,2,882,392,490,2001-6-2,-98
2001,6,3,1316,686,630,2001-6-3,56
2001,6,4,1512,770,742,2001-6-4,28
2001,6,5,1750,1036,714,2001-6-5,322
2001,6,6,1638,1050,588,2001-6-6,462
2001,6,7,1792,1260,532,2001-6-7,728
2001,6,8,1876,1288,588,2001-6-8,700
2001,6,9,2072,1358,714,2001-6-9,644
2001,6,10,2002,1176,826,2001-6-10,350
2001,6,11,2324,1414,910,2001-6-11,504
2001,6,12,1736,924,812,2001-6-12,112
2001,6,13,2016,1400,616,2001-6-13,784
2001,6,14,2576,2156,420,2001-6-14,1736
2001,6,15,2590,2226,364,2001-6-15,1862
2001,6,16,3570,3248,322,2001-6-16,2926
2001,6,17,2954,2688,266,2001-6-17,2422
2001,6,18,2156,1960,196,2001-6-18,1764
2001,6,19,2170,1890,280,2001-6-19,1610
2001,6,20,1946,1638,308,2001-6-20,1330
2001,6,21,1764,1512,252,2001-6-21,1260
2001,6,22,1946,1568,378,2001-6-22,1190
2001,6,23,2226,1736,490,2001-6-23,1246
2001,6,24,2198,1624,574,2001-6-24,1050
2001,6,25,1848,1358,490,2001-6-25,868
2001,6,26,1386,1036,350,2001-6-26,686
2001,6,27,1148,714,434,2001-6-27,280
2001,6,28,644,378,266,2001-6-28,112
2001,6,29,476,252,224,2001-6-29,28
2001,6,30,560,266,294,2001-6-30,-28
2001,7,1,644,294,350,2001-7-1,-56
2001,7,2,672,364,308,2001-7-2,56
2001,7,3,770,462,308,2001-7-3,154
2001,7,4,756,448,308,2001-7-4,140
2001,7,5,476,252,224,2001-7-5,28
2001,7,6,364,154,210,2001-7-6,-56
2001,7,7,350,154,196,2001-7-7,-42
2001,7,8,378,168,210,2001-7-8,-42
2001,7,9,532,168,364,2001-7-9,-196
2001,7,10,588,280,308,2001-7-10,-28
2001,7,11,574,336,238,2001-7-11,98
2001,7,12,714,462,252,2001-7-12,210
2001,7,13,924,658,266,2001-7-13,392
2001,7,14,1008,700,308,2001-7-14,392
2001,7,15,1204,868,336,2001-7-15,532
2001,7,16,1540,714,826,2001-7-16,-112
2001,7,17,1610,714,896,2001-7-17,-182
2001,7,18,1428,658,770,2001-7-18,-112
2001,7,19,1330,658,672,2001-7-19,-14
2001,7,20,1372,700,672,2001-7-20,28
2001,7,21,938,574,364,2001-7-21,210
2001,7,22,1274,616,658,2001-7-22,-42
2001,7,23,924,546,378,2001-7-23,168
2001,7,24,924,420,504,2001-7-24,-84
2001,7,25,756,280,476,2001-7-25,-196
2001,7,26,966,378,588,2001-7-26,-210
2001,7,27,644,266,378,2001-7-27,-112
2001,7,28,378,126,252,2001-7-28,-126
2001,7,29,266,28,238,2001-7-29,-210
2001,7,30,462,196,266,2001-7-30,-70
2001,7,31,630,308,322,2001-7-31,-14
2001,8,1,532,266,266,2001-8-1,0
2001,8,2,616,350,266,2001-8-2,84
2001,8,3,560,336,224,2001-8-3,112
2001,8,4,1106,574,532,2001-8-4,42
2001,8,5,1820,686,1134,2001-8-5,-448
2001,8,6,2016,868,1148,2001-8-6,-280
2001,8,7,2450,1008,1442,2001-8-7,-434
2001,8,8,2142,980,1162,2001-8-8,-182
2001,8,9,2002,1092,910,2001-8-9,182
2001,8,10,1526,728,798,2001-8-10,-70
2001,8,11,1946,882,1064,2001-8-11,-182
2001,8,12,1974,784,1190,2001-8-12,-406
2001,8,13,1344,266,1078,2001-8-13,-812
2001,8,14,1218,378,840,2001-8-14,-462
2001,8,15,1176,532,644,2001-8-15,-112
2001,8,16,1218,532,686,2001-8-16,-154
2001,8,17,756,392,364,2001-8-17,28
2001,8,18,1008,770,238,2001-8-18,532
2001,8,19,1120,812,308,2001-8-19,504
2001,8,20,1260,840,420,2001-8-20,420
2001,8,21,1330,882,448,2001-8-21,434
2001,8,22,1666,952,714,2001-8-22,238
2001,8,23,2184,784,1400,2001-8-23,-616
2001,8,24,1764,490,1274,2001-8-24,-784
2001,8,25,1820,448,1372,2001-8-25,-924
2001,8,26,1960,378,1582,2001-8-26,-1204
2001,8,27,2338,658,1680,2001-8-27,-1022
2001,8,28,2156,784,1372,2001-8-28,-588
2001,8,29,2394,1232,1162,2001-8-29,70
2001,8,30,2436,1260,1176,2001-8-30,84
2001,8,31,2352,1316,1036,2001-8-31,280
2001,9,1,2072,1260,812,2001-9-1,448
2001,9,2,1904,1204,700,2001-9-2,504
2001,9,3,1834,1204,630,2001-9-3,574
2001,9,4,2464,1288,1176,2001-9-4,112
2001,9,5,2688,1386,1302,2001-9-5,84
2001,9,6,3500,1302,2198,2001-9-6,-896
2001,9,7,3724,1260,2464,2001-9-7,-1204
2001,9,8,3598,924,2674,2001-9-8,-1750
2001,9,9,3444,616,2828,2001-9-9,-2212
2001,9,10,3487.4,575.4,2912,2001-9-10,-2336.6
2001,9,11,3332,658,2674,2001-9-11,-2016
2001,9,12,3570,644,2926,2001-9-12,-2282
2001,9,13,3080,294,2786,2001-9-13,-2492
2001,9,14,2828,196,2632,2001-9-14,-2436
2001,9,15,2380,294,2086,2001-9-15,-1792
2001,9,16,2058,532,1526,2001-9-16,-994
2001,9,17,1806,630,1176,2001-9-17,-546
2001,9,18,1876,882,994,2001-9-18,-112
2001,9,19,1932,1064,868,2001-9-19,196
2001,9,20,3024,1092,1932,2001-9-20,-840
2001,9,21,3164,994,2170,2001-9-21,-1176
2001,9,22,3528,1428,2100,2001-9-22,-672
2001,9,23,3948,1666,2282,2001-9-23,-616
2001,9,24,4424,1806,2618,2001-9-24,-812
2001,9,25,4004,1540,2464,2001-9-25,-924
2001,9,26,3934,1680,2254,2001-9-26,-574
2001,9,27,3738,1288,2450,2001-9-27,-1162
2001,9,28,3122,952,2170,2001-9-28,-1218
2001,9,29,3192,896,2296,2001-9-29,-1400
2001,9,30,3556,1092,2464,2001-9-30,-1372
2001,10,1,3024,1064,1960,2001-10-1,-896
2001,10,2,1624,728,896,2001-10-2,-168
2001,10,3,1330,574,756,2001-10-3,-182
2001,10,4,1456,574,882,2001-10-4,-308
2001,10,5,1330,294,1036,2001-10-5,-742
2001,10,6,1554,182,1372,2001-10-6,-1190
2001,10,7,1288,28,1260,2001-10-7,-1232
2001,10,8,854,70,784,2001-10-8,-714
2001,10,9,826,56,770,2001-10-9,-714
2001,10,10,784,154,630,2001-10-10,-476
2001,10,11,1470,798,672,2001-10-11,126
2001,10,12,1890,1288,602,2001-10-12,686
2001,10,13,1596,1148,448,2001-10-13,700
2001,10,14,1610,1246,364,2001-10-14,882
2001,10,15,1652,1372,280,2001-10-15,1092
2001,10,16,1904,1540,364,2001-10-16,1176
2001,10,17,2268,1568,700,2001-10-17,868
2001,10,18,2338,1428,910,2001-10-18,518
2001,10,19,2954,1582,1372,2001-10-19,210
2001,10,20,2324,1190,1134,2001-10-20,56
2001,10,21,2324,1092,1232,2001-10-21,-140
2001,10,22,2478,1120,1358,2001-10-22,-238
2001,10,23,2016,742,1274,2001-10-23,-532
2001,10,24,1876,588,1288,2001-10-24,-700
2001,10,25,2562,1274,1288,2001-10-25,-14
2001,10,26,3514,2268,1246,2001-10-26,1022
2001,10,27,3654,2660,994,2001-10-27,1666
2001,10,28,3710,2926,784,2001-10-28,2142
2001,10,29,3416,2954,462,2001-10-29,2492
2001,10,30,3220,3024,196,2001-10-30,2828
2001,10,31,3150,3122,28,2001-10-31,3094
2001,11,1,2842,2534,308,2001-11-1,2226
2001,11,2,3262,2758,504,2001-11-2,2254
2001,11,3,2352,1918,434,2001-11-3,1484
2001,11,4,2548,1932,616,2001-11-4,1316
2001,11,5,3248,1750,1498,2001-11-5,252
2001,11,6,2786,1064,1722,2001-11-6,-658
2001,11,7,2716,840,1876,2001-11-7,-1036
2001,11,8,2800,854,1946,2001-11-8,-1092
2001,11,9,3682,1288,2394,2001-11-9,-1106
2001,11,10,3976,1498,2478,2001-11-10,-980
2001,11,11,3514,1554,1960,2001-11-11,-406
2001,11,12,3346,1442,1904,2001-11-12,-462
2001,11,13,2996,994,2002,2001-11-13,-1008
2001,11,14,2114,658,1456,2001-11-14,-798
2001,11,15,2324,756,1568,2001-11-15,-812
2001,11,16,2198,728,1470,2001-11-16,-742
2001,11,17,1890,770,1120,2001-11-17,-350
2001,11,18,1918,756,1162,2001-11-18,-406
2001,11,19,1792,700,1092,2001-11-19,-392
2001,11,20,1652,616,1036,2001-11-20,-420
2001,11,21,1610,518,1092,2001-11-21,-574
2001,11,22,1834,616,1218,2001-11-22,-602
2001,11,23,1568,462,1106,2001-11-23,-644
2001,11,24,1211,273,938,2001-11-24,-665
2001,11,25,1190,462,728,2001-11-25,-266
2001,11,26,1246,756,490,2001-11-26,266
2001,11,27,1316,1064,252,2001-11-27,812
2001,11,28,2534,1554,980,2001-11-28,574
2001,11,29,2982,1988,994,2001-11-29,994
2001,11,30,3276,2156,1120,2001-11-30,1036
2001,12,1,3332,2030,1302,2001-12-1,728
2001,12,2,3150,1806,1344,2001-12-2,462
2001,12,3,3010,1610,1400,2001-12-3,210
2001,12,4,2996,1386,1610,2001-12-4,-224
2001,12,5,3248,1456,1792,2001-12-5,-336
2001,12,6,2800,994,1806,2001-12-6,-812
2001,12,7,2380,742,1638,2001-12-7,-896
2001,12,8,2296,910,1386,2001-12-8,-476
2001,12,9,2002,868,1134,2001-12-9,-266
2001,12,10,1974,798,1176,2001-12-10,-378
2001,12,11,2002,896,1106,2001-12-11,-210
2001,12,12,2156,966,1190,2001-12-12,-224
2001,12,13,2016,812,1204,2001-12-13,-392
2001,12,14,1834,728,1106,2001-12-14,-378
2001,12,15,1750,924,826,2001-12-15,98
2001,12,16,2436,1358,1078,2001-12-16,280
2001,12,17,2408,1260,1148,2001-12-17,112
2001,12,18,2058,1064,994,2001-12-18,70
2001,12,19,1624,994,630,2001-12-19,364
2001,12,20,1372,1022,350,2001-12-20,672
2001,12,21,1848,1428,420,2001-12-21,1008
2001,12,22,2114,1638,476,2001-12-22,1162
2001,12,23,2632,1876,756,2001-12-23,1120
2001,12,24,2548,1946,602,2001-12-24,1344
2001,12,25,3374,2086,1288,2001-12-25,798
2001,12,26,2772,1484,1288,2001-12-26,196
2001,12,27,2898,1764,1134,2001-12-27,630
2001,12,28,2562,1344,1218,2001-12-28,126
2001,12,29,1904,868,1036,2001-12-29,-168
2001,12,30,1680,742,938,2001-12-30,-196
2001,12,31,1806,672,1134,2001-12-31,-462
2002,1,1,1904,714,1190,2002-1-1,-476
2002,1,2,1687,644,1043,2002-1-2,-399
2002,1,3,1638,518,1120,2002-1-3,-602
2002,1,4,1666,560,1106,2002-1-4,-546
2002,1,5,1568,574,994,2002-1-5,-420
2002,1,6,1190,336,854,2002-1-6,-518
2002,1,7,798,322,476,2002-1-7,-154
2002,1,8,952,490,462,2002-1-8,28
2002,1,9,1526,812,714,2002-1-9,98
2002,1,10,1624,910,714,2002-1-10,196
2002,1,11,2072,1232,840,2002-1-11,392
2002,1,12,2100,1344,756,2002-1-12,588
2002,1,13,2310,1498,812,2002-1-13,686
2002,1,14,2212,1414,798,2002-1-14,616
2002,1,15,2114,1106,1008,2002-1-15,98
2002,1,16,1442,770,672,2002-1-16,98
2002,1,17,1596,896,700,2002-1-17,196
2002,1,18,1442,728,714,2002-1-18,14
2002,1,19,1554,616,938,2002-1-19,-322
2002,1,20,1610,574,1036,2002-1-20,-462
2002,1,21,1960,742,1218,2002-1-21,-476
2002,1,22,1582,560,1022,2002-1-22,-462
2002,1,23,1750,560,1190,2002-1-23,-630
2002,1,24,1652,476,1176,2002-1-24,-700
2002,1,25,1568,588,980,2002-1-25,-392
2002,1,26,1848,672,1176,2002-1-26,-504
2002,1,27,2016,686,1330,2002-1-27,-644
2002,1,28,2338,952,1386,2002-1-28,-434
2002,1,29,2408,966,1442,2002-1-29,-476
2002,1,30,2338,910,1428,2002-1-30,-518
2002,1,31,2758,952,1806,2002-1-31,-854
2002,2,1,3024,1092,1932,2002-2-1,-840
2002,2,2,2786,1120,1666,2002-2-2,-546
2002,2,3,2324,994,1330,2002-2-3,-336
2002,2,4,2758,952,1806,2002-2-4,-854
2002,2,5,2506,756,1750,2002-2-5,-994
2002,2,6,1582,448,1134,2002-2-6,-686
2002,2,7,1092,518,574,2002-2-7,-56
2002,2,8,1092,616,476,2002-2-8,140
2002,2,9,1414,994,420,2002-2-9,574
2002,2,10,1876,1190,686,2002-2-10,504
2002,2,11,1694,910,784,2002-2-11,126
2002,2,12,1582,770,812,2002-2-12,-42
2002,2,13,1708,1036,672,2002-2-13,364
2002,2,14,1512,980,532,2002-2-14,448
2002,2,15,1274,952,322,2002-2-15,630
2002,2,16,994,602,392,2002-2-16,210
2002,2,17,1190,602,588,2002-2-17,14
2002,2,18,1176,476,700,2002-2-18,-224
2002,2,19,1386,504,882,2002-2-19,-378
2002,2,20,1274,434,840,2002-2-20,-406
2002,2,21,1582,518,1064,2002-2-21,-546
2002,2,22,1134,210,924,2002-2-22,-714
2002,2,23,1274,322,952,2002-2-23,-630
2002,2,24,1638,336,1302,2002-2-24,-966
2002,2,25,1414,350,1064,2002-2-25,-714
2002,2,26,1652,378,1274,2002-2-26,-896
2002,2,27,1540,532,1008,2002-2-27,-476
2002,2,28,1358,826,532,2002-2-28,294
2002,3,1,1178.8,772.8,406,2002-3-1,366.8
2002,3,2,938,700,238,2002-3-2,462
2002,3,3,1106,742,364,2002-3-3,378
2002,3,4,1568,784,784,2002-3-4,0
2002,3,5,1260,644,616,2002-3-5,28
2002,3,6,1218,518,700,2002-3-6,-182
2002,3,7,882,280,602,2002-3-7,-322
2002,3,8,854,196,658,2002-3-8,-462
2002,3,9,1260,98,1162,2002-3-9,-1064
2002,3,10,1694,154,1540,2002-3-10,-1386
2002,3,11,1904,182,1722,2002-3-11,-1540
2002,3,12,1778,126,1652,2002-3-12,-1526
2002,3,13,1876,126,1750,2002-3-13,-1624
2002,3,14,1890,112,1778,2002-3-14,-1666
2002,3,15,1596,84,1512,2002-3-15,-1428
2002,3,16,1428,84,1344,2002-3-16,-1260
2002,3,17,1568,70,1498,2002-3-17,-1428
2002,3,18,1274,28,1246,2002-3-18,-1218
2002,3,19,1078,56,1022,2002-3-19,-966
2002,3,20,1330,168,1162,2002-3-20,-994
2002,3,21,1274,252,1022,2002-3-21,-770
2002,3,22,1358,560,798,2002-3-22,-238
2002,3,23,1470,756,714,2002-3-23,42
2002,3,24,938,448,490,2002-3-24,-42
2002,3,25,952,448,504,2002-3-25,-56
2002,3,26,966,434,532,2002-3-26,-98
2002,3,27,1344,812,532,2002-3-27,280
2002,3,28,1036,700,336,2002-3-28,364
2002,3,29,1904,1484,420,2002-3-29,1064
2002,3,30,1694,1414,280,2002-3-30,1134
2002,3,31,1778,1344,434,2002-3-31,910
2002,4,1,2632,1960,672,2002-4-1,1288
2002,4,2,2646,2100,546,2002-4-2,1554
2002,4,3,2366,1946,420,2002-4-3,1526
2002,4,4,2548,2254,294,2002-4-4,1960
2002,4,5,2842,2408,434,2002-4-5,1974
2002,4,6,2814,2296,518,2002-4-6,1778
2002,4,7,2758,2170,588,2002-4-7,1582
2002,4,8,2702,2170,532,2002-4-8,1638
2002,4,9,2394,1820,574,2002-4-9,1246
2002,4,10,1806,1302,504,2002-4-10,798
2002,4,11,2002,1204,798,2002-4-11,406
2002,4,12,2520,1302,1218,2002-4-12,84
2002,4,13,3024,1344,1680,2002-4-13,-336
2002,4,14,3038,1414,1624,2002-4-14,-210
2002,4,15,3360,1694,1666,2002-4-15,28
2002,4,16,2156,854,1302,2002-4-16,-448
2002,4,17,1540,350,1190,2002-4-17,-840
2002,4,18,1932,434,1498,2002-4-18,-1064
2002,4,19,2002,322,1680,2002-4-19,-1358
2002,4,20,1862,476,1386,2002-4-20,-910
2002,4,21,1442,588,854,2002-4-21,-266
2002,4,22,1372,994,378,2002-4-22,616
2002,4,23,1484,1078,406,2002-4-23,672
2002,4,24,1806,1302,504,2002-4-24,798
2002,4,25,1190,826,364,2002-4-25,462
2002,4,26,1288,1106,182,2002-4-26,924
2002,4,27,1232,1134,98,2002-4-27,1036
2002,4,28,966,924,42,2002-4-28,882
2002,4,29,1106,966,140,2002-4-29,826
2002,4,30,770,672,98,2002-4-30,574
2002,5,1,1344,840,504,2002-5-1,336
2002,5,2,1512,588,924,2002-5-2,-336
2002,5,3,2086,756,1330,2002-5-3,-574
2002,5,4,2072,840,1232,2002-5-4,-392
2002,5,5,2352,868,1484,2002-5-5,-616
2002,5,6,1848,644,1204,2002-5-6,-560
2002,5,7,1848,434,1414,2002-5-7,-980
2002,5,8,2016,336,1680,2002-5-8,-1344
2002,5,9,2268,378,1890,2002-5-9,-1512
2002,5,10,3122,252,2870,2002-5-10,-2618
2002,5,11,3220,196,3024,2002-5-11,-2828
2002,5,12,2982,140,2842,2002-5-12,-2702
2002,5,13,2296,98,2198,2002-5-13,-2100
2002,5,14,1232,42,1190,2002-5-14,-1148
2002,5,15,1386,28,1358,2002-5-15,-1330
2002,5,16,2016,868,1148,2002-5-16,-280
2002,5,17,2548,1400,1148,2002-5-17,252
2002,5,18,2464,1428,1036,2002-5-18,392
2002,5,19,2422,1484,938,2002-5-19,546
2002,5,20,2996,1680,1316,2002-5-20,364
2002,5,21,2772,1694,1078,2002-5-21,616
2002,5,22,2618,1512,1106,2002-5-22,406
2002,5,23,2030,1470,560,2002-5-23,910
2002,5,24,1736,1260,476,2002-5-24,784
2002,5,25,1680,1204,476,2002-5-25,728
2002,5,26,1960,1554,406,2002-5-26,1148
2002,5,27,1792,1456,336,2002-5-27,1120
2002,5,28,2016,1120,896,2002-5-28,224
2002,5,29,2590,896,1694,2002-5-29,-798
2002,5,30,2268,644,1624,2002-5-30,-980
2002,5,31,2156,616,1540,2002-5-31,-924
2002,6,1,2044,476,1568,2002-6-1,-1092
2002,6,2,1750,210,1540,2002-6-2,-1330
2002,6,3,1582,154,1428,2002-6-3,-1274
2002,6,4,1442,392,1050,2002-6-4,-658
2002,6,5,1666,546,1120,2002-6-5,-574
2002,6,6,1372,420,952,2002-6-6,-532
2002,6,7,1484,308,1176,2002-6-7,-868
2002,6,8,1596,378,1218,2002-6-8,-840
2002,6,9,1470,434,1036,2002-6-9,-602
2002,6,10,1652,336,1316,2002-6-10,-980
2002,6,11,1344,210,1134,2002-6-11,-924
2002,6,12,1316,252,1064,2002-6-12,-812
2002,6,13,1162,154,1008,2002-6-13,-854
2002,6,14,910,182,728,2002-6-14,-546
2002,6,15,896,406,490,2002-6-15,-84
2002,6,16,938,518,420,2002-6-16,98
2002,6,17,994,490,504,2002-6-17,-14
2002,6,18,1330,616,714,2002-6-18,-98
2002,6,19,1484,532,952,2002-6-19,-420
2002,6,20,1218,490,728,2002-6-20,-238
2002,6,21,1316,518,798,2002-6-21,-280
2002,6,22,1218,462,756,2002-6-22,-294
2002,6,23,1344,490,854,2002-6-23,-364
2002,6,24,1344,392,952,2002-6-24,-560
2002,6,25,1330,294,1036,2002-6-25,-742
2002,6,26,1204,210,994,2002-6-26,-784
2002,6,27,1148,154,994,2002-6-27,-840
2002,6,28,1022,98,924,2002-6-28,-826
2002,6,29,1330,140,1190,2002-6-29,-1050
2002,6,30,1498,112,1386,2002-6-30,-1274
2002,7,1,1400,280,1120,2002-7-1,-840
2002,7,2,1414,14,1400,2002-7-2,-1386
2002,7,3,1680,14,1666,2002-7-3,-1652
2002,7,4,1778,0,1778,2002-7-4,-1778
2002,7,5,1470,42,1428,2002-7-5,-1386
2002,7,6,1162,28,1134,2002-7-6,-1106
2002,7,7,966,0,966,2002-7-7,-966
2002,7,8,742,0,742,2002-7-8,-742
2002,7,9,1092,392,700,2002-7-9,-308
2002,7,10,1176,644,532,2002-7-10,112
2002,7,11,1204,770,434,2002-7-11,336
2002,7,12,1050,980,70,2002-7-12,910
2002,7,13,1176,1064,112,2002-7-13,952
2002,7,14,1190,1106,84,2002-7-14,1022
2002,7,15,1596,1344,252,2002-7-15,1092
2002,7,16,2912,2156,756,2002-7-16,1400
2002,7,17,3262,2058,1204,2002-7-17,854
2002,7,18,3010,1708,1302,2002-7-18,406
2002,7,19,2870,1568,1302,2002-7-19,266
2002,7,20,2310,882,1428,2002-7-20,-546
2002,7,21,2296,714,1582,2002-7-21,-868
2002,7,22,2660,700,1960,2002-7-22,-1260
2002,7,23,3346,420,2926,2002-7-23,-2506
2002,7,24,3262,462,2800,2002-7-24,-2338
2002,7,25,2982,588,2394,2002-7-25,-1806
2002,7,26,3794,812,2982,2002-7-26,-2170
2002,7,27,3612,756,2856,2002-7-27,-2100
2002,7,28,3374,714,2660,2002-7-28,-1946
2002,7,29,3584,546,3038,2002-7-29,-2492
2002,7,30,2604,252,2352,2002-7-30,-2100
2002,7,31,3122,308,2814,2002-7-31,-2506
2002,8,1,3038,168,2870,2002-8-1,-2702
2002,8,2,3094,238,2856,2002-8-2,-2618
2002,8,3,2352,448,1904,2002-8-3,-1456
2002,8,4,1834,490,1344,2002-8-4,-854
2002,8,5,1092,420,672,2002-8-5,-252
2002,8,6,1274,658,616,2002-8-6,42
2002,8,7,1358,798,560,2002-8-7,238
2002,8,8,1232,826,406,2002-8-8,420
2002,8,9,1078,910,168,2002-8-9,742
2002,8,10,1218,966,252,2002-8-10,714
2002,8,11,1792,784,1008,2002-8-11,-224
2002,8,12,2702,686,2016,2002-8-12,-1330
2002,8,13,2954,728,2226,2002-8-13,-1498
2002,8,14,3668,1022,2646,2002-8-14,-1624
2002,8,15,3948,1176,2772,2002-8-15,-1596
2002,8,16,3962,994,2968,2002-8-16,-1974
2002,8,17,3822,672,3150,2002-8-17,-2478
2002,8,18,3990,518,3472,2002-8-18,-2954
2002,8,19,4788,504,4284,2002-8-19,-3780
2002,8,20,4116,350,3766,2002-8-20,-3416
2002,8,21,3794,294,3500,2002-8-21,-3206
2002,8,22,3598,126,3472,2002-8-22,-3346
2002,8,23,3318,140,3178,2002-8-23,-3038
2002,8,24,2016,168,1848,2002-8-24,-1680
2002,8,25,1932,84,1848,2002-8-25,-1764
2002,8,26,1848,112,1736,2002-8-26,-1624
2002,8,27,1498,14,1484,2002-8-27,-1470
2002,8,28,1498,0,1498,2002-8-28,-1498
2002,8,29,1274,252,1022,2002-8-29,-770
2002,8,30,1820,630,1190,2002-8-30,-560
2002,8,31,2436,1162,1274,2002-8-31,-112
2002,9,1,2184,1134,1050,2002-9-1,84
2002,9,2,2646,1456,1190,2002-9-2,266
2002,9,3,2450,1386,1064,2002-9-3,322
2002,9,4,1932,1120,812,2002-9-4,308
2002,9,5,1764,1050,714,2002-9-5,336
2002,9,6,1386,784,602,2002-9-6,182
2002,9,7,1484,672,812,2002-9-7,-140
2002,9,8,2268,742,1526,2002-9-8,-784
2002,9,9,2688,700,1988,2002-9-9,-1288
2002,9,10,3598,1302,2296,2002-9-10,-994
2002,9,11,3136,1078,2058,2002-9-11,-980
2002,9,12,2590,812,1778,2002-9-12,-966
2002,9,13,2464,756,1708,2002-9-13,-952
2002,9,14,2478,672,1806,2002-9-14,-1134
2002,9,15,2044,336,1708,2002-9-15,-1372
2002,9,16,2142,196,1946,2002-9-16,-1750
2002,9,17,2072,224,1848,2002-9-17,-1624
2002,9,18,2198,140,2058,2002-9-18,-1918
2002,9,19,2100,98,2002,2002-9-19,-1904
2002,9,20,2422,112,2310,2002-9-20,-2198
2002,9,21,2100,70,2030,2002-9-21,-1960
2002,9,22,2100,140,1960,2002-9-22,-1820
2002,9,23,2240,364,1876,2002-9-23,-1512
2002,9,24,2002,700,1302,2002-9-24,-602
2002,9,25,2338,980,1358,2002-9-25,-378
2002,9,26,1778,1036,742,2002-9-26,294
2002,9,27,1358,728,630,2002-9-27,98
2002,9,28,1106,644,462,2002-9-28,182
2002,9,29,1008,700,308,2002-9-29,392
2002,9,30,728,546,182,2002-9-30,364
2002,10,1,910,658,252,2002-10-1,406
2002,10,2,1218,784,434,2002-10-2,350
2002,10,3,1008,574,434,2002-10-3,140
2002,10,4,1274,840,434,2002-10-4,406
2002,10,5,1918,1246,672,2002-10-5,574
2002,10,6,1533,952,581,2002-10-6,371
2002,10,7,1540,896,644,2002-10-7,252
2002,10,8,1414,910,504,2002-10-8,406
2002,10,9,2058,1302,756,2002-10-9,546
2002,10,10,1988,1288,700,2002-10-10,588
2002,10,11,1834,1414,420,2002-10-11,994
2002,10,12,2352,1750,602,2002-10-12,1148
2002,10,13,2198,1512,686,2002-10-13,826
2002,10,14,2086,1358,728,2002-10-14,630
2002,10,15,1526,840,686,2002-10-15,154
2002,10,16,1862,910,952,2002-10-16,-42
2002,10,17,1694,966,728,2002-10-17,238
2002,10,18,2324,1624,700,2002-10-18,924
2002,10,19,2254,1750,504,2002-10-19,1246
2002,10,20,2478,2058,420,2002-10-20,1638
2002,10,21,1988,1750,238,2002-10-21,1512
2002,10,22,2254,1918,336,2002-10-22,1582
2002,10,23,2212,1974,238,2002-10-23,1736
2002,10,24,2072,1792,280,2002-10-24,1512
2002,10,25,1876,1708,168,2002-10-25,1540
2002,10,26,1820,1638,182,2002-10-26,1456
2002,10,27,1428,1274,154,2002-10-27,1120
2002,10,28,1722,1512,210,2002-10-28,1302
2002,10,29,1708,1358,350,2002-10-29,1008
2002,10,30,1946,1666,280,2002-10-30,1386
2002,10,31,1288,1162,126,2002-10-31,1036
2002,11,1,1330,1134,196,2002-11-1,938
2002,11,2,1470,1036,434,2002-11-2,602
2002,11,3,1792,1022,770,2002-11-3,252
2002,11,4,2156,966,1190,2002-11-4,-224
2002,11,5,2324,994,1330,2002-11-5,-336
2002,11,6,2156,840,1316,2002-11-6,-476
2002,11,7,2002,756,1246,2002-11-7,-490
2002,11,8,2114,784,1330,2002-11-8,-546
2002,11,9,2422,742,1680,2002-11-9,-938
2002,11,10,2184,378,1806,2002-11-10,-1428
2002,11,11,1876,196,1680,2002-11-11,-1484
2002,11,12,1750,14,1736,2002-11-12,-1722
2002,11,13,1666,28,1638,2002-11-13,-1610
2002,11,14,1806,448,1358,2002-11-14,-910
2002,11,15,2296,868,1428,2002-11-15,-560
2002,11,16,2982,1078,1904,2002-11-16,-826
2002,11,17,3304,1162,2142,2002-11-17,-980
2002,11,18,2898,840,2058,2002-11-18,-1218
2002,11,19,2212,448,1764,2002-11-19,-1316
2002,11,20,1918,560,1358,2002-11-20,-798
2002,11,21,1666,574,1092,2002-11-21,-518
2002,11,22,1554,630,924,2002-11-22,-294
2002,11,23,1568,546,1022,2002-11-23,-476
2002,11,24,1386,434,952,2002-11-24,-518
2002,11,25,1232,462,770,2002-11-25,-308
2002,11,26,1106,434,672,2002-11-26,-238
2002,11,27,1064,196,868,2002-11-27,-672
2002,11,28,1176,168,1008,2002-11-28,-840
2002,11,29,868,266,602,2002-11-29,-336
2002,11,30,1036,350,686,2002-11-30,-336
2002,12,1,868,224,644,2002-12-1,-420
2002,12,2,1190,518,672,2002-12-2,-154
2002,12,3,1036,546,490,2002-12-3,56
2002,12,4,1078,616,462,2002-12-4,154
2002,12,5,1204,672,532,2002-12-5,140
2002,12,6,980,546,434,2002-12-6,112
2002,12,7,686,420,266,2002-12-7,154
2002,12,8,924,490,434,2002-12-8,56
2002,12,9,1050,434,616,2002-12-9,-182
2002,12,10,812,98,714,2002-12-10,-616
2002,12,11,700,98,602,2002-12-11,-504
2002,12,12,602,126,476,2002-12-12,-350
2002,12,13,1134,406,728,2002-12-13,-322
2002,12,14,1764,770,994,2002-12-14,-224
2002,12,15,1890,966,924,2002-12-15,42
2002,12,16,1680,966,714,2002-12-16,252
2002,12,17,2170,924,1246,2002-12-17,-322
2002,12,18,2548,1036,1512,2002-12-18,-476
2002,12,19,1904,532,1372,2002-12-19,-840
2002,12,20,2310,728,1582,2002-12-20,-854
2002,12,21,1652,378,1274,2002-12-21,-896
2002,12,22,1302,210,1092,2002-12-22,-882
2002,12,23,2240,434,1806,2002-12-23,-1372
2002,12,24,980,196,784,2002-12-24,-588
2002,12,25,490,126,364,2002-12-25,-238
2002,12,26,434,112,322,2002-12-26,-210
2002,12,27,280,126,154,2002-12-27,-28
2002,12,28,210,126,84,2002-12-28,42
2002,12,29,140,98,42,2002-12-29,56
2002,12,30,126,70,56,2002-12-30,14
2002,12,31,210,56,154,2002-12-31,-98
2003,1,1,168,42,126,2003-1-1,-84
2003,1,2,224,42,182,2003-1-2,-140
2003,1,3,462,112,350,2003-1-3,-238
2003,1,4,896,154,742,2003-1-4,-588
2003,1,5,924,112,812,2003-1-5,-700
2003,1,6,728,56,672,2003-1-6,-616
2003,1,7,1190,42,1148,2003-1-7,-1106
2003,1,8,1778,42,1736,2003-1-8,-1694
2003,1,9,1820,42,1778,2003-1-9,-1736
2003,1,10,1624,28,1596,2003-1-10,-1568
2003,1,11,2086,84,2002,2003-1-11,-1918
2003,1,12,1694,42,1652,2003-1-12,-1610
2003,1,13,1260,42,1218,2003-1-13,-1176
2003,1,14,1302,168,1134,2003-1-14,-966
2003,1,15,1134,252,882,2003-1-15,-630
2003,1,16,966,266,700,2003-1-16,-434
2003,1,17,882,294,588,2003-1-17,-294
2003,1,18,840,280,560,2003-1-18,-280
2003,1,19,994,420,574,2003-1-19,-154
2003,1,20,966,490,476,2003-1-20,14
2003,1,21,1078,462,616,2003-1-21,-154
2003,1,22,840,196,644,2003-1-22,-448
2003,1,23,910,196,714,2003-1-23,-518
2003,1,24,1078,252,826,2003-1-24,-574
2003,1,25,658,182,476,2003-1-25,-294
2003,1,26,714,140,574,2003-1-26,-434
2003,1,27,532,112,420,2003-1-27,-308
2003,1,28,686,168,518,2003-1-28,-350
2003,1,29,952,196,756,2003-1-29,-560
2003,1,30,658,168,490,2003-1-30,-322
2003,1,31,574,168,406,2003-1-31,-238
2003,2,1,644,126,518,2003-2-1,-392
2003,2,2,602,0,602,2003-2-2,-602
2003,2,3,630,0,630,2003-2-3,-630
2003,2,4,658,112,546,2003-2-4,-434
2003,2,5,602,154,448,2003-2-5,-294
2003,2,6,714,238,476,2003-2-6,-238
2003,2,7,686,266,420,2003-2-7,-154
2003,2,8,658,196,462,2003-2-8,-266
2003,2,9,602,196,406,2003-2-9,-210
2003,2,10,406,112,294,2003-2-10,-182
2003,2,11,350,112,238,2003-2-11,-126
2003,2,12,364,112,252,2003-2-12,-140
2003,2,13,350,112,238,2003-2-13,-126
2003,2,14,392,168,224,2003-2-14,-56
2003,2,15,294,252,42,2003-2-15,210
2003,2,16,140,126,14,2003-2-16,112
2003,2,17,70,70,0,2003-2-17,70
2003,2,18,84,84,0,2003-2-18,84
2003,2,19,336,336,0,2003-2-19,336
2003,2,20,826,826,0,2003-2-20,826
2003,2,21,728,700,28,2003-2-21,672
2003,2,22,560,532,28,2003-2-22,504
2003,2,23,532,532,0,2003-2-23,532
2003,2,24,378,378,0,2003-2-24,378
2003,2,25,294,252,42,2003-2-25,210
2003,2,26,308,266,42,2003-2-26,224
2003,2,27,350,154,196,2003-2-27,-42
2003,2,28,714,448,266,2003-2-28,182
2003,3,1,1190,896,294,2003-3-1,602
2003,3,2,1176,826,350,2003-3-2,476
2003,3,3,1260,952,308,2003-3-3,644
2003,3,4,1302,1078,224,2003-3-4,854
2003,3,5,1106,910,196,2003-3-5,714
2003,3,6,924,798,126,2003-3-6,672
2003,3,7,1344,1162,182,2003-3-7,980
2003,3,8,1708,1498,210,2003-3-8,1288
2003,3,9,1974,1638,336,2003-3-9,1302
2003,3,10,1736,1470,266,2003-3-10,1204
2003,3,11,1512,1232,280,2003-3-11,952
2003,3,12,1386,1204,182,2003-3-12,1022
2003,3,13,1078,924,154,2003-3-13,770
2003,3,14,1176,952,224,2003-3-14,728
2003,3,15,1414,1022,392,2003-3-15,630
2003,3,16,1596,994,602,2003-3-16,392
2003,3,17,1512,854,658,2003-3-17,196
2003,3,18,1414,644,770,2003-3-18,-126
2003,3,19,910,364,546,2003-3-19,-182
2003,3,20,560,28,532,2003-3-20,-504
2003,3,21,280,14,266,2003-3-21,-252
2003,3,22,98,28,70,2003-3-22,-42
2003,3,23,154,42,112,2003-3-23,-70
2003,3,24,266,182,84,2003-3-24,98
2003,3,25,672,588,84,2003-3-25,504
2003,3,26,896,770,126,2003-3-26,644
2003,3,27,1442,1232,210,2003-3-27,1022
2003,3,28,1792,1540,252,2003-3-28,1288
2003,3,29,1568,1176,392,2003-3-29,784
2003,3,30,1778,1232,546,2003-3-30,686
2003,3,31,1456,840,616,2003-3-31,224
2003,4,1,1470,756,714,2003-4-1,42
2003,4,2,1610,924,686,2003-4-2,238
2003,4,3,1624,924,700,2003-4-3,224
2003,4,4,1848,1204,644,2003-4-4,560
2003,4,5,1554,1190,364,2003-4-5,826
2003,4,6,1120,882,238,2003-4-6,644
2003,4,7,1022,910,112,2003-4-7,798
2003,4,8,980,952,28,2003-4-8,924
2003,4,9,924,784,140,2003-4-9,644
2003,4,10,728,546,182,2003-4-10,364
2003,4,11,672,504,168,2003-4-11,336
2003,4,12,644,490,154,2003-4-12,336
2003,4,13,686,490,196,2003-4-13,294
2003,4,14,602,448,154,2003-4-14,294
2003,4,15,448,322,126,2003-4-15,196
2003,4,16,112,0,112,2003-4-16,-112
2003,4,17,238,140,98,2003-4-17,42
2003,4,18,588,224,364,2003-4-18,-140
2003,4,19,616,196,420,2003-4-19,-224
2003,4,20,840,294,546,2003-4-20,-252
2003,4,21,896,308,588,2003-4-21,-280
2003,4,22,798,350,448,2003-4-22,-98
2003,4,23,938,476,462,2003-4-23,14
2003,4,24,966,518,448,2003-4-24,70
2003,4,25,1330,714,616,2003-4-25,98
2003,4,26,1778,1106,672,2003-4-26,434
2003,4,27,1918,1064,854,2003-4-27,210
2003,4,28,2044,770,1274,2003-4-28,-504
2003,4,29,2296,644,1652,2003-4-29,-1008
2003,4,30,1946,518,1428,2003-4-30,-910
2003,5,1,2394,588,1806,2003-5-1,-1218
2003,5,2,2450,728,1722,2003-5-2,-994
2003,5,3,2016,658,1358,2003-5-3,-700
2003,5,4,2590,630,1960,2003-5-4,-1330
2003,5,5,1960,392,1568,2003-5-5,-1176
2003,5,6,2072,392,1680,2003-5-6,-1288
2003,5,7,1624,392,1232,2003-5-7,-840
2003,5,8,420,308,112,2003-5-8,196
2003,5,9,448,448,0,2003-5-9,448
2003,5,10,252,252,0,2003-5-10,252
2003,5,11,350,294,56,2003-5-11,238
2003,5,12,434,308,126,2003-5-12,182
2003,5,13,266,140,126,2003-5-13,14
2003,5,14,294,196,98,2003-5-14,98
2003,5,15,406,210,196,2003-5-15,14
2003,5,16,560,126,434,2003-5-16,-308
2003,5,17,406,42,364,2003-5-17,-322
2003,5,18,252,28,224,2003-5-18,-196
2003,5,19,266,28,238,2003-5-19,-210
2003,5,20,518,0,518,2003-5-20,-518
2003,5,21,420,0,420,2003-5-21,-420
2003,5,22,700,28,672,2003-5-22,-644
2003,5,23,462,84,378,2003-5-23,-294
2003,5,24,448,42,406,2003-5-24,-364
2003,5,25,504,0,504,2003-5-25,-504
2003,5,26,560,28,532,2003-5-26,-504
2003,5,27,952,168,784,2003-5-27,-616
2003,5,28,1582,182,1400,2003-5-28,-1218
2003,5,29,1610,154,1456,2003-5-29,-1302
2003,5,30,1316,112,1204,2003-5-30,-1092
2003,5,31,938,154,784,2003-5-31,-630
2003,6,1,1008,364,644,2003-6-1,-280
2003,6,2,798,742,56,2003-6-2,686
2003,6,3,812,728,84,2003-6-3,644
2003,6,4,840,742,98,2003-6-4,644
2003,6,5,826,784,42,2003-6-5,742
2003,6,6,1064,980,84,2003-6-6,896
2003,6,7,1680,1036,644,2003-6-7,392
2003,6,8,2282,1484,798,2003-6-8,686
2003,6,9,2478,1512,966,2003-6-9,546
2003,6,10,2730,1876,854,2003-6-10,1022
2003,6,11,3024,2002,1022,2003-6-11,980
2003,6,12,2954,1904,1050,2003-6-12,854
2003,6,13,1960,1050,910,2003-6-13,140
2003,6,14,644,238,406,2003-6-14,-168
2003,6,15,672,322,350,2003-6-15,-28
2003,6,16,644,98,546,2003-6-16,-448
2003,6,17,728,98,630,2003-6-17,-532
2003,6,18,854,252,602,2003-6-18,-350
2003,6,19,756,322,434,2003-6-19,-112
2003,6,20,826,392,434,2003-6-20,-42
2003,6,21,742,392,350,2003-6-21,42
2003,6,22,798,490,308,2003-6-22,182
2003,6,23,756,504,252,2003-6-23,252
2003,6,24,798,546,252,2003-6-24,294
2003,6,25,952,770,182,2003-6-25,588
2003,6,26,826,714,112,2003-6-26,602
2003,6,27,938,826,112,2003-6-27,714
2003,6,28,1568,1372,196,2003-6-28,1176
2003,6,29,1680,1470,210,2003-6-29,1260
2003,6,30,1764,1540,224,2003-6-30,1316
2003,7,1,1582,1400,182,2003-7-1,1218
2003,7,2,1232,1134,98,2003-7-2,1036
2003,7,3,1176,1176,0,2003-7-3,1176
2003,7,4,1512,1512,0,2003-7-4,1512
2003,7,5,1652,1652,0,2003-7-5,1652
2003,7,6,1750,1722,28,2003-7-6,1694
2003,7,7,1652,1428,224,2003-7-7,1204
2003,7,8,1862,1414,448,2003-7-8,966
2003,7,9,1022,714,308,2003-7-9,406
2003,7,10,952,532,420,2003-7-10,112
2003,7,11,756,168,588,2003-7-11,-420
2003,7,12,602,98,504,2003-7-12,-406
2003,7,13,882,392,490,2003-7-13,-98
2003,7,14,966,560,406,2003-7-14,154
2003,7,15,1260,910,350,2003-7-15,560
2003,7,16,854,616,238,2003-7-16,378
2003,7,17,882,490,392,2003-7-17,98
2003,7,18,840,476,364,2003-7-18,112
2003,7,19,1092,462,630,2003-7-19,-168
2003,7,20,2016,714,1302,2003-7-20,-588
2003,7,21,1988,518,1470,2003-7-21,-952
2003,7,22,2380,518,1862,2003-7-22,-1344
2003,7,23,1988,434,1554,2003-7-23,-1120
2003,7,24,1442,280,1162,2003-7-24,-882
2003,7,25,476,224,252,2003-7-25,-28
2003,7,26,364,210,154,2003-7-26,56
2003,7,27,308,112,196,2003-7-27,-84
2003,7,28,868,322,546,2003-7-28,-224
2003,7,29,910,392,518,2003-7-29,-126
2003,7,30,630,308,322,2003-7-30,-14
2003,7,31,602,252,350,2003-7-31,-98
2003,8,1,686,140,546,2003-8-1,-406
2003,8,2,994,84,910,2003-8-2,-826
2003,8,3,1484,168,1316,2003-8-3,-1148
2003,8,4,1848,280,1568,2003-8-4,-1288
2003,8,5,1778,252,1526,2003-8-5,-1274
2003,8,6,1778,224,1554,2003-8-6,-1330
2003,8,7,1512,56,1456,2003-8-7,-1400
2003,8,8,1610,98,1512,2003-8-8,-1414
2003,8,9,1568,0,1568,2003-8-9,-1568
2003,8,10,1372,0,1372,2003-8-10,-1372
2003,8,11,1064,0,1064,2003-8-11,-1064
2003,8,12,896,0,896,2003-8-12,-896
2003,8,13,1120,0,1120,2003-8-13,-1120
2003,8,14,924,0,924,2003-8-14,-924
2003,8,15,756,0,756,2003-8-15,-756
2003,8,16,658,0,658,2003-8-16,-658
2003,8,17,756,154,602,2003-8-17,-448
2003,8,18,546,224,322,2003-8-18,-98
2003,8,19,518,224,294,2003-8-19,-70
2003,8,20,322,168,154,2003-8-20,14
2003,8,21,392,350,42,2003-8-21,308
2003,8,22,714,434,280,2003-8-22,154
2003,8,23,854,504,350,2003-8-23,154
2003,8,24,770,504,266,2003-8-24,238
2003,8,25,700,490,210,2003-8-25,280
2003,8,26,616,448,168,2003-8-26,280
2003,8,27,574,392,182,2003-8-27,210
2003,8,28,658,406,252,2003-8-28,154
2003,8,29,728,280,448,2003-8-29,-168
2003,8,30,672,280,392,2003-8-30,-112
2003,8,31,546,224,322,2003-8-31,-98
2003,9,1,308,56,252,2003-9-1,-196
2003,9,2,392,70,322,2003-9-2,-252
2003,9,3,378,28,350,2003-9-3,-322
2003,9,4,364,14,350,2003-9-4,-336
2003,9,5,406,0,406,2003-9-5,-406
2003,9,6,406,0,406,2003-9-6,-406
2003,9,7,294,0,294,2003-9-7,-294
2003,9,8,210,0,210,2003-9-8,-210
2003,9,9,84,0,84,2003-9-9,-84
2003,9,10,224,0,224,2003-9-10,-224
2003,9,11,294,0,294,2003-9-11,-294
2003,9,12,322,0,322,2003-9-12,-322
2003,9,13,378,0,378,2003-9-13,-378
2003,9,14,294,0,294,2003-9-14,-294
2003,9,15,280,56,224,2003-9-15,-168
2003,9,16,224,112,112,2003-9-16,0
2003,9,17,490,378,112,2003-9-17,266
2003,9,18,658,518,140,2003-9-18,378
2003,9,19,588,350,238,2003-9-19,112
2003,9,20,826,616,210,2003-9-20,406
2003,9,21,868,756,112,2003-9-21,644
2003,9,22,1036,868,168,2003-9-22,700
2003,9,23,1204,994,210,2003-9-23,784
2003,9,24,1050,896,154,2003-9-24,742
2003,9,25,1092,910,182,2003-9-25,728
2003,9,26,1022,896,126,2003-9-26,770
2003,9,27,1022,840,182,2003-9-27,658
2003,9,28,994,770,224,2003-9-28,546
2003,9,29,910,742,168,2003-9-29,574
2003,9,30,1190,714,476,2003-9-30,238
2003,10,1,1344,672,672,2003-10-1,0
2003,10,2,1162,322,840,2003-10-2,-518
2003,10,3,728,238,490,2003-10-3,-252
2003,10,4,546,0,546,2003-10-4,-546
2003,10,5,462,0,462,2003-10-5,-462
2003,10,6,532,0,532,2003-10-6,-532
2003,10,7,518,0,518,2003-10-7,-518
2003,10,8,574,0,574,2003-10-8,-574
2003,10,9,392,14,378,2003-10-9,-364
2003,10,10,350,42,308,2003-10-10,-266
2003,10,11,392,56,336,2003-10-11,-280
2003,10,12,182,28,154,2003-10-12,-126
2003,10,13,56,28,28,2003-10-13,0
2003,10,14,28,14,14,2003-10-14,0
2003,10,15,56,42,14,2003-10-15,28
2003,10,16,126,56,70,2003-10-16,-14
2003,10,17,210,112,98,2003-10-17,14
2003,10,18,518,462,56,2003-10-18,406
2003,10,19,1554,1526,28,2003-10-19,1498
2003,10,20,2100,2044,56,2003-10-20,1988
2003,10,21,2590,2436,154,2003-10-21,2282
2003,10,22,2730,2464,266,2003-10-22,2198
2003,10,23,4102,2450,1652,2003-10-23,798
2003,10,24,4200,2044,2156,2003-10-24,-112
2003,10,25,5684,2604,3080,2003-10-25,-476
2003,10,26,5278,2240,3038,2003-10-26,-798
2003,10,27,5978,2730,3248,2003-10-27,-518
2003,10,28,6328,3108,3220,2003-10-28,-112
2003,10,29,7224,2996,4228,2003-10-29,-1232
2003,10,30,7966,3136,4830,2003-10-30,-1694
2003,10,31,6188,2380,3808,2003-10-31,-1428
2003,11,1,5838,2408,3430,2003-11-1,-1022
2003,11,2,5670,2352,3318,2003-11-2,-966
2003,11,3,3962,1806,2156,2003-11-3,-350
2003,11,4,1540,490,1050,2003-11-4,-560
2003,11,5,182,28,154,2003-11-5,-126
2003,11,6,140,0,140,2003-11-6,-140
2003,11,7,168,0,168,2003-11-7,-168
2003,11,8,70,0,70,2003-11-8,-70
2003,11,9,140,0,140,2003-11-9,-140
2003,11,10,294,0,294,2003-11-10,-294
2003,11,11,392,0,392,2003-11-11,-392
2003,11,12,308,0,308,2003-11-12,-308
2003,11,13,630,476,154,2003-11-13,322
2003,11,14,490,490,0,2003-11-14,490
2003,11,15,504,504,0,2003-11-15,504
2003,11,16,546,546,0,2003-11-16,546
2003,11,17,560,532,28,2003-11-17,504
2003,11,18,1260,1092,168,2003-11-18,924
2003,11,19,2996,1820,1176,2003-11-19,644
2003,11,20,2814,1652,1162,2003-11-20,490
2003,11,21,2380,1554,826,2003-11-21,728
2003,11,22,2324,1484,840,2003-11-22,644
2003,11,23,2198,1484,714,2003-11-23,770
2003,11,24,2128,1246,882,2003-11-24,364
2003,11,25,1848,1120,728,2003-11-25,392
2003,11,26,1848,994,854,2003-11-26,140
2003,11,27,1372,868,504,2003-11-27,364
2003,11,28,2100,1288,812,2003-11-28,476
2003,11,29,1624,770,854,2003-11-29,-84
2003,11,30,1498,560,938,2003-11-30,-378
2003,12,1,1190,308,882,2003-12-1,-574
2003,12,2,826,84,742,2003-12-2,-658
2003,12,3,658,84,574,2003-12-3,-490
2003,12,4,812,56,756,2003-12-4,-700
2003,12,5,700,98,602,2003-12-5,-504
2003,12,6,560,84,476,2003-12-6,-392
2003,12,7,434,84,350,2003-12-7,-266
2003,12,8,378,126,252,2003-12-8,-126
2003,12,9,154,0,154,2003-12-9,-154
2003,12,10,434,168,266,2003-12-10,-98
2003,12,11,378,140,238,2003-12-11,-98
2003,12,12,308,140,168,2003-12-12,-28
2003,12,13,294,182,112,2003-12-13,70
2003,12,14,308,238,70,2003-12-14,168
2003,12,15,210,154,56,2003-12-15,98
2003,12,16,476,280,196,2003-12-16,84
2003,12,17,462,294,168,2003-12-17,126
2003,12,18,714,560,154,2003-12-18,406
2003,12,19,910,798,112,2003-12-19,686
2003,12,20,882,840,42,2003-12-20,798
2003,12,21,882,840,42,2003-12-21,798
2003,12,22,882,826,56,2003-12-22,770
2003,12,23,994,924,70,2003-12-23,854
2003,12,24,910,882,28,2003-12-24,854
2003,12,25,1092,1050,42,2003-12-25,1008
2003,12,26,1036,966,70,2003-12-26,896
2003,12,27,952,896,56,2003-12-27,840
2003,12,28,784,756,28,2003-12-28,728
2003,12,29,658,616,42,2003-12-29,574
2003,12,30,140,140,0,2003-12-30,140
2003,12,31,182,168,14,2003-12-31,154
2004,1,1,686,0,686,2004-1-1,-686
2004,1,2,1330,0,1330,2004-1-2,-1330
2004,1,3,1610,0,1610,2004-1-3,-1610
2004,1,4,1288,0,1288,2004-1-4,-1288
2004,1,5,1470,0,1470,2004-1-5,-1470
2004,1,6,1484,84,1400,2004-1-6,-1316
2004,1,7,1414,294,1120,2004-1-7,-826
2004,1,8,1414,322,1092,2004-1-8,-770
2004,1,9,1218,378,840,2004-1-9,-462
2004,1,10,1064,294,770,2004-1-10,-476
2004,1,11,966,294,672,2004-1-11,-378
2004,1,12,770,336,434,2004-1-12,-98
2004,1,13,1302,266,1036,2004-1-13,-770
2004,1,14,518,266,252,2004-1-14,14
2004,1,15,714,252,462,2004-1-15,-210
2004,1,16,812,308,504,2004-1-16,-196
2004,1,17,854,280,574,2004-1-17,-294
2004,1,18,546,70,476,2004-1-18,-406
2004,1,19,686,154,532,2004-1-19,-378
2004,1,20,756,336,420,2004-1-20,-84
2004,1,21,784,336,448,2004-1-21,-112
2004,1,22,560,308,252,2004-1-22,56
2004,1,23,364,196,168,2004-1-23,28
2004,1,24,322,98,224,2004-1-24,-126
2004,1,25,182,70,112,2004-1-25,-42
2004,1,26,42,28,14,2004-1-26,14
2004,1,27,0,0,0,2004-1-27,0
2004,1,28,0,0,0,2004-1-28,0
2004,1,29,98,0,98,2004-1-29,-98
2004,1,30,168,0,168,2004-1-30,-168
2004,1,31,224,140,84,2004-1-31,56
2004,2,1,392,266,126,2004-2-1,140
2004,2,2,616,336,280,2004-2-2,56
2004,2,3,728,308,420,2004-2-3,-112
2004,2,4,616,280,336,2004-2-4,-56
2004,2,5,616,168,448,2004-2-5,-280
2004,2,6,532,98,434,2004-2-6,-336
2004,2,7,560,126,434,2004-2-7,-308
2004,2,8,868,112,756,2004-2-8,-644
2004,2,9,1008,84,924,2004-2-9,-840
2004,2,10,728,42,686,2004-2-10,-644
2004,2,11,602,56,546,2004-2-11,-490
2004,2,12,588,42,546,2004-2-12,-504
2004,2,13,378,28,350,2004-2-13,-322
2004,2,14,294,42,252,2004-2-14,-210
2004,2,15,378,154,224,2004-2-15,-70
2004,2,16,266,112,154,2004-2-16,-42
2004,2,17,112,42,70,2004-2-17,-28
2004,2,18,112,28,84,2004-2-18,-56
2004,2,19,140,42,98,2004-2-19,-56
2004,2,20,140,14,126,2004-2-20,-112
2004,2,21,112,56,56,2004-2-21,0
2004,2,22,322,266,56,2004-2-22,210
2004,2,23,504,420,84,2004-2-23,336
2004,2,24,896,686,210,2004-2-24,476
2004,2,25,1078,770,308,2004-2-25,462
2004,2,26,1106,910,196,2004-2-26,714
2004,2,27,1554,1218,336,2004-2-27,882
2004,2,28,1498,1092,406,2004-2-28,686
2004,2,29,1232,910,322,2004-2-29,588
2004,3,1,462,182,280,2004-3-1,-98
2004,3,2,336,0,336,2004-3-2,-336
2004,3,3,336,0,336,2004-3-3,-336
2004,3,4,252,0,252,2004-3-4,-252
2004,3,5,420,0,420,2004-3-5,-420
2004,3,6,868,0,868,2004-3-6,-868
2004,3,7,952,0,952,2004-3-7,-952
2004,3,8,1120,0,1120,2004-3-8,-1120
2004,3,9,910,0,910,2004-3-9,-910
2004,3,10,1078,0,1078,2004-3-10,-1078
2004,3,11,840,0,840,2004-3-11,-840
2004,3,12,924,28,896,2004-3-12,-868
2004,3,13,798,154,644,2004-3-13,-490
2004,3,14,686,140,546,2004-3-14,-406
2004,3,15,490,126,364,2004-3-15,-238
2004,3,16,448,56,392,2004-3-16,-336
2004,3,17,630,56,574,2004-3-17,-518
2004,3,18,630,140,490,2004-3-18,-350
2004,3,19,490,112,378,2004-3-19,-266
2004,3,20,532,224,308,2004-3-20,-84
2004,3,21,448,308,140,2004-3-21,168
2004,3,22,364,224,140,2004-3-22,84
2004,3,23,532,336,196,2004-3-23,140
2004,3,24,630,266,364,2004-3-24,-98
2004,3,25,910,560,350,2004-3-25,210
2004,3,26,938,644,294,2004-3-26,350
2004,3,27,966,630,336,2004-3-27,294
2004,3,28,1120,630,490,2004-3-28,140
2004,3,29,1050,602,448,2004-3-29,154
2004,3,30,756,420,336,2004-3-30,84
2004,3,31,784,350,434,2004-3-31,-84
2004,4,1,756,308,448,2004-4-1,-140
2004,4,2,658,196,462,2004-4-2,-266
2004,4,3,616,196,420,2004-4-3,-224
2004,4,4,686,182,504,2004-4-4,-322
2004,4,5,728,238,490,2004-4-5,-252
2004,4,6,392,112,280,2004-4-6,-168
2004,4,7,294,14,280,2004-4-7,-266
2004,4,8,224,0,224,2004-4-8,-224
2004,4,9,168,0,168,2004-4-9,-168
2004,4,10,210,0,210,2004-4-10,-210
2004,4,11,126,0,126,2004-4-11,-126
2004,4,12,196,0,196,2004-4-12,-196
2004,4,13,182,0,182,2004-4-13,-182
2004,4,14,322,84,238,2004-4-14,-154
2004,4,15,252,84,168,2004-4-15,-84
2004,4,16,280,98,182,2004-4-16,-84
2004,4,17,182,70,112,2004-4-17,-42
2004,4,18,434,28,406,2004-4-18,-378
2004,4,19,616,14,602,2004-4-19,-588
2004,4,20,784,28,756,2004-4-20,-728
2004,4,21,686,0,686,2004-4-21,-686
2004,4,22,728,0,728,2004-4-22,-728
2004,4,23,630,0,630,2004-4-23,-630
2004,4,24,518,168,350,2004-4-24,-182
2004,4,25,560,238,322,2004-4-25,-84
2004,4,26,658,322,336,2004-4-26,-14
2004,4,27,434,196,238,2004-4-27,-42
2004,4,28,406,126,280,2004-4-28,-154
2004,4,29,280,112,168,2004-4-29,-56
2004,4,30,182,70,112,2004-4-30,-42
2004,5,1,238,42,196,2004-5-1,-154
2004,5,2,476,0,476,2004-5-2,-476
2004,5,3,378,0,378,2004-5-3,-378
2004,5,4,392,0,392,2004-5-4,-392
2004,5,5,406,0,406,2004-5-5,-406
2004,5,6,140,0,140,2004-5-6,-140
2004,5,7,252,0,252,2004-5-7,-252
2004,5,8,406,0,406,2004-5-8,-406
2004,5,9,392,0,392,2004-5-9,-392
2004,5,10,364,0,364,2004-5-10,-364
2004,5,11,420,0,420,2004-5-11,-420
2004,5,12,420,0,420,2004-5-12,-420
2004,5,13,630,14,616,2004-5-13,-602
2004,5,14,770,56,714,2004-5-14,-658
2004,5,15,1148,140,1008,2004-5-15,-868
2004,5,16,1190,294,896,2004-5-16,-602
2004,5,17,1190,420,770,2004-5-17,-350
2004,5,18,994,308,686,2004-5-18,-378
2004,5,19,742,196,546,2004-5-19,-350
2004,5,20,728,140,588,2004-5-20,-448
2004,5,21,658,140,518,2004-5-21,-378
2004,5,22,798,140,658,2004-5-22,-518
2004,5,23,728,98,630,2004-5-23,-532
2004,5,24,840,84,756,2004-5-24,-672
2004,5,25,728,70,658,2004-5-25,-588
2004,5,26,658,84,574,2004-5-26,-490
2004,5,27,560,98,462,2004-5-27,-364
2004,5,28,518,84,434,2004-5-28,-350
2004,5,29,882,0,882,2004-5-29,-882
2004,5,30,812,0,812,2004-5-30,-812
2004,5,31,588,0,588,2004-5-31,-588
2004,6,1,252,28,224,2004-6-1,-196
2004,6,2,224,14,210,2004-6-2,-196
2004,6,3,196,0,196,2004-6-3,-196
2004,6,4,112,0,112,2004-6-4,-112
2004,6,5,112,28,84,2004-6-5,-56
2004,6,6,84,14,70,2004-6-6,-56
2004,6,7,126,14,112,2004-6-7,-98
2004,6,8,182,14,168,2004-6-8,-154
2004,6,9,112,0,112,2004-6-9,-112
2004,6,10,266,0,266,2004-6-10,-266
2004,6,11,182,0,182,2004-6-11,-182
2004,6,12,126,0,126,2004-6-12,-126
2004,6,13,308,168,140,2004-6-13,28
2004,6,14,784,490,294,2004-6-14,196
2004,6,15,1204,518,686,2004-6-15,-168
2004,6,16,1428,532,896,2004-6-16,-364
2004,6,17,1302,546,756,2004-6-17,-210
2004,6,18,1386,588,798,2004-6-18,-210
2004,6,19,1246,504,742,2004-6-19,-238
2004,6,20,1512,518,994,2004-6-20,-476
2004,6,21,1302,448,854,2004-6-21,-406
2004,6,22,994,294,700,2004-6-22,-406
2004,6,23,896,224,672,2004-6-23,-448
2004,6,24,1064,336,728,2004-6-24,-392
2004,6,25,784,210,574,2004-6-25,-364
2004,6,26,546,42,504,2004-6-26,-462
2004,6,27,392,42,350,2004-6-27,-308
2004,6,28,196,140,56,2004-6-28,84
2004,6,29,322,252,70,2004-6-29,182
2004,6,30,168,140,28,2004-6-30,112
2004,7,1,154,70,84,2004-7-1,-14
2004,7,2,154,126,28,2004-7-2,98
2004,7,3,126,84,42,2004-7-3,42
2004,7,4,70,56,14,2004-7-4,42
2004,7,5,70,28,42,2004-7-5,-14
2004,7,6,42,28,14,2004-7-6,14
2004,7,7,70,28,42,2004-7-7,-14
2004,7,8,70,0,70,2004-7-8,-70
2004,7,9,126,0,126,2004-7-9,-126
2004,7,10,322,168,154,2004-7-10,14
2004,7,11,448,238,210,2004-7-11,28
2004,7,12,616,308,308,2004-7-12,0
2004,7,13,1358,574,784,2004-7-13,-210
2004,7,14,1162,490,672,2004-7-14,-182
2004,7,15,882,196,686,2004-7-15,-490
2004,7,16,1512,644,868,2004-7-16,-224
2004,7,17,2198,1260,938,2004-7-17,322
2004,7,18,3220,2072,1148,2004-7-18,924
2004,7,19,3255,2345,910,2004-7-19,1435
2004,7,20,3066,2478,588,2004-7-20,1890
2004,7,21,3388,2940,448,2004-7-21,2492
2004,7,22,2898,2506,392,2004-7-22,2114
2004,7,23,2870,2576,294,2004-7-23,2282
2004,7,24,2422,2254,168,2004-7-24,2086
2004,7,25,2016,1918,98,2004-7-25,1820
2004,7,26,1722,1610,112,2004-7-26,1498
2004,7,27,1582,1484,98,2004-7-27,1386
2004,7,28,1344,1316,28,2004-7-28,1288
2004,7,29,560,560,0,2004-7-29,560
2004,7,30,322,168,154,2004-7-30,14
2004,7,31,378,140,238,2004-7-31,-98
2004,8,1,364,112,252,2004-8-1,-140
2004,8,2,378,140,238,2004-8-2,-98
2004,8,3,364,84,280,2004-8-3,-196
2004,8,4,308,42,266,2004-8-4,-224
2004,8,5,238,0,238,2004-8-5,-238
2004,8,6,392,112,280,2004-8-6,-168
2004,8,7,784,84,700,2004-8-7,-616
2004,8,8,686,56,630,2004-8-8,-574
2004,8,9,1176,56,1120,2004-8-9,-1064
2004,8,10,1204,84,1120,2004-8-10,-1036
2004,8,11,1554,140,1414,2004-8-11,-1274
2004,8,12,2114,196,1918,2004-8-12,-1722
2004,8,13,2520,560,1960,2004-8-13,-1400
2004,8,14,2366,504,1862,2004-8-14,-1358
2004,8,15,2422,574,1848,2004-8-15,-1274
2004,8,16,2534,658,1876,2004-8-16,-1218
2004,8,17,1974,658,1316,2004-8-17,-658
2004,8,18,1050,784,266,2004-8-18,518
2004,8,19,924,924,0,2004-8-19,924
2004,8,20,1176,1134,42,2004-8-20,1092
2004,8,21,1190,1064,126,2004-8-21,938
2004,8,22,1078,938,140,2004-8-22,798
2004,8,23,980,812,168,2004-8-23,644
2004,8,24,784,588,196,2004-8-24,392
2004,8,25,770,616,154,2004-8-25,462
2004,8,26,336,168,168,2004-8-26,0
2004,8,27,238,112,126,2004-8-27,-14
2004,8,28,238,112,126,2004-8-28,-14
2004,8,29,140,56,84,2004-8-29,-28
2004,8,30,196,196,0,2004-8-30,196
2004,8,31,70,70,0,2004-8-31,70
2004,9,1,252,0,252,2004-9-1,-252
2004,9,2,364,14,350,2004-9-2,-336
2004,9,3,378,0,378,2004-9-3,-378
2004,9,4,546,0,546,2004-9-4,-546
2004,9,5,476,0,476,2004-9-5,-476
2004,9,6,546,0,546,2004-9-6,-546
2004,9,7,672,0,672,2004-9-7,-672
2004,9,8,770,0,770,2004-9-8,-770
2004,9,9,1330,420,910,2004-9-9,-490
2004,9,10,1414,364,1050,2004-9-10,-686
2004,9,11,980,378,602,2004-9-11,-224
2004,9,12,798,364,434,2004-9-12,-70
2004,9,13,714,378,336,2004-9-13,42
2004,9,14,518,434,84,2004-9-14,350
2004,9,15,644,448,196,2004-9-15,252
2004,9,16,658,322,336,2004-9-16,-14
2004,9,17,658,210,448,2004-9-17,-238
2004,9,18,644,140,504,2004-9-18,-364
2004,9,19,518,98,420,2004-9-19,-322
2004,9,20,560,112,448,2004-9-20,-336
2004,9,21,476,70,406,2004-9-21,-336
2004,9,22,364,0,364,2004-9-22,-364
2004,9,23,336,0,336,2004-9-23,-336
2004,9,24,336,0,336,2004-9-24,-336
2004,9,25,518,0,518,2004-9-25,-518
2004,9,26,378,0,378,2004-9-26,-378
2004,9,27,434,0,434,2004-9-27,-434
2004,9,28,224,0,224,2004-9-28,-224
2004,9,29,210,0,210,2004-9-29,-210
2004,9,30,266,42,224,2004-9-30,-182
2004,10,1,210,14,196,2004-10-1,-182
2004,10,2,196,14,182,2004-10-2,-168
2004,10,3,182,28,154,2004-10-3,-126
2004,10,4,196,28,168,2004-10-4,-140
2004,10,5,168,14,154,2004-10-5,-140
2004,10,6,182,56,126,2004-10-6,-70
2004,10,7,196,84,112,2004-10-7,-28
2004,10,8,140,112,28,2004-10-8,84
2004,10,9,154,126,28,2004-10-9,98
2004,10,10,0,0,0,2004-10-10,0
2004,10,11,0,0,0,2004-10-11,0
2004,10,12,14,14,0,2004-10-12,14
2004,10,13,266,28,238,2004-10-13,-210
2004,10,14,371,28,343,2004-10-14,-315
2004,10,15,336,0,336,2004-10-15,-336
2004,10,16,308,14,294,2004-10-16,-280
2004,10,17,294,0,294,2004-10-17,-294
2004,10,18,322,0,322,2004-10-18,-322
2004,10,19,532,168,364,2004-10-19,-196
2004,10,20,644,224,420,2004-10-20,-196
2004,10,21,770,378,392,2004-10-21,-14
2004,10,22,1232,560,672,2004-10-22,-112
2004,10,23,1008,602,406,2004-10-23,196
2004,10,24,1148,770,378,2004-10-24,392
2004,10,25,1204,812,392,2004-10-25,420
2004,10,26,1120,868,252,2004-10-26,616
2004,10,27,1218,924,294,2004-10-27,630
2004,10,28,1456,658,798,2004-10-28,-140
2004,10,29,1512,574,938,2004-10-29,-364
2004,10,30,1400,518,882,2004-10-30,-364
2004,10,31,1834,532,1302,2004-10-31,-770
2004,11,1,1624,350,1274,2004-11-1,-924
2004,11,2,1498,392,1106,2004-11-2,-714
2004,11,3,1736,658,1078,2004-11-3,-420
2004,11,4,1820,938,882,2004-11-4,56
2004,11,5,1960,1148,812,2004-11-5,336
2004,11,6,1918,1288,630,2004-11-6,658
2004,11,7,1372,924,448,2004-11-7,476
2004,11,8,1218,840,378,2004-11-8,462
2004,11,9,1372,1022,350,2004-11-9,672
2004,11,10,700,658,42,2004-11-10,616
2004,11,11,770,616,154,2004-11-11,462
2004,11,12,322,140,182,2004-11-12,-42
2004,11,13,308,112,196,2004-11-13,-84
2004,11,14,322,112,210,2004-11-14,-98
2004,11,15,448,280,168,2004-11-15,112
2004,11,16,574,448,126,2004-11-16,322
2004,11,17,462,252,210,2004-11-17,42
2004,11,18,294,126,168,2004-11-18,-42
2004,11,19,294,140,154,2004-11-19,-14
2004,11,20,252,154,98,2004-11-20,56
2004,11,21,168,126,42,2004-11-21,84
2004,11,22,196,154,42,2004-11-22,112
2004,11,23,266,126,140,2004-11-23,-14
2004,11,24,448,140,308,2004-11-24,-168
2004,11,25,434,98,336,2004-11-25,-238
2004,11,26,658,252,406,2004-11-26,-154
2004,11,27,588,182,406,2004-11-27,-224
2004,11,28,658,210,448,2004-11-28,-238
2004,11,29,616,210,406,2004-11-29,-196
2004,11,30,588,182,406,2004-11-30,-224
2004,12,1,630,182,448,2004-12-1,-266
2004,12,2,658,210,448,2004-12-2,-238
2004,12,3,630,252,378,2004-12-3,-126
2004,12,4,392,126,266,2004-12-4,-140
2004,12,5,322,112,210,2004-12-5,-98
2004,12,6,322,154,168,2004-12-6,-14
2004,12,7,140,140,0,2004-12-7,140
2004,12,8,168,140,28,2004-12-8,112
2004,12,9,140,126,14,2004-12-9,112
2004,12,10,56,42,14,2004-12-10,28
2004,12,11,70,70,0,2004-12-11,70
2004,12,12,140,140,0,2004-12-12,140
2004,12,13,168,168,0,2004-12-13,168
2004,12,14,182,182,0,2004-12-14,182
2004,12,15,238,210,28,2004-12-15,182
2004,12,16,42,0,42,2004-12-16,-42
2004,12,17,196,0,196,2004-12-17,-196
2004,12,18,196,0,196,2004-12-18,-196
2004,12,19,182,0,182,2004-12-19,-182
2004,12,20,294,0,294,2004-12-20,-294
2004,12,21,294,0,294,2004-12-21,-294
2004,12,22,280,0,280,2004-12-22,-280
2004,12,23,322,0,322,2004-12-23,-322
2004,12,24,294,0,294,2004-12-24,-294
2004,12,25,140,0,140,2004-12-25,-140
2004,12,26,126,0,126,2004-12-26,-126
2004,12,27,140,0,140,2004-12-27,-140
2004,12,28,322,112,210,2004-12-28,-98
2004,12,29,574,364,210,2004-12-29,154
2004,12,30,504,490,14,2004-12-30,476
2004,12,31,350,322,28,2004-12-31,294
2005,1,1,322,294,28,2005-1-1,266
2005,1,2,350,336,14,2005-1-2,322
2005,1,3,224,182,42,2005-1-3,140
2005,1,4,56,56,0,2005-1-4,56
2005,1,5,42,42,0,2005-1-5,42
2005,1,6,42,42,0,2005-1-6,42
2005,1,7,112,28,84,2005-1-7,-56
2005,1,8,238,28,210,2005-1-8,-182
2005,1,9,266,0,266,2005-1-9,-266
2005,1,10,252,14,238,2005-1-10,-224
2005,1,11,168,70,98,2005-1-11,-28
2005,1,12,840,588,252,2005-1-12,336
2005,1,13,1736,1512,224,2005-1-13,1288
2005,1,14,2506,2156,350,2005-1-14,1806
2005,1,15,2772,2268,504,2005-1-15,1764
2005,1,16,2744,2282,462,2005-1-16,1820
2005,1,17,2478,2142,336,2005-1-17,1806
2005,1,18,2310,2100,210,2005-1-18,1890
2005,1,19,1960,1806,154,2005-1-19,1652
2005,1,20,2212,2072,140,2005-1-20,1932
2005,1,21,1806,1624,182,2005-1-21,1442
2005,1,22,1722,1428,294,2005-1-22,1134
2005,1,23,322,98,224,2005-1-23,-126
2005,1,24,700,98,602,2005-1-24,-504
2005,1,25,462,70,392,2005-1-25,-322
2005,1,26,224,70,154,2005-1-26,-84
2005,1,27,196,70,126,2005-1-27,-56
2005,1,28,210,98,112,2005-1-28,-14
2005,1,29,224,126,98,2005-1-29,28
2005,1,30,168,0,168,2005-1-30,-168
2005,1,31,252,0,252,2005-1-31,-252
2005,2,1,238,0,238,2005-2-1,-238
2005,2,2,210,0,210,2005-2-2,-210
2005,2,3,70,0,70,2005-2-3,-70
2005,2,4,112,0,112,2005-2-4,-112
2005,2,5,56,0,56,2005-2-5,-56
2005,2,6,196,56,140,2005-2-6,-84
2005,2,7,504,126,378,2005-2-7,-252
2005,2,8,504,70,434,2005-2-8,-364
2005,2,9,686,84,602,2005-2-9,-518
2005,2,10,742,56,686,2005-2-10,-630
2005,2,11,1260,56,1204,2005-2-11,-1148
2005,2,12,1106,126,980,2005-2-12,-854
2005,2,13,1008,42,966,2005-2-13,-924
2005,2,14,1064,14,1050,2005-2-14,-1036
2005,2,15,966,28,938,2005-2-15,-910
2005,2,16,1008,0,1008,2005-2-16,-1008
2005,2,17,868,0,868,2005-2-17,-868
2005,2,18,826,0,826,2005-2-18,-826
2005,2,19,728,0,728,2005-2-19,-728
2005,2,20,812,42,770,2005-2-20,-728
2005,2,21,784,168,616,2005-2-21,-448
2005,2,22,714,294,420,2005-2-22,-126
2005,2,23,280,126,154,2005-2-23,-28
2005,2,24,56,0,56,2005-2-24,-56
2005,2,25,42,0,42,2005-2-25,-42
2005,2,26,98,0,98,2005-2-26,-98
2005,2,27,28,0,28,2005-2-27,-28
2005,2,28,0,0,0,2005-2-28,0
2005,3,1,14,0,14,2005-3-1,-14
2005,3,2,28,0,28,2005-3-2,-28
2005,3,3,28,0,28,2005-3-3,-28
2005,3,4,154,154,0,2005-3-4,154
2005,3,5,154,154,0,2005-3-5,154
2005,3,6,112,112,0,2005-3-6,112
2005,3,7,196,84,112,2005-3-7,-28
2005,3,8,224,56,168,2005-3-8,-112
2005,3,9,784,84,700,2005-3-9,-616
2005,3,10,658,140,518,2005-3-10,-378
2005,3,11,686,154,532,2005-3-11,-378
2005,3,12,742,42,700,2005-3-12,-658
2005,3,13,910,84,826,2005-3-13,-742
2005,3,14,896,98,798,2005-3-14,-700
2005,3,15,1008,140,868,2005-3-15,-728
2005,3,16,938,0,938,2005-3-16,-938
2005,3,17,756,0,756,2005-3-17,-756
2005,3,18,840,0,840,2005-3-18,-840
2005,3,19,896,0,896,2005-3-19,-896
2005,3,20,518,0,518,2005-3-20,-518
2005,3,21,462,28,434,2005-3-21,-406
2005,3,22,504,154,350,2005-3-22,-196
2005,3,23,308,126,182,2005-3-23,-56
2005,3,24,238,140,98,2005-3-24,42
2005,3,25,406,266,140,2005-3-25,126
2005,3,26,196,126,70,2005-3-26,56
2005,3,27,168,126,42,2005-3-27,84
2005,3,28,84,84,0,2005-3-28,84
2005,3,29,42,42,0,2005-3-29,42
2005,3,30,14,14,0,2005-3-30,14
2005,3,31,42,28,14,2005-3-31,14
2005,4,1,84,28,56,2005-4-1,-28
2005,4,2,140,42,98,2005-4-2,-56
2005,4,3,168,14,154,2005-4-3,-140
2005,4,4,238,28,210,2005-4-4,-182
2005,4,5,406,28,378,2005-4-5,-350
2005,4,6,252,14,238,2005-4-6,-224
2005,4,7,336,0,336,2005-4-7,-336
2005,4,8,350,0,350,2005-4-8,-350
2005,4,9,266,0,266,2005-4-9,-266
2005,4,10,196,0,196,2005-4-10,-196
2005,4,11,126,0,126,2005-4-11,-126
2005,4,12,224,112,112,2005-4-12,0
2005,4,13,308,224,84,2005-4-13,140
2005,4,14,406,238,168,2005-4-14,70
2005,4,15,322,210,112,2005-4-15,98
2005,4,16,224,140,84,2005-4-16,56
2005,4,17,280,154,126,2005-4-17,28
2005,4,18,252,154,98,2005-4-18,56
2005,4,19,196,154,42,2005-4-19,112
2005,4,20,182,112,70,2005-4-20,42
2005,4,21,98,84,14,2005-4-21,70
2005,4,22,112,84,28,2005-4-22,56
2005,4,23,112,84,28,2005-4-23,56
2005,4,24,0,0,0,2005-4-24,0
2005,4,25,476,0,476,2005-4-25,-476
2005,4,26,770,0,770,2005-4-26,-770
2005,4,27,1078,0,1078,2005-4-27,-1078
2005,4,28,1484,0,1484,2005-4-28,-1484
2005,4,29,1302,0,1302,2005-4-29,-1302
2005,4,30,1484,0,1484,2005-4-30,-1484
2005,5,1,1274,0,1274,2005-5-1,-1274
2005,5,2,1358,0,1358,2005-5-2,-1358
2005,5,3,1456,0,1456,2005-5-3,-1456
2005,5,4,1456,0,1456,2005-5-4,-1456
2005,5,5,1162,0,1162,2005-5-5,-1162
2005,5,6,1218,0,1218,2005-5-6,-1218
2005,5,7,560,0,560,2005-5-7,-560
2005,5,8,714,476,238,2005-5-8,238
2005,5,9,1274,798,476,2005-5-9,322
2005,5,10,1218,560,658,2005-5-10,-98
2005,5,11,1862,630,1232,2005-5-11,-602
2005,5,12,1596,420,1176,2005-5-12,-756
2005,5,13,1792,434,1358,2005-5-13,-924
2005,5,14,1008,490,518,2005-5-14,-28
2005,5,15,686,406,280,2005-5-15,126
2005,5,16,728,420,308,2005-5-16,112
2005,5,17,504,308,196,2005-5-17,112
2005,5,18,560,392,168,2005-5-18,224
2005,5,19,434,420,14,2005-5-19,406
2005,5,20,238,238,0,2005-5-20,238
2005,5,21,182,98,84,2005-5-21,14
2005,5,22,280,140,140,2005-5-22,0
2005,5,23,210,70,140,2005-5-23,-70
2005,5,24,238,56,182,2005-5-24,-126
2005,5,25,252,56,196,2005-5-25,-140
2005,5,26,266,42,224,2005-5-26,-182
2005,5,27,378,14,364,2005-5-27,-350
2005,5,28,546,28,518,2005-5-28,-490
2005,5,29,322,28,294,2005-5-29,-266
2005,5,30,504,140,364,2005-5-30,-224
2005,5,31,378,56,322,2005-5-31,-266
2005,6,1,700,56,644,2005-6-1,-588
2005,6,2,378,14,364,2005-6-2,-350
2005,6,3,364,0,364,2005-6-3,-364
2005,6,4,728,238,490,2005-6-4,-252
2005,6,5,882,238,644,2005-6-5,-406
2005,6,6,1064,308,756,2005-6-6,-448
2005,6,7,1442,392,1050,2005-6-7,-658
2005,6,8,1582,406,1176,2005-6-8,-770
2005,6,9,1582,504,1078,2005-6-9,-574
2005,6,10,1498,504,994,2005-6-10,-490
2005,6,11,1288,476,812,2005-6-11,-336
2005,6,12,1176,504,672,2005-6-12,-168
2005,6,13,980,406,574,2005-6-13,-168
2005,6,14,784,280,504,2005-6-14,-224
2005,6,15,1022,364,658,2005-6-15,-294
2005,6,16,910,196,714,2005-6-16,-518
2005,6,17,742,0,742,2005-6-17,-742
2005,6,18,742,0,742,2005-6-18,-742
2005,6,19,700,0,700,2005-6-19,-700
2005,6,20,560,0,560,2005-6-20,-560
2005,6,21,476,0,476,2005-6-21,-476
2005,6,22,350,0,350,2005-6-22,-350
2005,6,23,42,0,42,2005-6-23,-42
2005,6,24,28,0,28,2005-6-24,-28
2005,6,25,14,0,14,2005-6-25,-14
2005,6,26,0,0,0,2005-6-26,0
2005,6,27,84,84,0,2005-6-27,84
2005,6,28,126,126,0,2005-6-28,126
2005,6,29,252,182,70,2005-6-29,112
2005,6,30,560,168,392,2005-6-30,-224
2005,7,1,882,280,602,2005-7-1,-322
2005,7,2,1960,644,1316,2005-7-2,-672
2005,7,3,2044,504,1540,2005-7-3,-1036
2005,7,4,1610,574,1036,2005-7-4,-462
2005,7,5,1834,770,1064,2005-7-5,-294
2005,7,6,1582,742,840,2005-7-6,-98
2005,7,7,1610,896,714,2005-7-7,182
2005,7,8,1526,840,686,2005-7-8,154
2005,7,9,1134,672,462,2005-7-9,210
2005,7,10,770,672,98,2005-7-10,574
2005,7,11,686,588,98,2005-7-11,490
2005,7,12,518,476,42,2005-7-12,434
2005,7,13,616,546,70,2005-7-13,476
2005,7,14,560,462,98,2005-7-14,364
2005,7,15,182,28,154,2005-7-15,-126
2005,7,16,266,0,266,2005-7-16,-266
2005,7,17,84,0,84,2005-7-17,-84
2005,7,18,0,0,0,2005-7-18,0
2005,7,19,0,0,0,2005-7-19,0
2005,7,20,0,0,0,2005-7-20,0
2005,7,21,0,0,0,2005-7-21,0
2005,7,22,0,0,0,2005-7-22,0
2005,7,23,126,126,0,2005-7-23,126
2005,7,24,154,154,0,2005-7-24,154
2005,7,25,182,182,0,2005-7-25,182
2005,7,26,224,224,0,2005-7-26,224
2005,7,27,182,182,0,2005-7-27,182
2005,7,28,476,476,0,2005-7-28,476
2005,7,29,756,756,0,2005-7-29,756
2005,7,30,812,812,0,2005-7-30,812
2005,7,31,924,840,84,2005-7-31,756
2005,8,1,1092,938,154,2005-8-1,784
2005,8,2,924,714,210,2005-8-2,504
2005,8,3,798,490,308,2005-8-3,182
2005,8,4,700,392,308,2005-8-4,84
2005,8,5,672,350,322,2005-8-5,28
2005,8,6,588,280,308,2005-8-6,-28
2005,8,7,560,238,322,2005-8-7,-84
2005,8,8,518,238,280,2005-8-8,-42
2005,8,9,504,210,294,2005-8-9,-84
2005,8,10,266,84,182,2005-8-10,-98
2005,8,11,308,56,252,2005-8-11,-196
2005,8,12,294,42,252,2005-8-12,-210
2005,8,13,154,42,112,2005-8-13,-70
2005,8,14,266,0,266,2005-8-14,-266
2005,8,15,238,0,238,2005-8-15,-238
2005,8,16,196,0,196,2005-8-16,-196
2005,8,17,154,0,154,2005-8-17,-154
2005,8,18,182,0,182,2005-8-18,-182
2005,8,19,448,42,406,2005-8-19,-364
2005,8,20,952,98,854,2005-8-20,-756
2005,8,21,952,56,896,2005-8-21,-840
2005,8,22,1204,182,1022,2005-8-22,-840
2005,8,23,1204,252,952,2005-8-23,-700
2005,8,24,980,350,630,2005-8-24,-280
2005,8,25,630,616,14,2005-8-25,602
2005,8,26,406,406,0,2005-8-26,406
2005,8,27,392,308,84,2005-8-27,224
2005,8,28,378,238,140,2005-8-28,98
2005,8,29,378,154,224,2005-8-29,-70
2005,8,30,210,56,154,2005-8-30,-98
2005,8,31,168,28,140,2005-8-31,-112
2005,9,1,112,0,112,2005-9-1,-112
2005,9,2,112,0,112,2005-9-2,-112
2005,9,3,84,0,84,2005-9-3,-84
2005,9,4,84,0,84,2005-9-4,-84
2005,9,5,56,0,56,2005-9-5,-56
2005,9,6,56,0,56,2005-9-6,-56
2005,9,7,14,0,14,2005-9-7,-14
2005,9,8,770,56,714,2005-9-8,-658
2005,9,9,2030,28,2002,2005-9-9,-1974
2005,9,10,1988,28,1960,2005-9-10,-1932
2005,9,11,1778,28,1750,2005-9-11,-1722
2005,9,12,1176,0,1176,2005-9-12,-1176
2005,9,13,1204,28,1176,2005-9-13,-1148
2005,9,14,1400,0,1400,2005-9-14,-1400
2005,9,15,1232,0,1232,2005-9-15,-1232
2005,9,16,868,0,868,2005-9-16,-868
2005,9,17,658,70,588,2005-9-17,-518
2005,9,18,714,238,476,2005-9-18,-238
2005,9,19,644,252,392,2005-9-19,-140
2005,9,20,350,350,0,2005-9-20,350
2005,9,21,294,294,0,2005-9-21,294
2005,9,22,322,322,0,2005-9-22,322
2005,9,23,392,350,42,2005-9-23,308
2005,9,24,308,266,42,2005-9-24,224
2005,9,25,238,210,28,2005-9-25,182
2005,9,26,224,196,28,2005-9-26,168
2005,9,27,294,266,28,2005-9-27,238
2005,9,28,280,252,28,2005-9-28,224
2005,9,29,238,210,28,2005-9-29,182
2005,9,30,28,0,28,2005-9-30,-28
2005,10,1,0,0,0,2005-10-1,0
2005,10,2,0,0,0,2005-10-2,0
2005,10,3,0,0,0,2005-10-3,0
2005,10,4,84,0,84,2005-10-4,-84
2005,10,5,210,0,210,2005-10-5,-210
2005,10,6,182,0,182,2005-10-6,-182
2005,10,7,168,0,168,2005-10-7,-168
2005,10,8,112,0,112,2005-10-8,-112
2005,10,9,42,0,42,2005-10-9,-42
2005,10,10,28,0,28,2005-10-10,-28
2005,10,11,70,0,70,2005-10-11,-70
2005,10,12,56,0,56,2005-10-12,-56
2005,10,13,14,0,14,2005-10-13,-14
2005,10,14,70,70,0,2005-10-14,70
2005,10,15,98,98,0,2005-10-15,98
2005,10,16,70,70,0,2005-10-16,70
2005,10,17,56,56,0,2005-10-17,56
2005,10,18,42,42,0,2005-10-18,42
2005,10,19,70,42,28,2005-10-19,14
2005,10,20,28,28,0,2005-10-20,28
2005,10,21,28,28,0,2005-10-21,28
2005,10,22,28,28,0,2005-10-22,28
2005,10,23,14,14,0,2005-10-23,14
2005,10,24,0,0,0,2005-10-24,0
2005,10,25,0,0,0,2005-10-25,0
2005,10,26,0,0,0,2005-10-26,0
2005,10,27,0,0,0,2005-10-27,0
2005,10,28,0,0,0,2005-10-28,0
2005,10,29,14,0,14,2005-10-29,-14
2005,10,30,56,0,56,2005-10-30,-56
2005,10,31,84,0,84,2005-10-31,-84
2005,11,1,112,0,112,2005-11-1,-112
2005,11,2,98,0,98,2005-11-2,-98
2005,11,3,56,0,56,2005-11-3,-56
2005,11,4,28,0,28,2005-11-4,-28
2005,11,5,70,0,70,2005-11-5,-70
2005,11,6,98,0,98,2005-11-6,-98
2005,11,7,252,0,252,2005-11-7,-252
2005,11,8,168,0,168,2005-11-8,-168
2005,11,9,42,0,42,2005-11-9,-42
2005,11,10,0,0,0,2005-11-10,0
2005,11,11,0,0,0,2005-11-11,0
2005,11,12,168,0,168,2005-11-12,-168
2005,11,13,168,0,168,2005-11-13,-168
2005,11,14,854,0,854,2005-11-14,-854
2005,11,15,1134,0,1134,2005-11-15,-1134
2005,11,16,1036,0,1036,2005-11-16,-1036
2005,11,17,1008,0,1008,2005-11-17,-1008
2005,11,18,966,0,966,2005-11-18,-966
2005,11,19,910,0,910,2005-11-19,-910
2005,11,20,980,0,980,2005-11-20,-980
2005,11,21,826,0,826,2005-11-21,-826
2005,11,22,840,0,840,2005-11-22,-840
2005,11,23,574,0,574,2005-11-23,-574
2005,11,24,448,0,448,2005-11-24,-448
2005,11,25,294,0,294,2005-11-25,-294
2005,11,26,112,0,112,2005-11-26,-112
2005,11,27,98,0,98,2005-11-27,-98
2005,11,28,140,0,140,2005-11-28,-140
2005,11,29,126,0,126,2005-11-29,-126
2005,11,30,336,70,266,2005-11-30,-196
2005,12,1,546,70,476,2005-12-1,-406
2005,12,2,1008,182,826,2005-12-2,-644
2005,12,3,770,140,630,2005-12-3,-490
2005,12,4,812,154,658,2005-12-4,-504
2005,12,5,588,126,462,2005-12-5,-336
2005,12,6,392,42,350,2005-12-6,-308
2005,12,7,196,84,112,2005-12-7,-28
2005,12,8,308,98,210,2005-12-8,-112
2005,12,9,392,140,252,2005-12-9,-112
2005,12,10,490,322,168,2005-12-10,154
2005,12,11,476,364,112,2005-12-11,252
2005,12,12,378,308,70,2005-12-12,238
2005,12,13,476,308,168,2005-12-13,140
2005,12,14,476,210,266,2005-12-14,-56
2005,12,15,504,224,280,2005-12-15,-56
2005,12,16,476,154,322,2005-12-16,-168
2005,12,17,336,154,182,2005-12-17,-28
2005,12,18,378,140,238,2005-12-18,-98
2005,12,19,546,168,378,2005-12-19,-210
2005,12,20,518,154,364,2005-12-20,-210
2005,12,21,364,112,252,2005-12-21,-140
2005,12,22,392,238,154,2005-12-22,84
2005,12,23,406,280,126,2005-12-23,154
2005,12,24,476,336,140,2005-12-24,196
2005,12,25,420,308,112,2005-12-25,196
2005,12,26,616,518,98,2005-12-26,420
2005,12,27,490,420,70,2005-12-27,350
2005,12,28,322,280,42,2005-12-28,238
2005,12,29,476,280,196,2005-12-29,84
2005,12,30,364,238,126,2005-12-30,112
2005,12,31,350,294,56,2005-12-31,238
2006,1,1,280,266,14,2006-1-1,252
2006,1,2,238,224,14,2006-1-2,210
2006,1,3,168,168,0,2006-1-3,168
2006,1,4,168,168,0,2006-1-4,168
2006,1,5,126,126,0,2006-1-5,126
2006,1,6,84,84,0,2006-1-6,84
2006,1,7,70,70,0,2006-1-7,70
2006,1,8,56,56,0,2006-1-8,56
2006,1,9,42,42,0,2006-1-9,42
2006,1,10,28,28,0,2006-1-10,28
2006,1,11,28,28,0,2006-1-11,28
2006,1,12,28,28,0,2006-1-12,28
2006,1,13,0,0,0,2006-1-13,0
2006,1,14,0,0,0,2006-1-14,0
2006,1,15,98,56,42,2006-1-15,14
2006,1,16,182,98,84,2006-1-16,14
2006,1,17,182,98,84,2006-1-17,14
2006,1,18,224,70,154,2006-1-18,-84
2006,1,19,266,28,238,2006-1-19,-210
2006,1,20,238,0,238,2006-1-20,-238
2006,1,21,280,0,280,2006-1-21,-280
2006,1,22,364,0,364,2006-1-22,-364
2006,1,23,378,42,336,2006-1-23,-294
2006,1,24,476,14,462,2006-1-24,-448
2006,1,25,294,14,280,2006-1-25,-266
2006,1,26,182,0,182,2006-1-26,-182
2006,1,27,154,0,154,2006-1-27,-154
2006,1,28,42,0,42,2006-1-28,-42
2006,1,29,0,0,0,2006-1-29,0
2006,1,30,0,0,0,2006-1-30,0
2006,1,31,0,0,0,2006-1-31,0
2006,2,1,0,0,0,2006-2-1,0
2006,2,2,0,0,0,2006-2-2,0
2006,2,3,0,0,0,2006-2-3,0
2006,2,4,0,0,0,2006-2-4,0
2006,2,5,0,0,0,2006-2-5,0
2006,2,6,0,0,0,2006-2-6,0
2006,2,7,0,0,0,2006-2-7,0
2006,2,8,14,0,14,2006-2-8,-14
2006,2,9,28,0,28,2006-2-9,-28
2006,2,10,28,0,28,2006-2-10,-28
2006,2,11,42,0,42,2006-2-11,-42
2006,2,12,0,0,0,2006-2-12,0
2006,2,13,0,0,0,2006-2-13,0
2006,2,14,0,0,0,2006-2-14,0
2006,2,15,42,0,42,2006-2-15,-42
2006,2,16,70,28,42,2006-2-16,-14
2006,2,17,28,14,14,2006-2-17,0
2006,2,18,0,0,0,2006-2-18,0
2006,2,19,0,0,0,2006-2-19,0
2006,2,20,0,0,0,2006-2-20,0
2006,2,21,0,0,0,2006-2-21,0
2006,2,22,0,0,0,2006-2-22,0
2006,2,23,0,0,0,2006-2-23,0
2006,2,24,0,0,0,2006-2-24,0
2006,2,25,0,0,0,2006-2-25,0
2006,2,26,0,0,0,2006-2-26,0
2006,2,27,14,0,14,2006-2-27,-14
2006,2,28,28,0,28,2006-2-28,-28
2006,3,1,0,0,0,2006-3-1,0
2006,3,2,0,0,0,2006-3-2,0
2006,3,3,0,0,0,2006-3-3,0
2006,3,4,14,0,14,2006-3-4,-14
2006,3,5,28,14,14,2006-3-5,0
2006,3,6,28,14,14,2006-3-6,0
2006,3,7,42,28,14,2006-3-7,14
2006,3,8,42,28,14,2006-3-8,14
2006,3,9,14,14,0,2006-3-9,14
2006,3,10,14,14,0,2006-3-10,14
2006,3,11,0,0,0,2006-3-11,0
2006,3,12,28,28,0,2006-3-12,28
2006,3,13,28,28,0,2006-3-13,28
2006,3,14,42,14,28,2006-3-14,-14
2006,3,15,42,0,42,2006-3-15,-42
2006,3,16,28,0,28,2006-3-16,-28
2006,3,17,42,0,42,2006-3-17,-42
2006,3,18,42,0,42,2006-3-18,-42
2006,3,19,140,0,140,2006-3-19,-140
2006,3,20,182,0,182,2006-3-20,-182
2006,3,21,168,0,168,2006-3-21,-168
2006,3,22,182,28,154,2006-3-22,-126
2006,3,23,112,28,84,2006-3-23,-56
2006,3,24,154,42,112,2006-3-24,-70
2006,3,25,0,0,0,2006-3-25,0
2006,3,26,0,0,0,2006-3-26,0
2006,3,27,0,0,0,2006-3-27,0
2006,3,28,28,0,28,2006-3-28,-28
2006,3,29,280,0,280,2006-3-29,-280
2006,3,30,294,0,294,2006-3-30,-294
2006,3,31,462,0,462,2006-3-31,-462
2006,4,1,448,0,448,2006-4-1,-448
2006,4,2,686,0,686,2006-4-2,-686
2006,4,3,770,0,770,2006-4-3,-770
2006,4,4,1190,0,1190,2006-4-4,-1190
2006,4,5,1204,0,1204,2006-4-5,-1204
2006,4,6,1120,0,1120,2006-4-6,-1120
2006,4,7,630,0,630,2006-4-7,-630
2006,4,8,532,0,532,2006-4-8,-532
2006,4,9,168,0,168,2006-4-9,-168
2006,4,10,294,0,294,2006-4-10,-294
2006,4,11,308,0,308,2006-4-11,-308
2006,4,12,322,0,322,2006-4-12,-322
2006,4,13,224,0,224,2006-4-13,-224
2006,4,14,154,0,154,2006-4-14,-154
2006,4,15,196,0,196,2006-4-15,-196
2006,4,16,126,14,112,2006-4-16,-98
2006,4,17,70,0,70,2006-4-17,-70
2006,4,18,42,14,28,2006-4-18,-14
2006,4,19,56,28,28,2006-4-19,0
2006,4,20,98,0,98,2006-4-20,-98
2006,4,21,42,0,42,2006-4-21,-42
2006,4,22,14,0,14,2006-4-22,-14
2006,4,23,378,0,378,2006-4-23,-378
2006,4,24,812,0,812,2006-4-24,-812
2006,4,25,924,0,924,2006-4-25,-924
2006,4,26,1120,0,1120,2006-4-26,-1120
2006,4,27,770,0,770,2006-4-27,-770
2006,4,28,826,0,826,2006-4-28,-826
2006,4,29,546,0,546,2006-4-29,-546
2006,4,30,658,84,574,2006-4-30,-490
2006,5,1,406,98,308,2006-5-1,-210
2006,5,2,406,154,252,2006-5-2,-98
2006,5,3,476,196,280,2006-5-3,-84
2006,5,4,490,154,336,2006-5-4,-182
2006,5,5,294,56,238,2006-5-5,-182
2006,5,6,224,28,196,2006-5-6,-168
2006,5,7,224,14,210,2006-5-7,-196
2006,5,8,294,0,294,2006-5-8,-294
2006,5,9,252,0,252,2006-5-9,-252
2006,5,10,182,0,182,2006-5-10,-182
2006,5,11,154,0,154,2006-5-11,-154
2006,5,12,42,0,42,2006-5-12,-42
2006,5,13,42,0,42,2006-5-13,-42
2006,5,14,42,0,42,2006-5-14,-42
2006,5,15,0,0,0,2006-5-15,0
2006,5,16,0,0,0,2006-5-16,0
2006,5,17,0,0,0,2006-5-17,0
2006,5,18,0,0,0,2006-5-18,0
2006,5,19,28,0,28,2006-5-19,-28
2006,5,20,182,0,182,2006-5-20,-182
2006,5,21,154,0,154,2006-5-21,-154
2006,5,22,140,0,140,2006-5-22,-140
2006,5,23,154,42,112,2006-5-23,-70
2006,5,24,252,112,140,2006-5-24,-28
2006,5,25,140,70,70,2006-5-25,0
2006,5,26,280,182,98,2006-5-26,84
2006,5,27,322,196,126,2006-5-27,70
2006,5,28,280,126,154,2006-5-28,-28
2006,5,29,126,28,98,2006-5-29,-70
2006,5,30,182,56,126,2006-5-30,-70
2006,5,31,84,28,56,2006-5-31,-28
2006,6,1,42,42,0,2006-6-1,42
2006,6,2,0,0,0,2006-6-2,0
2006,6,3,0,0,0,2006-6-3,0
2006,6,4,322,0,322,2006-6-4,-322
2006,6,5,322,0,322,2006-6-5,-322
2006,6,6,392,0,392,2006-6-6,-392
2006,6,7,434,0,434,2006-6-7,-434
2006,6,8,546,0,546,2006-6-8,-546
2006,6,9,504,0,504,2006-6-9,-504
2006,6,10,420,0,420,2006-6-10,-420
2006,6,11,238,0,238,2006-6-11,-238
2006,6,12,168,0,168,2006-6-12,-168
2006,6,13,168,0,168,2006-6-13,-168
2006,6,14,168,0,168,2006-6-14,-168
2006,6,15,112,0,112,2006-6-15,-112
2006,6,16,0,0,0,2006-6-16,0
2006,6,17,98,14,84,2006-6-17,-70
2006,6,18,28,0,28,2006-6-18,-28
2006,6,19,56,0,56,2006-6-19,-56
2006,6,20,70,0,70,2006-6-20,-70
2006,6,21,154,0,154,2006-6-21,-154
2006,6,22,0,0,0,2006-6-22,0
2006,6,23,0,0,0,2006-6-23,0
2006,6,24,0,0,0,2006-6-24,0
2006,6,25,84,84,0,2006-6-25,84
2006,6,26,112,112,0,2006-6-26,112
2006,6,27,98,98,0,2006-6-27,98
2006,6,28,364,154,210,2006-6-28,-56
2006,6,29,462,98,364,2006-6-29,-266
2006,6,30,546,56,490,2006-6-30,-434
2006,7,1,336,42,294,2006-7-1,-252
2006,7,2,434,28,406,2006-7-2,-378
2006,7,3,532,28,504,2006-7-3,-476
2006,7,4,518,14,504,2006-7-4,-490
2006,7,5,728,0,728,2006-7-5,-728
2006,7,6,728,0,728,2006-7-6,-728
2006,7,7,672,0,672,2006-7-7,-672
2006,7,8,588,0,588,2006-7-8,-588
2006,7,9,420,0,420,2006-7-9,-420
2006,7,10,42,0,42,2006-7-10,-42
2006,7,11,28,0,28,2006-7-11,-28
2006,7,12,14,0,14,2006-7-12,-14
2006,7,13,1.4,0,1.4,2006-7-13,-1.4
2006,7,14,56,0,56,2006-7-14,-56
2006,7,15,70,0,70,2006-7-15,-70
2006,7,16,56,0,56,2006-7-16,-56
2006,7,17,56,0,56,2006-7-17,-56
2006,7,18,126,0,126,2006-7-18,-126
2006,7,19,126,0,126,2006-7-19,-126
2006,7,20,28,0,28,2006-7-20,-28
2006,7,21,14,0,14,2006-7-21,-14
2006,7,22,56,56,0,2006-7-22,56
2006,7,23,182,182,0,2006-7-23,182
2006,7,24,154,154,0,2006-7-24,154
2006,7,25,140,140,0,2006-7-25,140
2006,7,26,140,140,0,2006-7-26,140
2006,7,27,98,98,0,2006-7-27,98
2006,7,28,98,98,0,2006-7-28,98
2006,7,29,112,112,0,2006-7-29,112
2006,7,30,56,14,42,2006-7-30,-28
2006,7,31,42,28,14,2006-7-31,14
2006,8,1,14,0,14,2006-8-1,-14
2006,8,2,70,28,42,2006-8-2,-14
2006,8,3,84,42,42,2006-8-3,0
2006,8,4,0,0,0,2006-8-4,0
2006,8,5,0,0,0,2006-8-5,0
2006,8,6,0,0,0,2006-8-6,0
2006,8,7,0,0,0,2006-8-7,0
2006,8,8,56,0,56,2006-8-8,-56
2006,8,9,154,0,154,2006-8-9,-154
2006,8,10,434,0,434,2006-8-10,-434
2006,8,11,910,0,910,2006-8-11,-910
2006,8,12,1050,0,1050,2006-8-12,-1050
2006,8,13,952,0,952,2006-8-13,-952
2006,8,14,980,0,980,2006-8-14,-980
2006,8,15,980,0,980,2006-8-15,-980
2006,8,16,840,0,840,2006-8-16,-840
2006,8,17,826,0,826,2006-8-17,-826
2006,8,18,826,0,826,2006-8-18,-826
2006,8,19,756,0,756,2006-8-19,-756
2006,8,20,728,0,728,2006-8-20,-728
2006,8,21,392,0,392,2006-8-21,-392
2006,8,22,308,0,308,2006-8-22,-308
2006,8,23,392,0,392,2006-8-23,-392
2006,8,24,406,0,406,2006-8-24,-406
2006,8,25,364,0,364,2006-8-25,-364
2006,8,26,462,0,462,2006-8-26,-462
2006,8,27,490,0,490,2006-8-27,-490
2006,8,28,364,0,364,2006-8-28,-364
2006,8,29,252,0,252,2006-8-29,-252
2006,8,30,224,0,224,2006-8-30,-224
2006,8,31,280,0,280,2006-8-31,-280
2006,9,1,266,0,266,2006-9-1,-266
2006,9,2,168,0,168,2006-9-2,-168
2006,9,3,0,0,0,2006-9-3,0
2006,9,4,0,0,0,2006-9-4,0
2006,9,5,182,0,182,2006-9-5,-182
2006,9,6,392,0,392,2006-9-6,-392
2006,9,7,364,0,364,2006-9-7,-364
2006,9,8,462,0,462,2006-9-8,-462
2006,9,9,476,0,476,2006-9-9,-476
2006,9,10,448,0,448,2006-9-10,-448
2006,9,11,350,0,350,2006-9-11,-350
2006,9,12,308,0,308,2006-9-12,-308
2006,9,13,378,0,378,2006-9-13,-378
2006,9,14,308,0,308,2006-9-14,-308
2006,9,15,252,0,252,2006-9-15,-252
2006,9,16,266,0,266,2006-9-16,-266
2006,9,17,168,0,168,2006-9-17,-168
2006,9,18,42,0,42,2006-9-18,-42
2006,9,19,42,0,42,2006-9-19,-42
2006,9,20,14,0,14,2006-9-20,-14
2006,9,21,14,0,14,2006-9-21,-14
2006,9,22,70,0,70,2006-9-22,-70
2006,9,23,28,0,28,2006-9-23,-28
2006,9,24,42,0,42,2006-9-24,-42
2006,9,25,14,0,14,2006-9-25,-14
2006,9,26,42,42,0,2006-9-26,42
2006,9,27,28,28,0,2006-9-27,28
2006,9,28,168,56,112,2006-9-28,-56
2006,9,29,252,28,224,2006-9-29,-196
2006,9,30,252,0,252,2006-9-30,-252
2006,10,1,182,0,182,2006-10-1,-182
2006,10,2,140,0,140,2006-10-2,-140
2006,10,3,84,0,84,2006-10-3,-84
2006,10,4,70,0,70,2006-10-4,-70
2006,10,5,84,0,84,2006-10-5,-84
2006,10,6,56,0,56,2006-10-6,-56
2006,10,7,70,0,70,2006-10-7,-70
2006,10,8,42,0,42,2006-10-8,-42
2006,10,9,42,0,42,2006-10-9,-42
2006,10,10,14,0,14,2006-10-10,-14
2006,10,11,0,0,0,2006-10-11,0
2006,10,12,0,0,0,2006-10-12,0
2006,10,13,0,0,0,2006-10-13,0
2006,10,14,0,0,0,2006-10-14,0
2006,10,15,0,0,0,2006-10-15,0
2006,10,16,0,0,0,2006-10-16,0
2006,10,17,0,0,0,2006-10-17,0
2006,10,18,0,0,0,2006-10-18,0
2006,10,19,42,0,42,2006-10-19,-42
2006,10,20,42,0,42,2006-10-20,-42
2006,10,21,98,0,98,2006-10-21,-98
2006,10,22,280,0,280,2006-10-22,-280
2006,10,23,294,0,294,2006-10-23,-294
2006,10,24,238,0,238,2006-10-24,-238
2006,10,25,140,0,140,2006-10-25,-140
2006,10,26,0,0,0,2006-10-26,0
2006,10,27,28,0,28,2006-10-27,-28
2006,10,28,238,0,238,2006-10-28,-238
2006,10,29,0,0,0,2006-10-29,0
2006,10,30,70,0,70,2006-10-30,-70
2006,10,31,210,0,210,2006-10-31,-210
2006,11,1,434,0,434,2006-11-1,-434
2006,11,2,644,0,644,2006-11-2,-644
2006,11,3,448,0,448,2006-11-3,-448
2006,11,4,560,0,560,2006-11-4,-560
2006,11,5,532,0,532,2006-11-5,-532
2006,11,6,224,0,224,2006-11-6,-224
2006,11,7,126,0,126,2006-11-7,-126
2006,11,8,546,0,546,2006-11-8,-546
2006,11,9,728,0,728,2006-11-9,-728
2006,11,10,742,0,742,2006-11-10,-742
2006,11,11,868,0,868,2006-11-11,-868
2006,11,12,854,0,854,2006-11-12,-854
2006,11,13,994,0,994,2006-11-13,-994
2006,11,14,1120,0,1120,2006-11-14,-1120
2006,11,15,952,0,952,2006-11-15,-952
2006,11,16,966,0,966,2006-11-16,-966
2006,11,17,798,0,798,2006-11-17,-798
2006,11,18,812,0,812,2006-11-18,-812
2006,11,19,770,0,770,2006-11-19,-770
2006,11,20,476,0,476,2006-11-20,-476
2006,11,21,14,0,14,2006-11-21,-14
2006,11,22,0,0,0,2006-11-22,0
2006,11,23,0,0,0,2006-11-23,0
2006,11,24,0,0,0,2006-11-24,0
2006,11,25,364,0,364,2006-11-25,-364
2006,11,26,224,0,224,2006-11-26,-224
2006,11,27,392,42,350,2006-11-27,-308
2006,11,28,336,98,238,2006-11-28,-140
2006,11,29,462,168,294,2006-11-29,-126
2006,11,30,476,168,308,2006-11-30,-140
2006,12,1,434,154,280,2006-12-1,-126
2006,12,2,392,84,308,2006-12-2,-224
2006,12,3,364,84,280,2006-12-3,-196
2006,12,4,266,126,140,2006-12-4,-14
2006,12,5,868,126,742,2006-12-5,-616
2006,12,6,868,84,784,2006-12-6,-700
2006,12,7,728,98,630,2006-12-7,-532
2006,12,8,658,70,588,2006-12-8,-518
2006,12,9,532,0,532,2006-12-9,-532
2006,12,10,616,0,616,2006-12-10,-616
2006,12,11,672,0,672,2006-12-11,-672
2006,12,12,952,0,952,2006-12-12,-952
2006,12,13,938,0,938,2006-12-13,-938
2006,12,14,868,0,868,2006-12-14,-868
2006,12,15,770,0,770,2006-12-15,-770
2006,12,16,672,0,672,2006-12-16,-672
2006,12,17,322,0,322,2006-12-17,-322
2006,12,18,0,0,0,2006-12-18,0
2006,12,19,0,0,0,2006-12-19,0
2006,12,20,0,0,0,2006-12-20,0
2006,12,21,0,0,0,2006-12-21,0
2006,12,22,0,0,0,2006-12-22,0
2006,12,23,0,0,0,2006-12-23,0
2006,12,24,0,0,0,2006-12-24,0
2006,12,25,42,0,42,2006-12-25,-42
2006,12,26,42,0,42,2006-12-26,-42
2006,12,27,28,0,28,2006-12-27,-28
2006,12,28,0,0,0,2006-12-28,0
2006,12,29,0,0,0,2006-12-29,0
2006,12,30,84,0,84,2006-12-30,-84
2006,12,31,364,70,294,2006-12-31,-224
2007,1,1,364,56,308,2007-1-1,-252
2007,1,2,462,56,406,2007-1-2,-350
2007,1,3,798,28,770,2007-1-3,-742
2007,1,4,728,42,686,2007-1-4,-644
2007,1,5,714,28,686,2007-1-5,-658
2007,1,6,588,42,546,2007-1-6,-504
2007,1,7,630,28,602,2007-1-7,-574
2007,1,8,714,14,700,2007-1-8,-686
2007,1,9,812,0,812,2007-1-9,-812
2007,1,10,672,0,672,2007-1-10,-672
2007,1,11,406,14,392,2007-1-11,-378
2007,1,12,434,0,434,2007-1-12,-434
2007,1,13,448,154,294,2007-1-13,-140
2007,1,14,252,168,84,2007-1-14,84
2007,1,15,126,126,0,2007-1-15,126
2007,1,16,84,84,0,2007-1-16,84
2007,1,17,14,14,0,2007-1-17,14
2007,1,18,42,42,0,2007-1-18,42
2007,1,19,42,42,0,2007-1-19,42
2007,1,20,168,28,140,2007-1-20,-112
2007,1,21,154,0,154,2007-1-21,-154
2007,1,22,168,0,168,2007-1-22,-168
2007,1,23,238,0,238,2007-1-23,-238
2007,1,24,224,0,224,2007-1-24,-224
2007,1,25,84,0,84,2007-1-25,-84
2007,1,26,168,0,168,2007-1-26,-168
2007,1,27,238,0,238,2007-1-27,-238
2007,1,28,252,0,252,2007-1-28,-252
2007,1,29,490,0,490,2007-1-29,-490
2007,1,30,574,0,574,2007-1-30,-574
2007,1,31,616,0,616,2007-1-31,-616
2007,2,1,616,0,616,2007-2-1,-616
2007,2,2,546,0,546,2007-2-2,-546
2007,2,3,490,0,490,2007-2-3,-490
2007,2,4,434,0,434,2007-2-4,-434
2007,2,5,420,0,420,2007-2-5,-420
2007,2,6,448,0,448,2007-2-6,-448
2007,2,7,336,0,336,2007-2-7,-336
2007,2,8,322,0,322,2007-2-8,-322
2007,2,9,154,0,154,2007-2-9,-154
2007,2,10,168,0,168,2007-2-10,-168
2007,2,11,0,0,0,2007-2-11,0
2007,2,12,0,0,0,2007-2-12,0
2007,2,13,0,0,0,2007-2-13,0
2007,2,14,0,0,0,2007-2-14,0
2007,2,15,0,0,0,2007-2-15,0
2007,2,16,84,0,84,2007-2-16,-84
2007,2,17,28,0,28,2007-2-17,-28
2007,2,18,56,0,56,2007-2-18,-56
2007,2,19,154,0,154,2007-2-19,-154
2007,2,20,112,0,112,2007-2-20,-112
2007,2,21,70,0,70,2007-2-21,-70
2007,2,22,196,0,196,2007-2-22,-196
2007,2,23,168,0,168,2007-2-23,-168
2007,2,24,126,0,126,2007-2-24,-126
2007,2,25,154,0,154,2007-2-25,-154
2007,2,26,182,0,182,2007-2-26,-182
2007,2,27,168,0,168,2007-2-27,-168
2007,2,28,182,0,182,2007-2-28,-182
2007,3,1,126,0,126,2007-3-1,-126
2007,3,2,224,0,224,2007-3-2,-224
2007,3,3,126,0,126,2007-3-3,-126
2007,3,4,98,0,98,2007-3-4,-98
2007,3,5,112,0,112,2007-3-5,-112
2007,3,6,70,0,70,2007-3-6,-70
2007,3,7,14,0,14,2007-3-7,-14
2007,3,8,0,0,0,2007-3-8,0
2007,3,9,0,0,0,2007-3-9,0
2007,3,10,42,42,0,2007-3-10,42
2007,3,11,98,98,0,2007-3-11,98
2007,3,12,28,28,0,2007-3-12,28
2007,3,13,0,0,0,2007-3-13,0
2007,3,14,0,0,0,2007-3-14,0
2007,3,15,0,0,0,2007-3-15,0
2007,3,16,0,0,0,2007-3-16,0
2007,3,17,0,0,0,2007-3-17,0
2007,3,18,0,0,0,2007-3-18,0
2007,3,19,0,0,0,2007-3-19,0
2007,3,20,0,0,0,2007-3-20,0
2007,3,21,0,0,0,2007-3-21,0
2007,3,22,0,0,0,2007-3-22,0
2007,3,23,28,0,28,2007-3-23,-28
2007,3,24,28,0,28,2007-3-24,-28
2007,3,25,14,0,14,2007-3-25,-14
2007,3,26,42,0,42,2007-3-26,-42
2007,3,27,28,0,28,2007-3-27,-28
2007,3,28,112,98,14,2007-3-28,84
2007,3,29,56,56,0,2007-3-29,56
2007,3,30,14,14,0,2007-3-30,14
2007,3,31,28,28,0,2007-3-31,28
2007,4,1,70,70,0,2007-4-1,70
2007,4,2,28,28,0,2007-4-2,28
2007,4,3,28,14,14,2007-4-3,0
2007,4,4,0,0,0,2007-4-4,0
2007,4,5,0,0,0,2007-4-5,0
2007,4,6,0,0,0,2007-4-6,0
2007,4,7,0,0,0,2007-4-7,0
2007,4,8,0,0,0,2007-4-8,0
2007,4,9,0,0,0,2007-4-9,0
2007,4,10,0,0,0,2007-4-10,0
2007,4,11,0,0,0,2007-4-11,0
2007,4,12,0,0,0,2007-4-12,0
2007,4,13,0,0,0,2007-4-13,0
2007,4,14,14,0,14,2007-4-14,-14
2007,4,15,0,0,0,2007-4-15,0
2007,4,16,0,0,0,2007-4-16,0
2007,4,17,28,0,28,2007-4-17,-28
2007,4,18,14,0,14,2007-4-18,-14
2007,4,19,0,0,0,2007-4-19,0
2007,4,20,0,0,0,2007-4-20,0
2007,4,21,0,0,0,2007-4-21,0
2007,4,22,0,0,0,2007-4-22,0
2007,4,23,0,0,0,2007-4-23,0
2007,4,24,0,0,0,2007-4-24,0
2007,4,25,322,0,322,2007-4-25,-322
2007,4,26,630,0,630,2007-4-26,-630
2007,4,27,700,0,700,2007-4-27,-700
2007,4,28,728,0,728,2007-4-28,-728
2007,4,29,700,0,700,2007-4-29,-700
2007,4,30,714,0,714,2007-4-30,-714
2007,5,1,672,0,672,2007-5-1,-672
2007,5,2,630,0,630,2007-5-2,-630
2007,5,3,560,0,560,2007-5-3,-560
2007,5,4,462,0,462,2007-5-4,-462
2007,5,5,364,0,364,2007-5-5,-364
2007,5,6,168,0,168,2007-5-6,-168
2007,5,7,266,0,266,2007-5-7,-266
2007,5,8,126,0,126,2007-5-8,-126
2007,5,9,350,0,350,2007-5-9,-350
2007,5,10,112,0,112,2007-5-10,-112
2007,5,11,210,0,210,2007-5-11,-210
2007,5,12,126,0,126,2007-5-12,-126
2007,5,13,70,0,70,2007-5-13,-70
2007,5,14,182,112,70,2007-5-14,42
2007,5,15,196,182,14,2007-5-15,168
2007,5,16,336,308,28,2007-5-16,280
2007,5,17,420,420,0,2007-5-17,420
2007,5,18,434,392,42,2007-5-18,350
2007,5,19,252,210,42,2007-5-19,168
2007,5,20,266,266,0,2007-5-20,266
2007,5,21,126,126,0,2007-5-21,126
2007,5,22,56,56,0,2007-5-22,56
2007,5,23,28,28,0,2007-5-23,28
2007,5,24,0,0,0,2007-5-24,0
2007,5,25,0,0,0,2007-5-25,0
2007,5,26,0,0,0,2007-5-26,0
2007,5,27,0,0,0,2007-5-27,0
2007,5,28,0,0,0,2007-5-28,0
2007,5,29,42,0,42,2007-5-29,-42
2007,5,30,42,0,42,2007-5-30,-42
2007,5,31,0,0,0,2007-5-31,0
2007,6,1,476,0,476,2007-6-1,-476
2007,6,2,728,0,728,2007-6-2,-728
2007,6,3,798,0,798,2007-6-3,-798
2007,6,4,686,0,686,2007-6-4,-686
2007,6,5,616,0,616,2007-6-5,-616
2007,6,6,406,0,406,2007-6-6,-406
2007,6,7,420,0,420,2007-6-7,-420
2007,6,8,350,0,350,2007-6-8,-350
2007,6,9,210,0,210,2007-6-9,-210
2007,6,10,182,0,182,2007-6-10,-182
2007,6,11,112,0,112,2007-6-11,-112
2007,6,12,112,0,112,2007-6-12,-112
2007,6,13,98,0,98,2007-6-13,-98
2007,6,14,0,0,0,2007-6-14,0
2007,6,15,0,0,0,2007-6-15,0
2007,6,16,0,0,0,2007-6-16,0
2007,6,17,0,0,0,2007-6-17,0
2007,6,18,0,0,0,2007-6-18,0
2007,6,19,0,0,0,2007-6-19,0
2007,6,20,0,0,0,2007-6-20,0
2007,6,21,0,0,0,2007-6-21,0
2007,6,22,0,0,0,2007-6-22,0
2007,6,23,0,0,0,2007-6-23,0
2007,6,24,0,0,0,2007-6-24,0
2007,6,25,154,0,154,2007-6-25,-154
2007,6,26,154,0,154,2007-6-26,-154
2007,6,27,252,0,252,2007-6-27,-252
2007,6,28,308,0,308,2007-6-28,-308
2007,6,29,210,0,210,2007-6-29,-210
2007,6,30,336,0,336,2007-6-30,-336
2007,7,1,210,0,210,2007-7-1,-210
2007,7,2,126,0,126,2007-7-2,-126
2007,7,3,126,0,126,2007-7-3,-126
2007,7,4,140,0,140,2007-7-4,-140
2007,7,5,168,0,168,2007-7-5,-168
2007,7,6,70,0,70,2007-7-6,-70
2007,7,7,154,0,154,2007-7-7,-154
2007,7,8,210,0,210,2007-7-8,-210
2007,7,9,364,0,364,2007-7-9,-364
2007,7,10,742,0,742,2007-7-10,-742
2007,7,11,518,0,518,2007-7-11,-518
2007,7,12,602,0,602,2007-7-12,-602
2007,7,13,490,56,434,2007-7-13,-378
2007,7,14,350,70,280,2007-7-14,-210
2007,7,15,448,70,378,2007-7-15,-308
2007,7,16,364,28,336,2007-7-16,-308
2007,7,17,336,0,336,2007-7-17,-336
2007,7,18,294,0,294,2007-7-18,-294
2007,7,19,154,0,154,2007-7-19,-154
2007,7,20,0,0,0,2007-7-20,0
2007,7,21,0,0,0,2007-7-21,0
2007,7,22,0,0,0,2007-7-22,0
2007,7,23,0,0,0,2007-7-23,0
2007,7,24,0,0,0,2007-7-24,0
2007,7,25,0,0,0,2007-7-25,0
2007,7,26,0,0,0,2007-7-26,0
2007,7,27,0,0,0,2007-7-27,0
2007,7,28,42,0,42,2007-7-28,-42
2007,7,29,56,0,56,2007-7-29,-56
2007,7,30,14,0,14,2007-7-30,-14
2007,7,31,14,0,14,2007-7-31,-14
2007,8,1,0,0,0,2007-8-1,0
2007,8,2,0,0,0,2007-8-2,0
2007,8,3,14,0,14,2007-8-3,-14
2007,8,4,42,0,42,2007-8-4,-42
2007,8,5,14,0,14,2007-8-5,-14
2007,8,6,42,0,42,2007-8-6,-42
2007,8,7,28,0,28,2007-8-7,-28
2007,8,8,126,70,56,2007-8-8,14
2007,8,9,56,0,56,2007-8-9,-56
2007,8,10,42,0,42,2007-8-10,-42
2007,8,11,28,0,28,2007-8-11,-28
2007,8,12,14,0,14,2007-8-12,-14
2007,8,13,28,28,0,2007-8-13,28
2007,8,14,28,28,0,2007-8-14,28
2007,8,15,0,0,0,2007-8-15,0
2007,8,16,0,0,0,2007-8-16,0
2007,8,17,0,0,0,2007-8-17,0
2007,8,18,0,0,0,2007-8-18,0
2007,8,19,0,0,0,2007-8-19,0
2007,8,20,0,0,0,2007-8-20,0
2007,8,21,126,0,126,2007-8-21,-126
2007,8,22,140,0,140,2007-8-22,-140
2007,8,23,140,0,140,2007-8-23,-140
2007,8,24,126,0,126,2007-8-24,-126
2007,8,25,154,0,154,2007-8-25,-154
2007,8,26,112,0,112,2007-8-26,-112
2007,8,27,140,0,140,2007-8-27,-140
2007,8,28,154,0,154,2007-8-28,-154
2007,8,29,140,0,140,2007-8-29,-140
2007,8,30,126,0,126,2007-8-30,-126
2007,8,31,168,0,168,2007-8-31,-168
2007,9,1,112,0,112,2007-9-1,-112
2007,9,2,42,0,42,2007-9-2,-42
2007,9,3,42,0,42,2007-9-3,-42
2007,9,4,28,0,28,2007-9-4,-28
2007,9,5,42,0,42,2007-9-5,-42
2007,9,6,14,0,14,2007-9-6,-14
2007,9,7,0,0,0,2007-9-7,0
2007,9,8,0,0,0,2007-9-8,0
2007,9,9,0,0,0,2007-9-9,0
2007,9,10,0,0,0,2007-9-10,0
2007,9,11,0,0,0,2007-9-11,0
2007,9,12,0,0,0,2007-9-12,0
2007,9,13,0,0,0,2007-9-13,0
2007,9,14,0,0,0,2007-9-14,0
2007,9,15,0,0,0,2007-9-15,0
2007,9,16,0,0,0,2007-9-16,0
2007,9,17,0,0,0,2007-9-17,0
2007,9,18,0,0,0,2007-9-18,0
2007,9,19,0,0,0,2007-9-19,0
2007,9,20,0,0,0,2007-9-20,0
2007,9,21,0,0,0,2007-9-21,0
2007,9,22,0,0,0,2007-9-22,0
2007,9,23,0,0,0,2007-9-23,0
2007,9,24,0,0,0,2007-9-24,0
2007,9,25,0,0,0,2007-9-25,0
2007,9,26,0,0,0,2007-9-26,0
2007,9,27,0,0,0,2007-9-27,0
2007,9,28,56,56,0,2007-9-28,56
2007,9,29,70,70,0,2007-9-29,70
2007,9,30,56,56,0,2007-9-30,56
2007,10,1,28,0,28,2007-10-1,-28
2007,10,2,0,0,0,2007-10-2,0
2007,10,3,0,0,0,2007-10-3,0
2007,10,4,0,0,0,2007-10-4,0
2007,10,5,0,0,0,2007-10-5,0
2007,10,6,84,0,84,2007-10-6,-84
2007,10,7,28,0,28,2007-10-7,-28
2007,10,8,0,0,0,2007-10-8,0
2007,10,9,0,0,0,2007-10-9,0
2007,10,10,0,0,0,2007-10-10,0
2007,10,11,0,0,0,2007-10-11,0
2007,10,12,0,0,0,2007-10-12,0
2007,10,13,0,0,0,2007-10-13,0
2007,10,14,0,0,0,2007-10-14,0
2007,10,15,0,0,0,2007-10-15,0
2007,10,16,0,0,0,2007-10-16,0
2007,10,17,0,0,0,2007-10-17,0
2007,10,18,0,0,0,2007-10-18,0
2007,10,19,0,0,0,2007-10-19,0
2007,10,20,0,0,0,2007-10-20,0
2007,10,21,0,0,0,2007-10-21,0
2007,10,22,0,0,0,2007-10-22,0
2007,10,23,0,0,0,2007-10-23,0
2007,10,24,0,0,0,2007-10-24,0
2007,10,25,0,0,0,2007-10-25,0
2007,10,26,0,0,0,2007-10-26,0
2007,10,27,0,0,0,2007-10-27,0
2007,10,28,0,0,0,2007-10-28,0
2007,10,29,0,0,0,2007-10-29,0
2007,10,30,0,0,0,2007-10-30,0
2007,10,31,0,0,0,2007-10-31,0
2007,11,1,0,0,0,2007-11-1,0
2007,11,2,0,0,0,2007-11-2,0
2007,11,3,0,0,0,2007-11-3,0
2007,11,4,0,0,0,2007-11-4,0
2007,11,5,0,0,0,2007-11-5,0
2007,11,6,14,0,14,2007-11-6,-14
2007,11,7,0,0,0,2007-11-7,0
2007,11,8,0,0,0,2007-11-8,0
2007,11,9,0,0,0,2007-11-9,0
2007,11,10,0,0,0,2007-11-10,0
2007,11,11,0,0,0,2007-11-11,0
2007,11,12,0,0,0,2007-11-12,0
2007,11,13,0,0,0,2007-11-13,0
2007,11,14,0,0,0,2007-11-14,0
2007,11,15,0,0,0,2007-11-15,0
2007,11,16,28,28,0,2007-11-16,28
2007,11,17,56,56,0,2007-11-17,56
2007,11,18,0,0,0,2007-11-18,0
2007,11,19,0,0,0,2007-11-19,0
2007,11,20,0,0,0,2007-11-20,0
2007,11,21,0,0,0,2007-11-21,0
2007,11,22,0,0,0,2007-11-22,0
2007,11,23,0,0,0,2007-11-23,0
2007,11,24,28,28,0,2007-11-24,28
2007,11,25,14,14,0,2007-11-25,14
2007,11,26,14,14,0,2007-11-26,14
2007,11,27,0,0,0,2007-11-27,0
2007,11,28,0,0,0,2007-11-28,0
2007,11,29,0,0,0,2007-11-29,0
2007,11,30,0,0,0,2007-11-30,0
2007,12,1,42,0,42,2007-12-1,-42
2007,12,2,56,0,56,2007-12-2,-56
2007,12,3,42,0,42,2007-12-3,-42
2007,12,4,42,0,42,2007-12-4,-42
2007,12,5,28,0,28,2007-12-5,-28
2007,12,6,112,0,112,2007-12-6,-112
2007,12,7,126,0,126,2007-12-7,-126
2007,12,8,294,70,224,2007-12-8,-154
2007,12,9,420,112,308,2007-12-9,-196
2007,12,10,434,84,350,2007-12-10,-266
2007,12,11,336,0,336,2007-12-11,-336
2007,12,12,280,0,280,2007-12-12,-280
2007,12,13,476,0,476,2007-12-13,-476
2007,12,14,406,0,406,2007-12-14,-406
2007,12,15,476,0,476,2007-12-15,-476
2007,12,16,336,0,336,2007-12-16,-336
2007,12,17,140,0,140,2007-12-17,-140
2007,12,18,168,0,168,2007-12-18,-168
2007,12,19,0,0,0,2007-12-19,0
2007,12,20,0,0,0,2007-12-20,0
2007,12,21,0,0,0,2007-12-21,0
2007,12,22,0,0,0,2007-12-22,0
2007,12,23,0,0,0,2007-12-23,0
2007,12,24,0,0,0,2007-12-24,0
2007,12,25,0,0,0,2007-12-25,0
2007,12,26,0,0,0,2007-12-26,0
2007,12,27,0,0,0,2007-12-27,0
2007,12,28,0,0,0,2007-12-28,0
2007,12,29,0,0,0,2007-12-29,0
2007,12,30,0,0,0,2007-12-30,0
2007,12,31,0,0,0,2007-12-31,0
2008,1,1,42,0,42,2008-1-1,-42
2008,1,2,42,0,42,2008-1-2,-42
2008,1,3,28,0,28,2008-1-3,-28
2008,1,4,42,28,14,2008-1-4,14
2008,1,5,28,28,0,2008-1-5,28
2008,1,6,28,28,0,2008-1-6,28
2008,1,7,28,0,28,2008-1-7,-28
2008,1,8,28,0,28,2008-1-8,-28
2008,1,9,0,0,0,2008-1-9,0
2008,1,10,0,0,0,2008-1-10,0
2008,1,11,0,0,0,2008-1-11,0
2008,1,12,0,0,0,2008-1-12,0
2008,1,13,0,0,0,2008-1-13,0
2008,1,14,0,0,0,2008-1-14,0
2008,1,15,0,0,0,2008-1-15,0
2008,1,16,0,0,0,2008-1-16,0
2008,1,17,0,0,0,2008-1-17,0
2008,1,18,0,0,0,2008-1-18,0
2008,1,19,0,0,0,2008-1-19,0
2008,1,20,0,0,0,2008-1-20,0
2008,1,21,0,0,0,2008-1-21,0
2008,1,22,0,0,0,2008-1-22,0
2008,1,23,0,0,0,2008-1-23,0
2008,1,24,0,0,0,2008-1-24,0
2008,1,25,0,0,0,2008-1-25,0
2008,1,26,0,0,0,2008-1-26,0
2008,1,27,0,0,0,2008-1-27,0
2008,1,28,0,0,0,2008-1-28,0
2008,1,29,28,0,28,2008-1-29,-28
2008,1,30,84,0,84,2008-1-30,-84
2008,1,31,70,0,70,2008-1-31,-70
2008,2,1,42,0,42,2008-2-1,-42
2008,2,2,28,0,28,2008-2-2,-28
2008,2,3,14,0,14,2008-2-3,-14
2008,2,4,14,0,14,2008-2-4,-14
2008,2,5,0,0,0,2008-2-5,0
2008,2,6,0,0,0,2008-2-6,0
2008,2,7,0,0,0,2008-2-7,0
2008,2,8,0,0,0,2008-2-8,0
2008,2,9,0,0,0,2008-2-9,0
2008,2,10,0,0,0,2008-2-10,0
2008,2,11,0,0,0,2008-2-11,0
2008,2,12,0,0,0,2008-2-12,0
2008,2,13,0,0,0,2008-2-13,0
2008,2,14,0,0,0,2008-2-14,0
2008,2,15,0,0,0,2008-2-15,0
2008,2,16,0,0,0,2008-2-16,0
2008,2,17,0,0,0,2008-2-17,0
2008,2,18,0,0,0,2008-2-18,0
2008,2,19,0,0,0,2008-2-19,0
2008,2,20,0,0,0,2008-2-20,0
2008,2,21,0,0,0,2008-2-21,0
2008,2,22,0,0,0,2008-2-22,0
2008,2,23,0,0,0,2008-2-23,0
2008,2,24,0,0,0,2008-2-24,0
2008,2,25,28,0,28,2008-2-25,-28
2008,2,26,42,0,42,2008-2-26,-42
2008,2,27,42,0,42,2008-2-27,-42
2008,2,28,42,0,42,2008-2-28,-42
2008,2,29,0,0,0,2008-2-29,0
2008,3,1,0,0,0,2008-3-1,0
2008,3,2,0,0,0,2008-3-2,0
2008,3,3,0,0,0,2008-3-3,0
2008,3,4,0,0,0,2008-3-4,0
2008,3,5,28,0,28,2008-3-5,-28
2008,3,6,42,0,42,2008-3-6,-42
2008,3,7,0,0,0,2008-3-7,0
2008,3,8,0,0,0,2008-3-8,0
2008,3,9,0,0,0,2008-3-9,0
2008,3,10,126,0,126,2008-3-10,-126
2008,3,11,0,0,0,2008-3-11,0
2008,3,12,0,0,0,2008-3-12,0
2008,3,13,0,0,0,2008-3-13,0
2008,3,14,0,0,0,2008-3-14,0
2008,3,15,28,0,28,2008-3-15,-28
2008,3,16,28,0,28,2008-3-16,-28
2008,3,17,14,0,14,2008-3-17,-14
2008,3,18,0,0,0,2008-3-18,0
2008,3,19,0,0,0,2008-3-19,0
2008,3,20,0,0,0,2008-3-20,0
2008,3,21,0,0,0,2008-3-21,0
2008,3,22,0,0,0,2008-3-22,0
2008,3,23,56,0,56,2008-3-23,-56
2008,3,24,294,0,294,2008-3-24,-294
2008,3,25,532,0,532,2008-3-25,-532
2008,3,26,728,0,728,2008-3-26,-728
2008,3,27,714,0,714,2008-3-27,-714
2008,3,28,574,0,574,2008-3-28,-574
2008,3,29,546,0,546,2008-3-29,-546
2008,3,30,420,0,420,2008-3-30,-420
2008,3,31,350,0,350,2008-3-31,-350
2008,4,1,252,0,252,2008-4-1,-252
2008,4,2,308,0,308,2008-4-2,-308
2008,4,3,98,0,98,2008-4-3,-98
2008,4,4,0,0,0,2008-4-4,0
2008,4,5,0,0,0,2008-4-5,0
2008,4,6,0,0,0,2008-4-6,0
2008,4,7,0,0,0,2008-4-7,0
2008,4,8,0,0,0,2008-4-8,0
2008,4,9,0,0,0,2008-4-9,0
2008,4,10,0,0,0,2008-4-10,0
2008,4,11,0,0,0,2008-4-11,0
2008,4,12,0,0,0,2008-4-12,0
2008,4,13,0,0,0,2008-4-13,0
2008,4,14,14,14,0,2008-4-14,14
2008,4,15,14,14,0,2008-4-15,14
2008,4,16,0,0,0,2008-4-16,0
2008,4,17,0,0,0,2008-4-17,0
2008,4,18,0,0,0,2008-4-18,0
2008,4,19,28,0,28,2008-4-19,-28
2008,4,20,28,0,28,2008-4-20,-28
2008,4,21,0,0,0,2008-4-21,0
2008,4,22,56,56,0,2008-4-22,56
2008,4,23,56,56,0,2008-4-23,56
2008,4,24,14,14,0,2008-4-24,14
2008,4,25,0,0,0,2008-4-25,0
2008,4,26,0,0,0,2008-4-26,0
2008,4,27,0,0,0,2008-4-27,0
2008,4,28,0,0,0,2008-4-28,0
2008,4,29,0,0,0,2008-4-29,0
2008,4,30,0,0,0,2008-4-30,0
2008,5,1,0,0,0,2008-5-1,0
2008,5,2,0,0,0,2008-5-2,0
2008,5,3,0,0,0,2008-5-3,0
2008,5,4,14,0,14,2008-5-4,-14
2008,5,5,28,0,28,2008-5-5,-28
2008,5,6,0,0,0,2008-5-6,0
2008,5,7,0,0,0,2008-5-7,0
2008,5,8,0,0,0,2008-5-8,0
2008,5,9,0,0,0,2008-5-9,0
2008,5,10,0,0,0,2008-5-10,0
2008,5,11,0,0,0,2008-5-11,0
2008,5,12,0,0,0,2008-5-12,0
2008,5,13,0,0,0,2008-5-13,0
2008,5,14,0,0,0,2008-5-14,0
2008,5,15,0,0,0,2008-5-15,0
2008,5,16,63,42,21,2008-5-16,21
2008,5,17,42,42,0,2008-5-17,42
2008,5,18,112,42,70,2008-5-18,-28
2008,5,19,42,14,28,2008-5-19,-14
2008,5,20,28,14,14,2008-5-20,0
2008,5,21,0,0,0,2008-5-21,0
2008,5,22,0,0,0,2008-5-22,0
2008,5,23,0,0,0,2008-5-23,0
2008,5,24,0,0,0,2008-5-24,0
2008,5,25,0,0,0,2008-5-25,0
2008,5,26,14,0,14,2008-5-26,-14
2008,5,27,0,0,0,2008-5-27,0
2008,5,28,0,0,0,2008-5-28,0
2008,5,29,0,0,0,2008-5-29,0
2008,5,30,0,0,0,2008-5-30,0
2008,5,31,0,0,0,2008-5-31,0
2008,6,1,0,0,0,2008-6-1,0
2008,6,2,0,0,0,2008-6-2,0
2008,6,3,0,0,0,2008-6-3,0
2008,6,4,0,0,0,2008-6-4,0
2008,6,5,0,0,0,2008-6-5,0
2008,6,6,0,0,0,2008-6-6,0
2008,6,7,0,0,0,2008-6-7,0
2008,6,8,0,0,0,2008-6-8,0
2008,6,9,0,0,0,2008-6-9,0
2008,6,10,56,0,56,2008-6-10,-56
2008,6,11,28,0,28,2008-6-11,-28
2008,6,12,42,0,42,2008-6-12,-42
2008,6,13,28,0,28,2008-6-13,-28
2008,6,14,0,0,0,2008-6-14,0
2008,6,15,0,0,0,2008-6-15,0
2008,6,16,28,0,28,2008-6-16,-28
2008,6,17,28,0,28,2008-6-17,-28
2008,6,18,14,0,14,2008-6-18,-14
2008,6,19,14,0,14,2008-6-19,-14
2008,6,20,14,0,14,2008-6-20,-14
2008,6,21,14,0,14,2008-6-21,-14
2008,6,22,14,0,14,2008-6-22,-14
2008,6,23,0,0,0,2008-6-23,0
2008,6,24,0,0,0,2008-6-24,0
2008,6,25,0,0,0,2008-6-25,0
2008,6,26,0,0,0,2008-6-26,0
2008,6,27,0,0,0,2008-6-27,0
2008,6,28,0,0,0,2008-6-28,0
2008,6,29,0,0,0,2008-6-29,0
2008,6,30,0,0,0,2008-6-30,0
2008,7,1,0,0,0,2008-7-1,0
2008,7,2,0,0,0,2008-7-2,0
2008,7,3,0,0,0,2008-7-3,0
2008,7,4,0,0,0,2008-7-4,0
2008,7,5,0,0,0,2008-7-5,0
2008,7,6,0,0,0,2008-7-6,0
2008,7,7,0,0,0,2008-7-7,0
2008,7,8,0,0,0,2008-7-8,0
2008,7,9,0,0,0,2008-7-9,0
2008,7,10,0,0,0,2008-7-10,0
2008,7,11,0,0,0,2008-7-11,0
2008,7,12,0,0,0,2008-7-12,0
2008,7,13,0,0,0,2008-7-13,0
2008,7,14,0,0,0,2008-7-14,0
2008,7,15,0,0,0,2008-7-15,0
2008,7,16,0,0,0,2008-7-16,0
2008,7,17,0,0,0,2008-7-17,0
2008,7,18,14,0,14,2008-7-18,-14
2008,7,19,28,0,28,2008-7-19,-28
2008,7,20,14,0,14,2008-7-20,-14
2008,7,21,0,0,0,2008-7-21,0
2008,7,22,0,0,0,2008-7-22,0
2008,7,23,0,0,0,2008-7-23,0
2008,7,24,0,0,0,2008-7-24,0
2008,7,25,0,0,0,2008-7-25,0
2008,7,26,0,0,0,2008-7-26,0
2008,7,27,0,0,0,2008-7-27,0
2008,7,28,0,0,0,2008-7-28,0
2008,7,29,0,0,0,2008-7-29,0
2008,7,30,0,0,0,2008-7-30,0
2008,7,31,0,0,0,2008-7-31,0
2008,8,1,0,0,0,2008-8-1,0
2008,8,2,0,0,0,2008-8-2,0
2008,8,3,0,0,0,2008-8-3,0
2008,8,4,0,0,0,2008-8-4,0
2008,8,5,0,0,0,2008-8-5,0
2008,8,6,0,0,0,2008-8-6,0
2008,8,7,0,0,0,2008-8-7,0
2008,8,8,0,0,0,2008-8-8,0
2008,8,9,0,0,0,2008-8-9,0
2008,8,10,0,0,0,2008-8-10,0
2008,8,11,0,0,0,2008-8-11,0
2008,8,12,0,0,0,2008-8-12,0
2008,8,13,0,0,0,2008-8-13,0
2008,8,14,0,0,0,2008-8-14,0
2008,8,15,0,0,0,2008-8-15,0
2008,8,16,0,0,0,2008-8-16,0
2008,8,17,0,0,0,2008-8-17,0
2008,8,18,0,0,0,2008-8-18,0
2008,8,19,0,0,0,2008-8-19,0
2008,8,20,0,0,0,2008-8-20,0
2008,8,21,0,0,0,2008-8-21,0
2008,8,22,0,0,0,2008-8-22,0
2008,8,23,0,0,0,2008-8-23,0
2008,8,24,0,0,0,2008-8-24,0
2008,8,25,0,0,0,2008-8-25,0
2008,8,26,0,0,0,2008-8-26,0
2008,8,27,0,0,0,2008-8-27,0
2008,8,28,0,0,0,2008-8-28,0
2008,8,29,0,0,0,2008-8-29,0
2008,8,30,0,0,0,2008-8-30,0
2008,8,31,0,0,0,2008-8-31,0
2008,9,1,0,0,0,2008-9-1,0
2008,9,2,0,0,0,2008-9-2,0
2008,9,3,0,0,0,2008-9-3,0
2008,9,4,0,0,0,2008-9-4,0
2008,9,5,0,0,0,2008-9-5,0
2008,9,6,0,0,0,2008-9-6,0
2008,9,7,0,0,0,2008-9-7,0
2008,9,8,0,0,0,2008-9-8,0
2008,9,9,0,0,0,2008-9-9,0
2008,9,10,0,0,0,2008-9-10,0
2008,9,11,28,28,0,2008-9-11,28
2008,9,12,0,0,0,2008-9-12,0
2008,9,13,0,0,0,2008-9-13,0
2008,9,14,0,0,0,2008-9-14,0
2008,9,15,0,0,0,2008-9-15,0
2008,9,16,0,0,0,2008-9-16,0
2008,9,17,0,0,0,2008-9-17,0
2008,9,18,0,0,0,2008-9-18,0
2008,9,19,0,0,0,2008-9-19,0
2008,9,20,0,0,0,2008-9-20,0
2008,9,21,0,0,0,2008-9-21,0
2008,9,22,42,42,0,2008-9-22,42
2008,9,23,28,28,0,2008-9-23,28
2008,9,24,0,0,0,2008-9-24,0
2008,9,25,0,0,0,2008-9-25,0
2008,9,26,0,0,0,2008-9-26,0
2008,9,27,0,0,0,2008-9-27,0
2008,9,28,0,0,0,2008-9-28,0
2008,9,29,0,0,0,2008-9-29,0
2008,9,30,0,0,0,2008-9-30,0
2008,10,1,0,0,0,2008-10-1,0
2008,10,2,0,0,0,2008-10-2,0
2008,10,3,0,0,0,2008-10-3,0
2008,10,4,14,0,14,2008-10-4,-14
2008,10,5,0,0,0,2008-10-5,0
2008,10,6,0,0,0,2008-10-6,0
2008,10,7,0,0,0,2008-10-7,0
2008,10,8,0,0,0,2008-10-8,0
2008,10,9,0,0,0,2008-10-9,0
2008,10,10,14,0,14,2008-10-10,-14
2008,10,11,56,56,0,2008-10-11,56
2008,10,12,98,98,0,2008-10-12,98
2008,10,13,56,56,0,2008-10-13,56
2008,10,14,28,28,0,2008-10-14,28
2008,10,15,42,42,0,2008-10-15,42
2008,10,16,70,42,28,2008-10-16,14
2008,10,17,42,0,42,2008-10-17,-42
2008,10,18,0,0,0,2008-10-18,0
2008,10,19,0,0,0,2008-10-19,0
2008,10,20,0,0,0,2008-10-20,0
2008,10,21,0,0,0,2008-10-21,0
2008,10,22,0,0,0,2008-10-22,0
2008,10,23,0,0,0,2008-10-23,0
2008,10,24,0,0,0,2008-10-24,0
2008,10,25,0,0,0,2008-10-25,0
2008,10,26,0,0,0,2008-10-26,0
2008,10,27,0,0,0,2008-10-27,0
2008,10,28,0,0,0,2008-10-28,0
2008,10,29,0,0,0,2008-10-29,0
2008,10,30,28,28,0,2008-10-30,28
2008,10,31,42,42,0,2008-10-31,42
2008,11,1,28,28,0,2008-11-1,28
2008,11,2,84,84,0,2008-11-2,84
2008,11,3,112,112,0,2008-11-3,112
2008,11,4,84,84,0,2008-11-4,84
2008,11,5,42,42,0,2008-11-5,42
2008,11,6,42,42,0,2008-11-6,42
2008,11,7,0,0,0,2008-11-7,0
2008,11,8,0,0,0,2008-11-8,0
2008,11,9,0,0,0,2008-11-9,0
2008,11,10,56,56,0,2008-11-10,56
2008,11,11,112,112,0,2008-11-11,112
2008,11,12,112,112,0,2008-11-12,112
2008,11,13,98,98,0,2008-11-13,98
2008,11,14,42,42,0,2008-11-14,42
2008,11,15,70,70,0,2008-11-15,70
2008,11,16,56,56,0,2008-11-16,56
2008,11,17,14,14,0,2008-11-17,14
2008,11,18,0,0,0,2008-11-18,0
2008,11,19,0,0,0,2008-11-19,0
2008,11,20,0,0,0,2008-11-20,0
2008,11,21,0,0,0,2008-11-21,0
2008,11,22,0,0,0,2008-11-22,0
2008,11,23,0,0,0,2008-11-23,0
2008,11,24,0,0,0,2008-11-24,0
2008,11,25,0,0,0,2008-11-25,0
2008,11,26,0,0,0,2008-11-26,0
2008,11,27,0,0,0,2008-11-27,0
2008,11,28,0,0,0,2008-11-28,0
2008,11,29,0,0,0,2008-11-29,0
2008,11,30,0,0,0,2008-11-30,0
2008,12,1,0,0,0,2008-12-1,0
2008,12,2,0,0,0,2008-12-2,0
2008,12,3,0,0,0,2008-12-3,0
2008,12,4,0,0,0,2008-12-4,0
2008,12,5,0,0,0,2008-12-5,0
2008,12,6,0,0,0,2008-12-6,0
2008,12,7,0,0,0,2008-12-7,0
2008,12,8,0,0,0,2008-12-8,0
2008,12,9,0,0,0,2008-12-9,0
2008,12,10,70,0,70,2008-12-10,-70
2008,12,11,28,0,28,2008-12-11,-28
2008,12,12,28,0,28,2008-12-12,-28
2008,12,13,0,0,0,2008-12-13,0
2008,12,14,0,0,0,2008-12-14,0
2008,12,15,0,0,0,2008-12-15,0
2008,12,16,0,0,0,2008-12-16,0
2008,12,17,0,0,0,2008-12-17,0
2008,12,18,0,0,0,2008-12-18,0
2008,12,19,0,0,0,2008-12-19,0
2008,12,20,0,0,0,2008-12-20,0
2008,12,21,0,0,0,2008-12-21,0
2008,12,22,0,0,0,2008-12-22,0
2008,12,23,0,0,0,2008-12-23,0
2008,12,24,0,0,0,2008-12-24,0
2008,12,25,0,0,0,2008-12-25,0
2008,12,26,0,0,0,2008-12-26,0
2008,12,27,0,0,0,2008-12-27,0
2008,12,28,0,0,0,2008-12-28,0
2008,12,29,0,0,0,2008-12-29,0
2008,12,30,0,0,0,2008-12-30,0
2008,12,31,0,0,0,2008-12-31,0
2009,1,1,0,0,0,2009-1-1,0
2009,1,2,0,0,0,2009-1-2,0
2009,1,3,0,0,0,2009-1-3,0
2009,1,4,0,0,0,2009-1-4,0
2009,1,5,0,0,0,2009-1-5,0
2009,1,6,0,0,0,2009-1-6,0
2009,1,7,0,0,0,2009-1-7,0
2009,1,8,0,0,0,2009-1-8,0
2009,1,9,28,28,0,2009-1-9,28
2009,1,10,42,42,0,2009-1-10,42
2009,1,11,70,70,0,2009-1-11,70
2009,1,12,14,14,0,2009-1-12,14
2009,1,13,14,14,0,2009-1-13,14
2009,1,14,0,0,0,2009-1-14,0
2009,1,15,0,0,0,2009-1-15,0
2009,1,16,0,0,0,2009-1-16,0
2009,1,17,0,0,0,2009-1-17,0
2009,1,18,0,0,0,2009-1-18,0
2009,1,19,14,0,14,2009-1-19,-14
2009,1,20,0,0,0,2009-1-20,0
2009,1,21,0,0,0,2009-1-21,0
2009,1,22,0,0,0,2009-1-22,0
2009,1,23,0,0,0,2009-1-23,0
2009,1,24,0,0,0,2009-1-24,0
2009,1,25,0,0,0,2009-1-25,0
2009,1,26,0,0,0,2009-1-26,0
2009,1,27,0,0,0,2009-1-27,0
2009,1,28,0,0,0,2009-1-28,0
2009,1,29,0,0,0,2009-1-29,0
2009,1,30,0,0,0,2009-1-30,0
2009,1,31,0,0,0,2009-1-31,0
2009,2,1,0,0,0,2009-2-1,0
2009,2,2,0,0,0,2009-2-2,0
2009,2,3,0,0,0,2009-2-3,0
2009,2,4,0,0,0,2009-2-4,0
2009,2,5,0,0,0,2009-2-5,0
2009,2,6,0,0,0,2009-2-6,0
2009,2,7,0,0,0,2009-2-7,0
2009,2,8,0,0,0,2009-2-8,0
2009,2,9,0,0,0,2009-2-9,0
2009,2,10,0,0,0,2009-2-10,0
2009,2,11,14,0,14,2009-2-11,-14
2009,2,12,14,0,14,2009-2-12,-14
2009,2,13,14,0,14,2009-2-13,-14
2009,2,14,0,0,0,2009-2-14,0
2009,2,15,0,0,0,2009-2-15,0
2009,2,16,0,0,0,2009-2-16,0
2009,2,17,0,0,0,2009-2-17,0
2009,2,18,0,0,0,2009-2-18,0
2009,2,19,0,0,0,2009-2-19,0
2009,2,20,0,0,0,2009-2-20,0
2009,2,21,0,0,0,2009-2-21,0
2009,2,22,0,0,0,2009-2-22,0
2009,2,23,0,0,0,2009-2-23,0
2009,2,24,28,28,0,2009-2-24,28
2009,2,25,14,14,0,2009-2-25,14
2009,2,26,14,14,0,2009-2-26,14
2009,2,27,0,0,0,2009-2-27,0
2009,2,28,0,0,0,2009-2-28,0
2009,3,1,0,0,0,2009-3-1,0
2009,3,2,0,0,0,2009-3-2,0
2009,3,3,0,0,0,2009-3-3,0
2009,3,4,0,0,0,2009-3-4,0
2009,3,5,0,0,0,2009-3-5,0
2009,3,6,28,0,28,2009-3-6,-28
2009,3,7,28,0,28,2009-3-7,-28
2009,3,8,0,0,0,2009-3-8,0
2009,3,9,0,0,0,2009-3-9,0
2009,3,10,0,0,0,2009-3-10,0
2009,3,11,0,0,0,2009-3-11,0
2009,3,12,0,0,0,2009-3-12,0
2009,3,13,0,0,0,2009-3-13,0
2009,3,14,0,0,0,2009-3-14,0
2009,3,15,0,0,0,2009-3-15,0
2009,3,16,0,0,0,2009-3-16,0
2009,3,17,0,0,0,2009-3-17,0
2009,3,18,0,0,0,2009-3-18,0
2009,3,19,0,0,0,2009-3-19,0
2009,3,20,0,0,0,2009-3-20,0
2009,3,21,0,0,0,2009-3-21,0
2009,3,22,0,0,0,2009-3-22,0
2009,3,23,0,0,0,2009-3-23,0
2009,3,24,0,0,0,2009-3-24,0
2009,3,25,0,0,0,2009-3-25,0
2009,3,26,0,0,0,2009-3-26,0
2009,3,27,0,0,0,2009-3-27,0
2009,3,28,0,0,0,2009-3-28,0
2009,3,29,0,0,0,2009-3-29,0
2009,3,30,0,0,0,2009-3-30,0
2009,3,31,0,0,0,2009-3-31,0
2009,4,1,0,0,0,2009-4-1,0
2009,4,2,0,0,0,2009-4-2,0
2009,4,3,0,0,0,2009-4-3,0
2009,4,4,0,0,0,2009-4-4,0
2009,4,5,0,0,0,2009-4-5,0
2009,4,6,0,0,0,2009-4-6,0
2009,4,7,0,0,0,2009-4-7,0
2009,4,8,0,0,0,2009-4-8,0
2009,4,9,0,0,0,2009-4-9,0
2009,4,10,0,0,0,2009-4-10,0
2009,4,11,0,0,0,2009-4-11,0
2009,4,12,0,0,0,2009-4-12,0
2009,4,13,0,0,0,2009-4-13,0
2009,4,14,0,0,0,2009-4-14,0
2009,4,15,0,0,0,2009-4-15,0
2009,4,16,0,0,0,2009-4-16,0
2009,4,17,0,0,0,2009-4-17,0
2009,4,18,0,0,0,2009-4-18,0
2009,4,19,0,0,0,2009-4-19,0
2009,4,20,0,0,0,2009-4-20,0
2009,4,21,14,14,0,2009-4-21,14
2009,4,22,0,0,0,2009-4-22,0
2009,4,23,0,0,0,2009-4-23,0
2009,4,24,0,0,0,2009-4-24,0
2009,4,25,0,0,0,2009-4-25,0
2009,4,26,0,0,0,2009-4-26,0
2009,4,27,0,0,0,2009-4-27,0
2009,4,28,0,0,0,2009-4-28,0
2009,4,29,28,0,28,2009-4-29,-28
2009,4,30,14,0,14,2009-4-30,-14
2009,5,1,0,0,0,2009-5-1,0
2009,5,2,0,0,0,2009-5-2,0
2009,5,3,0,0,0,2009-5-3,0
2009,5,4,0,0,0,2009-5-4,0
2009,5,5,0,0,0,2009-5-5,0
2009,5,6,0,0,0,2009-5-6,0
2009,5,7,0,0,0,2009-5-7,0
2009,5,8,0,0,0,2009-5-8,0
2009,5,9,0,0,0,2009-5-9,0
2009,5,10,0,0,0,2009-5-10,0
2009,5,11,0,0,0,2009-5-11,0
2009,5,12,0,0,0,2009-5-12,0
2009,5,13,14,14,0,2009-5-13,14
2009,5,14,28,28,0,2009-5-14,28
2009,5,15,14,14,0,2009-5-15,14
2009,5,16,28,28,0,2009-5-16,28
2009,5,17,14,14,0,2009-5-17,14
2009,5,18,42,42,0,2009-5-18,42
2009,5,19,14,14,0,2009-5-19,14
2009,5,20,0,0,0,2009-5-20,0
2009,5,21,0,0,0,2009-5-21,0
2009,5,22,0,0,0,2009-5-22,0
2009,5,23,42,0,42,2009-5-23,-42
2009,5,24,0,0,0,2009-5-24,0
2009,5,25,0,0,0,2009-5-25,0
2009,5,26,0,0,0,2009-5-26,0
2009,5,27,0,0,0,2009-5-27,0
2009,5,28,0,0,0,2009-5-28,0
2009,5,29,0,0,0,2009-5-29,0
2009,5,30,0,0,0,2009-5-30,0
2009,5,31,42,42,0,2009-5-31,42
2009,6,1,112,112,0,2009-6-1,112
2009,6,2,84,84,0,2009-6-2,84
2009,6,3,14,14,0,2009-6-3,14
2009,6,4,28,28,0,2009-6-4,28
2009,6,5,14,14,0,2009-6-5,14
2009,6,6,0,0,0,2009-6-6,0
2009,6,7,0,0,0,2009-6-7,0
2009,6,8,28,28,0,2009-6-8,28
2009,6,9,28,28,0,2009-6-9,28
2009,6,10,0,0,0,2009-6-10,0
2009,6,11,0,0,0,2009-6-11,0
2009,6,12,14,14,0,2009-6-12,14
2009,6,13,0,0,0,2009-6-13,0
2009,6,14,0,0,0,2009-6-14,0
2009,6,15,0,0,0,2009-6-15,0
2009,6,16,0,0,0,2009-6-16,0
2009,6,17,14,0,14,2009-6-17,-14
2009,6,18,0,0,0,2009-6-18,0
2009,6,19,0,0,0,2009-6-19,0
2009,6,20,0,0,0,2009-6-20,0
2009,6,21,28,0,28,2009-6-21,-28
2009,6,22,70,0,70,2009-6-22,-70
2009,6,23,42,0,42,2009-6-23,-42
2009,6,24,56,0,56,2009-6-24,-56
2009,6,25,0,0,0,2009-6-25,0
2009,6,26,0,0,0,2009-6-26,0
2009,6,27,0,0,0,2009-6-27,0
2009,6,28,0,0,0,2009-6-28,0
2009,6,29,0,0,0,2009-6-29,0
2009,6,30,0,0,0,2009-6-30,0
2009,7,1,0,0,0,2009-7-1,0
2009,7,2,0,0,0,2009-7-2,0
2009,7,3,84,0,84,2009-7-3,-84
2009,7,4,140,0,140,2009-7-4,-140
2009,7,5,238,0,238,2009-7-5,-238
2009,7,6,224,0,224,2009-7-6,-224
2009,7,7,252,0,252,2009-7-7,-252
2009,7,8,266,0,266,2009-7-8,-266
2009,7,9,322,0,322,2009-7-9,-322
2009,7,10,84,0,84,2009-7-10,-84
2009,7,11,0,0,0,2009-7-11,0
2009,7,12,0,0,0,2009-7-12,0
2009,7,13,0,0,0,2009-7-13,0
2009,7,14,0,0,0,2009-7-14,0
2009,7,15,0,0,0,2009-7-15,0
2009,7,16,0,0,0,2009-7-16,0
2009,7,17,0,0,0,2009-7-17,0
2009,7,18,0,0,0,2009-7-18,0
2009,7,19,0,0,0,2009-7-19,0
2009,7,20,0,0,0,2009-7-20,0
2009,7,21,0,0,0,2009-7-21,0
2009,7,22,0,0,0,2009-7-22,0
2009,7,23,0,0,0,2009-7-23,0
2009,7,24,0,0,0,2009-7-24,0
2009,7,25,0,0,0,2009-7-25,0
2009,7,26,0,0,0,2009-7-26,0
2009,7,27,0,0,0,2009-7-27,0
2009,7,28,0,0,0,2009-7-28,0
2009,7,29,0,0,0,2009-7-29,0
2009,7,30,0,0,0,2009-7-30,0
2009,7,31,0,0,0,2009-7-31,0
2009,8,1,0,0,0,2009-8-1,0
2009,8,2,0,0,0,2009-8-2,0
2009,8,3,0,0,0,2009-8-3,0
2009,8,4,0,0,0,2009-8-4,0
2009,8,5,0,0,0,2009-8-5,0
2009,8,6,0,0,0,2009-8-6,0
2009,8,7,0,0,0,2009-8-7,0
2009,8,8,0,0,0,2009-8-8,0
2009,8,9,0,0,0,2009-8-9,0
2009,8,10,0,0,0,2009-8-10,0
2009,8,11,0,0,0,2009-8-11,0
2009,8,12,0,0,0,2009-8-12,0
2009,8,13,0,0,0,2009-8-13,0
2009,8,14,0,0,0,2009-8-14,0
2009,8,15,0,0,0,2009-8-15,0
2009,8,16,0,0,0,2009-8-16,0
2009,8,17,0,0,0,2009-8-17,0
2009,8,18,0,0,0,2009-8-18,0
2009,8,19,0,0,0,2009-8-19,0
2009,8,20,0,0,0,2009-8-20,0
2009,8,21,0,0,0,2009-8-21,0
2009,8,22,0,0,0,2009-8-22,0
2009,8,23,0,0,0,2009-8-23,0
2009,8,24,0,0,0,2009-8-24,0
2009,8,25,0,0,0,2009-8-25,0
2009,8,26,0,0,0,2009-8-26,0
2009,8,27,0,0,0,2009-8-27,0
2009,8,28,0,0,0,2009-8-28,0
2009,8,29,0,0,0,2009-8-29,0
2009,8,30,0,0,0,2009-8-30,0
2009,8,31,14,14,0,2009-8-31,14
2009,9,1,14,14,0,2009-9-1,14
2009,9,2,0,0,0,2009-9-2,0
2009,9,3,0,0,0,2009-9-3,0
2009,9,4,0,0,0,2009-9-4,0
2009,9,5,0,0,0,2009-9-5,0
2009,9,6,0,0,0,2009-9-6,0
2009,9,7,0,0,0,2009-9-7,0
2009,9,8,0,0,0,2009-9-8,0
2009,9,9,0,0,0,2009-9-9,0
2009,9,10,0,0,0,2009-9-10,0
2009,9,11,0,0,0,2009-9-11,0
2009,9,12,0,0,0,2009-9-12,0
2009,9,13,0,0,0,2009-9-13,0
2009,9,14,0,0,0,2009-9-14,0
2009,9,15,0,0,0,2009-9-15,0
2009,9,16,0,0,0,2009-9-16,0
2009,9,17,0,0,0,2009-9-17,0
2009,9,18,0,0,0,2009-9-18,0
2009,9,19,0,0,0,2009-9-19,0
2009,9,20,0,0,0,2009-9-20,0
2009,9,21,14,0,14,2009-9-21,-14
2009,9,22,98,56,42,2009-9-22,14
2009,9,23,196,140,56,2009-9-23,84
2009,9,24,252,154,98,2009-9-24,56
2009,9,25,112,84,28,2009-9-25,56
2009,9,26,84,84,0,2009-9-26,84
2009,9,27,14,14,0,2009-9-27,14
2009,9,28,84,84,0,2009-9-28,84
2009,9,29,56,56,0,2009-9-29,56
2009,9,30,14,14,0,2009-9-30,14
2009,10,1,14,14,0,2009-10-1,14
2009,10,2,0,0,0,2009-10-2,0
2009,10,3,0,0,0,2009-10-3,0
2009,10,4,0,0,0,2009-10-4,0
2009,10,5,0,0,0,2009-10-5,0
2009,10,6,0,0,0,2009-10-6,0
2009,10,7,0,0,0,2009-10-7,0
2009,10,8,0,0,0,2009-10-8,0
2009,10,9,0,0,0,2009-10-9,0
2009,10,10,0,0,0,2009-10-10,0
2009,10,11,0,0,0,2009-10-11,0
2009,10,12,0,0,0,2009-10-12,0
2009,10,13,0,0,0,2009-10-13,0
2009,10,14,0,0,0,2009-10-14,0
2009,10,15,0,0,0,2009-10-15,0
2009,10,16,0,0,0,2009-10-16,0
2009,10,17,0,0,0,2009-10-17,0
2009,10,18,0,0,0,2009-10-18,0
2009,10,19,0,0,0,2009-10-19,0
2009,10,20,14,14,0,2009-10-20,14
2009,10,21,0,0,0,2009-10-21,0
2009,10,22,0,0,0,2009-10-22,0
2009,10,23,84,84,0,2009-10-23,84
2009,10,24,168,168,0,2009-10-24,168
2009,10,25,182,182,0,2009-10-25,182
2009,10,26,266,266,0,2009-10-26,266
2009,10,27,364,364,0,2009-10-27,364
2009,10,28,476,476,0,2009-10-28,476
2009,10,29,532,532,0,2009-10-29,532
2009,10,30,448,448,0,2009-10-30,448
2009,10,31,0,0,0,2009-10-31,0
2009,11,1,0,0,0,2009-11-1,0
2009,11,2,0,0,0,2009-11-2,0
2009,11,3,0,0,0,2009-11-3,0
2009,11,4,0,0,0,2009-11-4,0
2009,11,5,70,70,0,2009-11-5,70
2009,11,6,14,14,0,2009-11-6,14
2009,11,7,14,14,0,2009-11-7,14
2009,11,8,0,0,0,2009-11-8,0
2009,11,9,14,14,0,2009-11-9,14
2009,11,10,14,14,0,2009-11-10,14
2009,11,11,14,14,0,2009-11-11,14
2009,11,12,14,14,0,2009-11-12,14
2009,11,13,0,0,0,2009-11-13,0
2009,11,14,0,0,0,2009-11-14,0
2009,11,15,14,14,0,2009-11-15,14
2009,11,16,14,14,0,2009-11-16,14
2009,11,17,0,0,0,2009-11-17,0
2009,11,18,70,70,0,2009-11-18,70
2009,11,19,98,98,0,2009-11-19,98
2009,11,20,28,28,0,2009-11-20,28
2009,11,21,42,42,0,2009-11-21,42
2009,11,22,14,14,0,2009-11-22,14
2009,11,23,0,0,0,2009-11-23,0
2009,11,24,0,0,0,2009-11-24,0
2009,11,25,0,0,0,2009-11-25,0
2009,11,26,0,0,0,2009-11-26,0
2009,11,27,0,0,0,2009-11-27,0
2009,11,28,0,0,0,2009-11-28,0
2009,11,29,0,0,0,2009-11-29,0
2009,11,30,0,0,0,2009-11-30,0
2009,12,1,0,0,0,2009-12-1,0
2009,12,2,0,0,0,2009-12-2,0
2009,12,3,0,0,0,2009-12-3,0
2009,12,4,0,0,0,2009-12-4,0
2009,12,5,0,0,0,2009-12-5,0
2009,12,6,0,0,0,2009-12-6,0
2009,12,7,0,0,0,2009-12-7,0
2009,12,8,0,0,0,2009-12-8,0
2009,12,9,14,14,0,2009-12-9,14
2009,12,10,14,14,0,2009-12-10,14
2009,12,11,28,28,0,2009-12-11,28
2009,12,12,28,28,0,2009-12-12,28
2009,12,13,28,28,0,2009-12-13,28
2009,12,14,42,42,0,2009-12-14,42
2009,12,15,182,182,0,2009-12-15,182
2009,12,16,196,196,0,2009-12-16,196
2009,12,17,294,294,0,2009-12-17,294
2009,12,18,434,434,0,2009-12-18,434
2009,12,19,336,322,14,2009-12-19,308
2009,12,20,462,448,14,2009-12-20,434
2009,12,21,252,154,98,2009-12-21,56
2009,12,22,28,14,14,2009-12-22,0
2009,12,23,98,28,70,2009-12-23,-42
2009,12,24,14,14,0,2009-12-24,14
2009,12,25,0,0,0,2009-12-25,0
2009,12,26,14,0,14,2009-12-26,-14
2009,12,27,140,0,140,2009-12-27,-140
2009,12,28,126,0,126,2009-12-28,-126
2009,12,29,112,0,112,2009-12-29,-112
2009,12,30,70,0,70,2009-12-30,-70
2009,12,31,182,0,182,2009-12-31,-182
2010,1,1,168,0,168,2010-1-1,-168
2010,1,2,266,0,266,2010-1-2,-266
2010,1,3,308,0,308,2010-1-3,-308
2010,1,4,210,0,210,2010-1-4,-210
2010,1,5,126,0,126,2010-1-5,-126
2010,1,6,0,0,0,2010-1-6,0
2010,1,7,112,112,0,2010-1-7,112
2010,1,8,56,56,0,2010-1-8,56
2010,1,9,98,98,0,2010-1-9,98
2010,1,10,182,182,0,2010-1-10,182
2010,1,11,420,420,0,2010-1-11,420
2010,1,12,420,420,0,2010-1-12,420
2010,1,13,532,532,0,2010-1-13,532
2010,1,14,406,406,0,2010-1-14,406
2010,1,15,490,490,0,2010-1-15,490
2010,1,16,406,406,0,2010-1-16,406
2010,1,17,224,224,0,2010-1-17,224
2010,1,18,196,196,0,2010-1-18,196
2010,1,19,0,0,0,2010-1-19,0
2010,1,20,84,0,84,2010-1-20,-84
2010,1,21,266,0,266,2010-1-21,-266
2010,1,22,336,56,280,2010-1-22,-224
2010,1,23,532,266,266,2010-1-23,0
2010,1,24,462,224,238,2010-1-24,-14
2010,1,25,140,70,70,2010-1-25,0
2010,1,26,210,126,84,2010-1-26,42
2010,1,27,56,0,56,2010-1-27,-56
2010,1,28,42,0,42,2010-1-28,-42
2010,1,29,28,0,28,2010-1-29,-28
2010,1,30,70,56,14,2010-1-30,42
2010,1,31,84,84,0,2010-1-31,84
2010,2,1,98,98,0,2010-2-1,98
2010,2,2,70,70,0,2010-2-2,70
2010,2,3,70,70,0,2010-2-3,70
2010,2,4,28,28,0,2010-2-4,28
2010,2,5,42,42,0,2010-2-5,42
2010,2,6,434,434,0,2010-2-6,434
2010,2,7,504,504,0,2010-2-7,504
2010,2,8,644,630,14,2010-2-8,616
2010,2,9,448,434,14,2010-2-9,420
2010,2,10,532,518,14,2010-2-10,504
2010,2,11,476,476,0,2010-2-11,476
2010,2,12,308,308,0,2010-2-12,308
2010,2,13,322,322,0,2010-2-13,322
2010,2,14,112,112,0,2010-2-14,112
2010,2,15,70,70,0,2010-2-15,70
2010,2,16,70,70,0,2010-2-16,70
2010,2,17,112,56,56,2010-2-17,0
2010,2,18,84,0,84,2010-2-18,-84
2010,2,19,84,0,84,2010-2-19,-84
2010,2,20,84,0,84,2010-2-20,-84
2010,2,21,70,0,70,2010-2-21,-70
2010,2,22,28,0,28,2010-2-22,-28
2010,2,23,42,0,42,2010-2-23,-42
2010,2,24,168,140,28,2010-2-24,112
2010,2,25,42,14,28,2010-2-25,-14
2010,2,26,98,56,42,2010-2-26,14
2010,2,27,42,42,0,2010-2-27,42
2010,2,28,14,14,0,2010-2-28,14
2010,3,1,70,14,56,2010-3-1,-42
2010,3,2,84,14,70,2010-3-2,-56
2010,3,3,42,14,28,2010-3-3,-14
2010,3,4,126,14,112,2010-3-4,-98
2010,3,5,42,14,28,2010-3-5,-14
2010,3,6,0,0,0,2010-3-6,0
2010,3,7,0,0,0,2010-3-7,0
2010,3,8,0,0,0,2010-3-8,0
2010,3,9,0,0,0,2010-3-9,0
2010,3,10,14,14,0,2010-3-10,14
2010,3,11,196,154,42,2010-3-11,112
2010,3,12,308,266,42,2010-3-12,224
2010,3,13,322,322,0,2010-3-13,322
2010,3,14,322,322,0,2010-3-14,322
2010,3,15,336,336,0,2010-3-15,336
2010,3,16,126,126,0,2010-3-16,126
2010,3,17,126,126,0,2010-3-17,126
2010,3,18,126,126,0,2010-3-18,126
2010,3,19,28,28,0,2010-3-19,28
2010,3,20,56,56,0,2010-3-20,56
2010,3,21,98,98,0,2010-3-21,98
2010,3,22,70,70,0,2010-3-22,70
2010,3,23,14,14,0,2010-3-23,14
2010,3,24,336,336,0,2010-3-24,336
2010,3,25,561.4,561.4,0,2010-3-25,561.4
2010,3,26,455,455,0,2010-3-26,455
2010,3,27,700,532,168,2010-3-27,364
2010,3,28,714,574,140,2010-3-28,434
2010,3,29,616,406,210,2010-3-29,196
2010,3,30,546,364,182,2010-3-30,182
2010,3,31,448,350,98,2010-3-31,252
2010,4,1,336,266,70,2010-4-1,196
2010,4,2,406,350,56,2010-4-2,294
2010,4,3,350,280,70,2010-4-3,210
2010,4,4,294,252,42,2010-4-4,210
2010,4,5,196,154,42,2010-4-5,112
2010,4,6,210,196,14,2010-4-6,182
2010,4,7,112,112,0,2010-4-7,112
2010,4,8,70,70,0,2010-4-8,70
2010,4,9,56,56,0,2010-4-9,56
2010,4,10,14,14,0,2010-4-10,14
2010,4,11,0,0,0,2010-4-11,0
2010,4,12,14,0,14,2010-4-12,-14
2010,4,13,28,0,28,2010-4-13,-28
2010,4,14,14,0,14,2010-4-14,-14
2010,4,15,0,0,0,2010-4-15,0
2010,4,16,0,0,0,2010-4-16,0
2010,4,17,0,0,0,2010-4-17,0
2010,4,18,0,0,0,2010-4-18,0
2010,4,19,0,0,0,2010-4-19,0
2010,4,20,0,0,0,2010-4-20,0
2010,4,21,0,0,0,2010-4-21,0
2010,4,22,0,0,0,2010-4-22,0
2010,4,23,0,0,0,2010-4-23,0
2010,4,24,0,0,0,2010-4-24,0
2010,4,25,0,0,0,2010-4-25,0
2010,4,26,0,0,0,2010-4-26,0
2010,4,27,0,0,0,2010-4-27,0
2010,4,28,14,14,0,2010-4-28,14
2010,4,29,0,0,0,2010-4-29,0
2010,4,30,28,28,0,2010-4-30,28
2010,5,1,14,14,0,2010-5-1,14
2010,5,2,28,28,0,2010-5-2,28
2010,5,3,70,42,28,2010-5-3,14
2010,5,4,140,112,28,2010-5-4,84
2010,5,5,308,280,28,2010-5-5,252
2010,5,6,140,126,14,2010-5-6,112
2010,5,7,42,42,0,2010-5-7,42
2010,5,8,42,42,0,2010-5-8,42
2010,5,9,0,0,0,2010-5-9,0
2010,5,10,0,0,0,2010-5-10,0
2010,5,11,0,0,0,2010-5-11,0
2010,5,12,0,0,0,2010-5-12,0
2010,5,13,0,0,0,2010-5-13,0
2010,5,14,0,0,0,2010-5-14,0
2010,5,15,0,0,0,2010-5-15,0
2010,5,16,0,0,0,2010-5-16,0
2010,5,17,0,0,0,2010-5-17,0
2010,5,18,0,0,0,2010-5-18,0
2010,5,19,0,0,0,2010-5-19,0
2010,5,20,0,0,0,2010-5-20,0
2010,5,21,42,0,42,2010-5-21,-42
2010,5,22,140,0,140,2010-5-22,-140
2010,5,23,182,0,182,2010-5-23,-182
2010,5,24,126,0,126,2010-5-24,-126
2010,5,25,84,0,84,2010-5-25,-84
2010,5,26,70,0,70,2010-5-26,-70
2010,5,27,56,0,56,2010-5-27,-56
2010,5,28,63,0,63,2010-5-28,-63
2010,5,29,70,42,28,2010-5-29,14
2010,5,30,56,42,14,2010-5-30,28
2010,5,31,42,14,28,2010-5-31,-14
2010,6,1,28,0,28,2010-6-1,-28
2010,6,2,56,0,56,2010-6-2,-56
2010,6,3,266,0,266,2010-6-3,-266
2010,6,4,98,0,98,2010-6-4,-98
2010,6,5,35,14,21,2010-6-5,-7
2010,6,6,126,0,126,2010-6-6,-126
2010,6,7,28,0,28,2010-6-7,-28
2010,6,8,112,0,112,2010-6-8,-112
2010,6,9,266,0,266,2010-6-9,-266
2010,6,10,294,0,294,2010-6-10,-294
2010,6,11,217,70,147,2010-6-11,-77
2010,6,12,196,112,84,2010-6-12,28
2010,6,13,154,126,28,2010-6-13,98
2010,6,14,14,14,0,2010-6-14,14
2010,6,15,0,0,0,2010-6-15,0
2010,6,16,0,0,0,2010-6-16,0
2010,6,17,14,14,0,2010-6-17,14
2010,6,18,14,14,0,2010-6-18,14
2010,6,19,28,28,0,2010-6-19,28
2010,6,20,42,42,0,2010-6-20,42
2010,6,21,56,56,0,2010-6-21,56
2010,6,22,42,42,0,2010-6-22,42
2010,6,23,28,28,0,2010-6-23,28
2010,6,24,14,14,0,2010-6-24,14
2010,6,25,0,0,0,2010-6-25,0
2010,6,26,0,0,0,2010-6-26,0
2010,6,27,126,0,126,2010-6-27,-126
2010,6,28,126,0,126,2010-6-28,-126
2010,6,29,154,0,154,2010-6-29,-154
2010,6,30,154,0,154,2010-6-30,-154
2010,7,1,154,0,154,2010-7-1,-154
2010,7,2,140,0,140,2010-7-2,-140
2010,7,3,210,0,210,2010-7-3,-210
2010,7,4,154,0,154,2010-7-4,-154
2010,7,5,154,14,140,2010-7-5,-126
2010,7,6,168,14,154,2010-7-6,-140
2010,7,7,154,14,140,2010-7-7,-126
2010,7,8,70,0,70,2010-7-8,-70
2010,7,9,42,42,0,2010-7-9,42
2010,7,10,140,140,0,2010-7-10,140
2010,7,11,168,168,0,2010-7-11,168
2010,7,12,182,182,0,2010-7-12,182
2010,7,13,112,98,14,2010-7-13,84
2010,7,14,140,140,0,2010-7-14,140
2010,7,15,84,84,0,2010-7-15,84
2010,7,16,70,70,0,2010-7-16,70
2010,7,17,28,28,0,2010-7-17,28
2010,7,18,14,14,0,2010-7-18,14
2010,7,19,196,14,182,2010-7-19,-168
2010,7,20,224,14,210,2010-7-20,-196
2010,7,21,448,14,434,2010-7-21,-420
2010,7,22,336,0,336,2010-7-22,-336
2010,7,23,280,0,280,2010-7-23,-280
2010,7,24,224,0,224,2010-7-24,-224
2010,7,25,210,14,196,2010-7-25,-182
2010,7,26,140,0,140,2010-7-26,-140
2010,7,27,98,0,98,2010-7-27,-98
2010,7,28,378,252,126,2010-7-28,126
2010,7,29,490,294,196,2010-7-29,98
2010,7,30,294,238,56,2010-7-30,182
2010,7,31,322,322,0,2010-7-31,322
2010,8,1,406,406,0,2010-8-1,406
2010,8,2,392,392,0,2010-8-2,392
2010,8,3,266,266,0,2010-8-3,266
2010,8,4,392,392,0,2010-8-4,392
2010,8,5,602,588,14,2010-8-5,574
2010,8,6,602,588,14,2010-8-6,574
2010,8,7,420,406,14,2010-8-7,392
2010,8,8,462,448,14,2010-8-8,434
2010,8,9,532,518,14,2010-8-9,504
2010,8,10,294,280,14,2010-8-10,266
2010,8,11,280,266,14,2010-8-11,252
2010,8,12,406,406,0,2010-8-12,406
2010,8,13,168,168,0,2010-8-13,168
2010,8,14,210,210,0,2010-8-14,210
2010,8,15,182,182,0,2010-8-15,182
2010,8,16,140,126,14,2010-8-16,112
2010,8,17,28,14,14,2010-8-17,0
2010,8,18,28,14,14,2010-8-18,0
2010,8,19,0,0,0,2010-8-19,0
2010,8,20,0,0,0,2010-8-20,0
2010,8,21,0,0,0,2010-8-21,0
2010,8,22,0,0,0,2010-8-22,0
2010,8,23,0,0,0,2010-8-23,0
2010,8,24,42,42,0,2010-8-24,42
2010,8,25,140,126,14,2010-8-25,112
2010,8,26,140,126,14,2010-8-26,112
2010,8,27,140,140,0,2010-8-27,140
2010,8,28,182,182,0,2010-8-28,182
2010,8,29,238,238,0,2010-8-29,238
2010,8,30,252,252,0,2010-8-30,252
2010,8,31,308,308,0,2010-8-31,308
2010,9,1,378,378,0,2010-9-1,378
2010,9,2,252,252,0,2010-9-2,252
2010,9,3,252,252,0,2010-9-3,252
2010,9,4,280,280,0,2010-9-4,280
2010,9,5,364,364,0,2010-9-5,364
2010,9,6,210,210,0,2010-9-6,210
2010,9,7,56,56,0,2010-9-7,56
2010,9,8,14,14,0,2010-9-8,14
2010,9,9,0,0,0,2010-9-9,0
2010,9,10,0,0,0,2010-9-10,0
2010,9,11,70,0,70,2010-9-11,-70
2010,9,12,126,14,112,2010-9-12,-98
2010,9,13,140,0,140,2010-9-13,-140
2010,9,14,154,0,154,2010-9-14,-154
2010,9,15,126,0,126,2010-9-15,-126
2010,9,16,560,0,560,2010-9-16,-560
2010,9,17,504,0,504,2010-9-17,-504
2010,9,18,658,0,658,2010-9-18,-658
2010,9,19,714,0,714,2010-9-19,-714
2010,9,20,560,0,560,2010-9-20,-560
2010,9,21,422.8,42,380.8,2010-9-21,-338.8
2010,9,22,756,280,476,2010-9-22,-196
2010,9,23,658,294,364,2010-9-23,-70
2010,9,24,784,392,392,2010-9-24,0
2010,9,25,686,392,294,2010-9-25,98
2010,9,26,826,518,308,2010-9-26,210
2010,9,27,910,588,322,2010-9-27,266
2010,9,28,602,406,196,2010-9-28,210
2010,9,29,518,518,0,2010-9-29,518
2010,9,30,392,392,0,2010-9-30,392
2010,10,1,392,392,0,2010-10-1,392
2010,10,2,490,490,0,2010-10-2,490
2010,10,3,350,350,0,2010-10-3,350
2010,10,4,154,154,0,2010-10-4,154
2010,10,5,0,0,0,2010-10-5,0
2010,10,6,0,0,0,2010-10-6,0
2010,10,7,0,0,0,2010-10-7,0
2010,10,8,0,0,0,2010-10-8,0
2010,10,9,56,0,56,2010-10-9,-56
2010,10,10,70,0,70,2010-10-10,-70
2010,10,11,42,0,42,2010-10-11,-42
2010,10,12,28,0,28,2010-10-12,-28
2010,10,13,182,168,14,2010-10-13,154
2010,10,14,168,140,28,2010-10-14,112
2010,10,15,532,182,350,2010-10-15,-168
2010,10,16,588,182,406,2010-10-16,-224
2010,10,17,700,252,448,2010-10-17,-196
2010,10,18,630,210,420,2010-10-18,-210
2010,10,19,602,252,350,2010-10-19,-98
2010,10,20,420,252,168,2010-10-20,84
2010,10,21,420,224,196,2010-10-21,28
2010,10,22,378,224,154,2010-10-22,70
2010,10,23,504,308,196,2010-10-23,112
2010,10,24,630,462,168,2010-10-24,294
2010,10,25,756,532,224,2010-10-25,308
2010,10,26,756,588,168,2010-10-26,420
2010,10,27,756,644,112,2010-10-27,532
2010,10,28,728,728,0,2010-10-28,728
2010,10,29,770,770,0,2010-10-29,770
2010,10,30,686,686,0,2010-10-30,686
2010,10,31,770,770,0,2010-10-31,770
2010,11,1,420,420,0,2010-11-1,420
2010,11,2,112,112,0,2010-11-2,112
2010,11,3,70,70,0,2010-11-3,70
2010,11,4,28,14,14,2010-11-4,0
2010,11,5,112,14,98,2010-11-5,-84
2010,11,6,126,14,112,2010-11-6,-98
2010,11,7,140,14,126,2010-11-7,-112
2010,11,8,112,42,70,2010-11-8,-28
2010,11,9,98,28,70,2010-11-9,-42
2010,11,10,98,42,56,2010-11-10,-14
2010,11,11,154,42,112,2010-11-11,-70
2010,11,12,140,56,84,2010-11-12,-28
2010,11,13,252,154,98,2010-11-13,56
2010,11,14,210,154,56,2010-11-14,98
2010,11,15,462,378,84,2010-11-15,294
2010,11,16,658,546,112,2010-11-16,434
2010,11,17,560,434,126,2010-11-17,308
2010,11,18,350,294,56,2010-11-18,238
2010,11,19,462,406,56,2010-11-19,350
2010,11,20,168,98,70,2010-11-20,28
2010,11,21,112,84,28,2010-11-21,56
2010,11,22,126,112,14,2010-11-22,98
2010,11,23,84,84,0,2010-11-23,84
2010,11,24,70,70,0,2010-11-24,70
2010,11,25,70,56,14,2010-11-25,42
2010,11,26,56,42,14,2010-11-26,28
2010,11,27,42,42,0,2010-11-27,42
2010,11,28,126,84,42,2010-11-28,42
2010,11,29,126,112,14,2010-11-29,98
2010,11,30,266,266,0,2010-11-30,266
2010,12,1,350,350,0,2010-12-1,350
2010,12,2,672,672,0,2010-12-2,672
2010,12,3,756,756,0,2010-12-3,756
2010,12,4,784,784,0,2010-12-4,784
2010,12,5,686,686,0,2010-12-5,686
2010,12,6,812,812,0,2010-12-6,812
2010,12,7,882,882,0,2010-12-7,882
2010,12,8,630,630,0,2010-12-8,630
2010,12,9,560,560,0,2010-12-9,560
2010,12,10,574,574,0,2010-12-10,574
2010,12,11,574,574,0,2010-12-11,574
2010,12,12,532,532,0,2010-12-12,532
2010,12,13,518,518,0,2010-12-13,518
2010,12,14,448,448,0,2010-12-14,448
2010,12,15,70,70,0,2010-12-15,70
2010,12,16,112,112,0,2010-12-16,112
2010,12,17,0,0,0,2010-12-17,0
2010,12,18,0,0,0,2010-12-18,0
2010,12,19,0,0,0,2010-12-19,0
2010,12,20,0,0,0,2010-12-20,0
2010,12,21,0,0,0,2010-12-21,0
2010,12,22,0,0,0,2010-12-22,0
2010,12,23,0,0,0,2010-12-23,0
2010,12,24,0,0,0,2010-12-24,0
2010,12,25,42,28,14,2010-12-25,14
2010,12,26,28,14,14,2010-12-26,0
2010,12,27,70,70,0,2010-12-27,70
2010,12,28,84,84,0,2010-12-28,84
2010,12,29,70,56,14,2010-12-29,42
2010,12,30,28,28,0,2010-12-30,28
2010,12,31,266,266,0,2010-12-31,266
2011,1,1,490,434,56,2011-1-1,378
2011,1,2,364,238,126,2011-1-2,112
2011,1,3,448,280,168,2011-1-3,112
2011,1,4,504,378,126,2011-1-4,252
2011,1,5,350,294,56,2011-1-5,238
2011,1,6,322,252,70,2011-1-6,182
2011,1,7,238,196,42,2011-1-7,154
2011,1,8,252,224,28,2011-1-8,196
2011,1,9,210,196,14,2011-1-9,182
2011,1,10,196,196,0,2011-1-10,196
2011,1,11,182,182,0,2011-1-11,182
2011,1,12,112,112,0,2011-1-12,112
2011,1,13,14,14,0,2011-1-13,14
2011,1,14,0,0,0,2011-1-14,0
2011,1,15,168,168,0,2011-1-15,168
2011,1,16,168,168,0,2011-1-16,168
2011,1,17,224,210,14,2011-1-17,196
2011,1,18,266,224,42,2011-1-18,182
2011,1,19,196,182,14,2011-1-19,168
2011,1,20,266,238,28,2011-1-20,210
2011,1,21,224,224,0,2011-1-21,224
2011,1,22,336,336,0,2011-1-22,336
2011,1,23,336,336,0,2011-1-23,336
2011,1,24,378,378,0,2011-1-24,378
2011,1,25,322,322,0,2011-1-25,322
2011,1,26,560,560,0,2011-1-26,560
2011,1,27,0,0,0,2011-1-27,0
2011,1,28,42,28,14,2011-1-28,14
2011,1,29,35,7,28,2011-1-29,-21
2011,1,30,70,0,70,2011-1-30,-70
2011,1,31,98,0,98,2011-1-31,-98
2011,2,1,112,0,112,2011-2-1,-112
2011,2,2,112,0,112,2011-2-2,-112
2011,2,3,28,0,28,2011-2-3,-28
2011,2,4,126,42,84,2011-2-4,-42
2011,2,5,35,14,21,2011-2-5,-7
2011,2,6,42,21,21,2011-2-6,0
2011,2,7,42,42,0,2011-2-7,42
2011,2,8,168,154,14,2011-2-8,140
2011,2,9,308,280,28,2011-2-9,252
2011,2,10,56,28,28,2011-2-10,0
2011,2,11,140,28,112,2011-2-11,-84
2011,2,12,126,56,70,2011-2-12,-14
2011,2,13,252,84,168,2011-2-13,-84
2011,2,14,742,112,630,2011-2-14,-518
2011,2,15,1099,259,840,2011-2-15,-581
2011,2,16,1050,182,868,2011-2-16,-686
2011,2,17,602,196,406,2011-2-17,-210
2011,2,18,1078,644,434,2011-2-18,210
2011,2,19,952,560,392,2011-2-19,168
2011,2,20,868,588,280,2011-2-20,308
2011,2,21,476,476,0,2011-2-21,476
2011,2,22,490,490,0,2011-2-22,490
2011,2,23,280,280,0,2011-2-23,280
2011,2,24,364,364,0,2011-2-24,364
2011,2,25,518,518,0,2011-2-25,518
2011,2,26,462,434,28,2011-2-26,406
2011,2,27,266,252,14,2011-2-27,238
2011,2,28,532,504,28,2011-2-28,476
2011,3,1,868,784,84,2011-3-1,700
2011,3,2,616,574,42,2011-3-2,532
2011,3,3,882,868,14,2011-3-3,854
2011,3,4,1540,1512,28,2011-3-4,1484
2011,3,5,2226,2002,224,2011-3-5,1778
2011,3,6,1750,1470,280,2011-3-6,1190
2011,3,7,2310,1722,588,2011-3-7,1134
2011,3,8,2156,1834,322,2011-3-8,1512
2011,3,9,1750,1680,70,2011-3-9,1610
2011,3,10,1316,1288,28,2011-3-10,1260
2011,3,11,1330,1330,0,2011-3-11,1330
2011,3,12,1470,1470,0,2011-3-12,1470
2011,3,13,1330,1330,0,2011-3-13,1330
2011,3,14,1148,1148,0,2011-3-14,1148
2011,3,15,700,700,0,2011-3-15,700
2011,3,16,420,364,56,2011-3-16,308
2011,3,17,238,154,84,2011-3-17,70
2011,3,18,70,28,42,2011-3-18,-14
2011,3,19,112,84,28,2011-3-19,56
2011,3,20,210,182,28,2011-3-20,154
2011,3,21,448,196,252,2011-3-21,-56
2011,3,22,658,182,476,2011-3-22,-294
2011,3,23,812,126,686,2011-3-23,-560
2011,3,24,560,28,532,2011-3-24,-504
2011,3,25,826,126,700,2011-3-25,-574
2011,3,26,938,154,784,2011-3-26,-630
2011,3,27,994,322,672,2011-3-27,-350
2011,3,28,826,406,420,2011-3-28,-14
2011,3,29,658,336,322,2011-3-29,14
2011,3,30,840,504,336,2011-3-30,168
2011,3,31,420,210,210,2011-3-31,0
2011,4,1,462,322,140,2011-4-1,182
2011,4,2,392,252,140,2011-4-2,112
2011,4,3,406,350,56,2011-4-3,294
2011,4,4,476,462,14,2011-4-4,448
2011,4,5,420,406,14,2011-4-5,392
2011,4,6,322,322,0,2011-4-6,322
2011,4,7,406,392,14,2011-4-7,378
2011,4,8,462,392,70,2011-4-8,322
2011,4,9,322,252,70,2011-4-9,182
2011,4,10,210,182,28,2011-4-10,154
2011,4,11,266,238,28,2011-4-11,210
2011,4,12,476,448,28,2011-4-12,420
2011,4,13,910,896,14,2011-4-13,882
2011,4,14,924,910,14,2011-4-14,896
2011,4,15,1302,1288,14,2011-4-15,1274
2011,4,16,1274,1260,14,2011-4-16,1246
2011,4,17,1134,1134,0,2011-4-17,1134
2011,4,18,952,952,0,2011-4-18,952
2011,4,19,952,924,28,2011-4-19,896
2011,4,20,777,525,252,2011-4-20,273
2011,4,21,854,434,420,2011-4-21,14
2011,4,22,840,280,560,2011-4-22,-280
2011,4,23,826,378,448,2011-4-23,-70
2011,4,24,728,280,448,2011-4-24,-168
2011,4,25,952,378,574,2011-4-25,-196
2011,4,26,343,28,315,2011-4-26,-287
2011,4,27,490,168,322,2011-4-27,-154
2011,4,28,630,308,322,2011-4-28,-14
2011,4,29,616,322,294,2011-4-29,28
2011,4,30,742,560,182,2011-4-30,378
2011,5,1,700,518,182,2011-5-1,336
2011,5,2,224,210,14,2011-5-2,196
2011,5,3,420,378,42,2011-5-3,336
2011,5,4,392,364,28,2011-5-4,336
2011,5,5,399,371,28,2011-5-5,343
2011,5,6,336,336,0,2011-5-6,336
2011,5,7,280,280,0,2011-5-7,280
2011,5,8,322,322,0,2011-5-8,322
2011,5,9,518,504,14,2011-5-9,490
2011,5,10,364,364,0,2011-5-10,364
2011,5,11,322,308,14,2011-5-11,294
2011,5,12,98,98,0,2011-5-12,98
2011,5,13,56,56,0,2011-5-13,56
2011,5,14,168,70,98,2011-5-14,-28
2011,5,15,182,84,98,2011-5-15,-14
2011,5,16,294,84,210,2011-5-16,-126
2011,5,17,224,14,210,2011-5-17,-196
2011,5,18,322,42,280,2011-5-18,-238
2011,5,19,308,0,308,2011-5-19,-308
2011,5,20,266,0,266,2011-5-20,-266
2011,5,21,238,0,238,2011-5-21,-238
2011,5,22,182,14,168,2011-5-22,-154
2011,5,23,196,70,126,2011-5-23,-56
2011,5,24,140,14,126,2011-5-24,-112
2011,5,25,98,14,84,2011-5-25,-70
2011,5,26,182,14,168,2011-5-26,-154
2011,5,27,252,70,182,2011-5-27,-112
2011,5,28,756,266,490,2011-5-28,-224
2011,5,29,1050,406,644,2011-5-29,-238
2011,5,30,1400,658,742,2011-5-30,-84
2011,5,31,1120,392,728,2011-5-31,-336
2011,6,1,616,266,350,2011-6-1,-84
2011,6,2,910,504,406,2011-6-2,98
2011,6,3,1008,364,644,2011-6-3,-280
2011,6,4,588,238,350,2011-6-4,-112
2011,6,5,322,140,182,2011-6-5,-42
2011,6,6,308,154,154,2011-6-6,0
2011,6,7,224,154,70,2011-6-7,84
2011,6,8,126,84,42,2011-6-8,42
2011,6,9,70,42,28,2011-6-9,14
2011,6,10,56,28,28,2011-6-10,0
2011,6,11,42,28,14,2011-6-11,14
2011,6,12,14,0,14,2011-6-12,-14
2011,6,13,14,0,14,2011-6-13,-14
2011,6,14,322,266,56,2011-6-14,210
2011,6,15,630,490,140,2011-6-15,350
2011,6,16,630,490,140,2011-6-16,350
2011,6,17,504,364,140,2011-6-17,224
2011,6,18,490,280,210,2011-6-18,70
2011,6,19,378,280,98,2011-6-19,182
2011,6,20,350,336,14,2011-6-20,322
2011,6,21,294,280,14,2011-6-21,266
2011,6,22,224,210,14,2011-6-22,196
2011,6,23,294,224,70,2011-6-23,154
2011,6,24,392,322,70,2011-6-24,252
2011,6,25,147,140,7,2011-6-25,133
2011,6,26,56,56,0,2011-6-26,56
2011,6,27,21,14,7,2011-6-27,7
2011,6,28,56,49,7,2011-6-28,42
2011,6,29,196,196,0,2011-6-29,196
2011,6,30,154,154,0,2011-6-30,154
2011,7,1,168,168,0,2011-7-1,168
2011,7,2,154,154,0,2011-7-2,154
2011,7,3,168,168,0,2011-7-3,168
2011,7,4,231,231,0,2011-7-4,231
2011,7,5,182,182,0,2011-7-5,182
2011,7,6,210,210,0,2011-7-6,210
2011,7,7,210,210,0,2011-7-7,210
2011,7,8,154,126,28,2011-7-8,98
2011,7,9,98,42,56,2011-7-9,-14
2011,7,10,126,14,112,2011-7-10,-98
2011,7,11,406,126,280,2011-7-11,-154
2011,7,12,420,154,266,2011-7-12,-112
2011,7,13,560,294,266,2011-7-13,28
2011,7,14,371,189,182,2011-7-14,7
2011,7,15,364,182,182,2011-7-15,0
2011,7,16,322,140,182,2011-7-16,-42
2011,7,17,392,224,168,2011-7-17,56
2011,7,18,560,406,154,2011-7-18,252
2011,7,19,924,672,252,2011-7-19,420
2011,7,20,434,238,196,2011-7-20,42
2011,7,21,406,266,140,2011-7-21,126
2011,7,22,252,140,112,2011-7-22,28
2011,7,23,224,140,84,2011-7-23,56
2011,7,24,56,42,14,2011-7-24,28
2011,7,25,49,42,7,2011-7-25,35
2011,7,26,448,448,0,2011-7-26,448
2011,7,27,532,532,0,2011-7-27,532
2011,7,28,1078,1064,14,2011-7-28,1050
2011,7,29,1764,1750,14,2011-7-29,1736
2011,7,30,1176,1162,14,2011-7-30,1148
2011,7,31,1582,1568,14,2011-7-31,1554
2011,8,1,1568,1568,0,2011-8-1,1568
2011,8,2,1757,1757,0,2011-8-2,1757
2011,8,3,1540,1540,0,2011-8-3,1540
2011,8,4,1932,1932,0,2011-8-4,1932
2011,8,5,1456,1442,14,2011-8-5,1428
2011,8,6,924,840,84,2011-8-6,756
2011,8,7,938,882,56,2011-8-7,826
2011,8,8,714,700,14,2011-8-8,686
2011,8,9,588,574,14,2011-8-9,560
2011,8,10,350,350,0,2011-8-10,350
2011,8,11,70,42,28,2011-8-11,14
2011,8,12,28,14,14,2011-8-12,0
2011,8,13,35,21,14,2011-8-13,7
2011,8,14,0,0,0,2011-8-14,0
2011,8,15,168,168,0,2011-8-15,168
2011,8,16,350,336,14,2011-8-16,322
2011,8,17,434,336,98,2011-8-17,238
2011,8,18,504,406,98,2011-8-18,308
2011,8,19,392,336,56,2011-8-19,280
2011,8,20,476,406,70,2011-8-20,336
2011,8,21,546,420,126,2011-8-21,294
2011,8,22,532,448,84,2011-8-22,364
2011,8,23,518,462,56,2011-8-23,406
2011,8,24,308,280,28,2011-8-24,252
2011,8,25,476,476,0,2011-8-25,476
2011,8,26,462,462,0,2011-8-26,462
2011,8,27,434,434,0,2011-8-27,434
2011,8,28,280,196,84,2011-8-28,112
2011,8,29,273,231,42,2011-8-29,189
2011,8,30,322,294,28,2011-8-30,266
2011,8,31,630,476,154,2011-8-31,322
2011,9,1,826,560,266,2011-9-1,294
2011,9,2,910,756,154,2011-9-2,602
2011,9,3,812,644,168,2011-9-3,476
2011,9,4,756,546,210,2011-9-4,336
2011,9,5,616,434,182,2011-9-5,252
2011,9,6,784,630,154,2011-9-6,476
2011,9,7,868,714,154,2011-9-7,560
2011,9,8,882,798,84,2011-9-8,714
2011,9,9,952,826,126,2011-9-9,700
2011,9,10,1092,924,168,2011-9-10,756
2011,9,11,1050,868,182,2011-9-11,686
2011,9,12,686,504,182,2011-9-12,322
2011,9,13,924,686,238,2011-9-13,448
2011,9,14,1246,840,406,2011-9-14,434
2011,9,15,1134,1008,126,2011-9-15,882
2011,9,16,1386,1218,168,2011-9-16,1050
2011,9,17,1274,1190,84,2011-9-17,1106
2011,9,18,1400,1246,154,2011-9-18,1092
2011,9,19,1022,938,84,2011-9-19,854
2011,9,20,840,784,56,2011-9-20,728
2011,9,21,938,910,28,2011-9-21,882
2011,9,22,1358,1344,14,2011-9-22,1330
2011,9,23,2128,2114,14,2011-9-23,2100
2011,9,24,2702,2660,42,2011-9-24,2618
2011,9,25,1960,1862,98,2011-9-25,1764
2011,9,26,1680,1596,84,2011-9-26,1512
2011,9,27,1554,1554,0,2011-9-27,1554
2011,9,28,1736,1736,0,2011-9-28,1736
2011,9,29,1288,1288,0,2011-9-29,1288
2011,9,30,1358,1358,0,2011-9-30,1358
2011,10,1,1330,1288,42,2011-10-1,1246
2011,10,2,1064,1022,42,2011-10-2,980
2011,10,3,1043,1029,14,2011-10-3,1015
2011,10,4,1337,1176,161,2011-10-4,1015
2011,10,5,1225,910,315,2011-10-5,595
2011,10,6,1232,854,378,2011-10-6,476
2011,10,7,1106,826,280,2011-10-7,546
2011,10,8,630,378,252,2011-10-8,126
2011,10,9,840,644,196,2011-10-9,448
2011,10,10,910,728,182,2011-10-10,546
2011,10,11,1176,756,420,2011-10-11,336
2011,10,12,1456,938,518,2011-10-12,420
2011,10,13,1680,980,700,2011-10-13,280
2011,10,14,1750,1036,714,2011-10-14,322
2011,10,15,1806,1092,714,2011-10-15,378
2011,10,16,1736,1092,644,2011-10-16,448
2011,10,17,1638,1218,420,2011-10-17,798
2011,10,18,1316,966,350,2011-10-18,616
2011,10,19,1722,1428,294,2011-10-19,1134
2011,10,20,1862,1666,196,2011-10-20,1470
2011,10,21,1918,1582,336,2011-10-21,1246
2011,10,22,1414,1148,266,2011-10-22,882
2011,10,23,952,770,182,2011-10-23,588
2011,10,24,1554,1274,280,2011-10-24,994
2011,10,25,1204,1092,112,2011-10-25,980
2011,10,26,924,840,84,2011-10-26,756
2011,10,27,980,896,84,2011-10-27,812
2011,10,28,868,868,0,2011-10-28,868
2011,10,29,742,742,0,2011-10-29,742
2011,10,30,700,700,0,2011-10-30,700
2011,10,31,840,840,0,2011-10-31,840
2011,11,1,1218,1050,168,2011-11-1,882
2011,11,2,1610,1288,322,2011-11-2,966
2011,11,3,2779,2254,525,2011-11-3,1729
2011,11,4,2604,2268,336,2011-11-4,1932
2011,11,5,2548,2128,420,2011-11-5,1708
2011,11,6,2646,2198,448,2011-11-6,1750
2011,11,7,2940,2478,462,2011-11-7,2016
2011,11,8,2142,1778,364,2011-11-8,1414
2011,11,9,2942.8,2326.8,616,2011-11-9,1710.8
2011,11,10,2674,2086,588,2011-11-10,1498
2011,11,11,1736,1260,476,2011-11-11,784
2011,11,12,2184,1414,770,2011-11-12,644
2011,11,13,1722,1036,686,2011-11-13,350
2011,11,14,1260,882,378,2011-11-14,504
2011,11,15,1176,896,280,2011-11-15,616
2011,11,16,1260,770,490,2011-11-16,280
2011,11,17,980,518,462,2011-11-17,56
2011,11,18,980,322,658,2011-11-18,-336
2011,11,19,966,406,560,2011-11-19,-154
2011,11,20,868,336,532,2011-11-20,-196
2011,11,21,1092,812,280,2011-11-21,532
2011,11,22,1022,798,224,2011-11-22,574
2011,11,23,938,756,182,2011-11-23,574
2011,11,24,1050,896,154,2011-11-24,742
2011,11,25,980,903,77,2011-11-25,826
2011,11,26,826,770,56,2011-11-26,714
2011,11,27,882,826,56,2011-11-27,770
2011,11,28,490,490,0,2011-11-28,490
2011,11,29,714,658,56,2011-11-29,602
2011,11,30,868,714,154,2011-11-30,560
2011,12,1,756,588,168,2011-12-1,420
2011,12,2,882,532,350,2011-12-2,182
2011,12,3,1218,756,462,2011-12-3,294
2011,12,4,1344,742,602,2011-12-4,140
2011,12,5,1645,728,917,2011-12-5,-189
2011,12,6,882,378,504,2011-12-6,-126
2011,12,7,1050,462,588,2011-12-7,-126
2011,12,8,1008,350,658,2011-12-8,-308
2011,12,9,1232,588,644,2011-12-9,-56
2011,12,10,868,308,560,2011-12-10,-252
2011,12,11,1022,364,658,2011-12-11,-294
2011,12,12,392,182,210,2011-12-12,-28
2011,12,13,392,168,224,2011-12-13,-56
2011,12,14,392,224,168,2011-12-14,56
2011,12,15,392,168,224,2011-12-15,-56
2011,12,16,350,154,196,2011-12-16,-42
2011,12,17,350,112,238,2011-12-17,-126
2011,12,18,378,112,266,2011-12-18,-154
2011,12,19,560,140,420,2011-12-19,-280
2011,12,20,658,252,406,2011-12-20,-154
2011,12,21,742,448,294,2011-12-21,154
2011,12,22,1386,1064,322,2011-12-22,742
2011,12,23,1456,1176,280,2011-12-23,896
2011,12,24,1134,700,434,2011-12-24,266
2011,12,25,826,476,350,2011-12-25,126
2011,12,26,1134,476,658,2011-12-26,-182
2011,12,27,1442,490,952,2011-12-27,-462
2011,12,28,1589,511,1078,2011-12-28,-567
2011,12,29,1435,497,938,2011-12-29,-441
2011,12,30,1414,490,924,2011-12-30,-434
2011,12,31,1106,364,742,2011-12-31,-378
2012,1,1,784,0,784,2012-1-1,-784
2012,1,2,798,182,616,2012-1-2,-434
2012,1,3,910,392,518,2012-1-3,-126
2012,1,4,1344,826,518,2012-1-4,308
2012,1,5,1246,896,350,2012-1-5,546
2012,1,6,1400,994,406,2012-1-6,588
2012,1,7,1106,742,364,2012-1-7,378
2012,1,8,1260,966,294,2012-1-8,672
2012,1,9,1652,1358,294,2012-1-9,1064
2012,1,10,1372,1372,0,2012-1-10,1372
2012,1,11,1288,1288,0,2012-1-11,1288
2012,1,12,364,364,0,2012-1-12,364
2012,1,13,399,343,56,2012-1-13,287
2012,1,14,714,616,98,2012-1-14,518
2012,1,15,931,854,77,2012-1-15,777
2012,1,16,1498,1470,28,2012-1-16,1442
2012,1,17,1778,1694,84,2012-1-17,1610
2012,1,18,1582,1484,98,2012-1-18,1386
2012,1,19,1596,1526,70,2012-1-19,1456
2012,1,20,1078,1078,0,2012-1-20,1078
2012,1,21,1302,1302,0,2012-1-21,1302
2012,1,22,1106,1106,0,2012-1-22,1106
2012,1,23,1036,1036,0,2012-1-23,1036
2012,1,24,1232,1232,0,2012-1-24,1232
2012,1,25,490,490,0,2012-1-25,490
2012,1,26,714,714,0,2012-1-26,714
2012,1,27,406,406,0,2012-1-27,406
2012,1,28,294,294,0,2012-1-28,294
2012,1,29,406,378,28,2012-1-29,350
2012,1,30,462,434,28,2012-1-30,406
2012,1,31,476,434,42,2012-1-31,392
2012,2,1,588,574,14,2012-2-1,560
2012,2,2,490,476,14,2012-2-2,462
2012,2,3,392,392,0,2012-2-3,392
2012,2,4,378,364,14,2012-2-4,350
2012,2,5,238,224,14,2012-2-5,210
2012,2,6,294,294,0,2012-2-6,294
2012,2,7,294,294,0,2012-2-7,294
2012,2,8,126,126,0,2012-2-8,126
2012,2,9,210,84,126,2012-2-9,-42
2012,2,10,168,28,140,2012-2-10,-112
2012,2,11,588,28,560,2012-2-11,-532
2012,2,12,770,224,546,2012-2-12,-322
2012,2,13,630,238,392,2012-2-13,-154
2012,2,14,588,224,364,2012-2-14,-140
2012,2,15,434,168,266,2012-2-15,-98
2012,2,16,420,196,224,2012-2-16,-28
2012,2,17,350,182,168,2012-2-17,14
2012,2,18,210,168,42,2012-2-18,126
2012,2,19,252,224,28,2012-2-19,196
2012,2,20,490,490,0,2012-2-20,490
2012,2,21,560,560,0,2012-2-21,560
2012,2,22,378,378,0,2012-2-22,378
2012,2,23,392,392,0,2012-2-23,392
2012,2,24,420,420,0,2012-2-24,420
2012,2,25,420,420,0,2012-2-25,420
2012,2,26,406,406,0,2012-2-26,406
2012,2,27,182,182,0,2012-2-27,182
2012,2,28,182,182,0,2012-2-28,182
2012,2,29,182,182,0,2012-2-29,182
2012,3,1,154,154,0,2012-3-1,154
2012,3,2,140,140,0,2012-3-2,140
2012,3,3,602,546,56,2012-3-3,490
2012,3,4,1218,1120,98,2012-3-4,1022
2012,3,5,1736,1372,364,2012-3-5,1008
2012,3,6,2156,1764,392,2012-3-6,1372
2012,3,7,2520,2058,462,2012-3-7,1596
2012,3,8,1862,1582,280,2012-3-8,1302
2012,3,9,1736,1554,182,2012-3-9,1372
2012,3,10,1568,1484,84,2012-3-10,1400
2012,3,11,1764,1596,168,2012-3-11,1428
2012,3,12,910,798,112,2012-3-12,686
2012,3,13,910,840,70,2012-3-13,770
2012,3,14,742,686,56,2012-3-14,630
2012,3,15,518,434,84,2012-3-15,350
2012,3,16,336,252,84,2012-3-16,168
2012,3,17,294,126,168,2012-3-17,-42
2012,3,18,364,84,280,2012-3-18,-196
2012,3,19,448,112,336,2012-3-19,-224
2012,3,20,560,98,462,2012-3-20,-364
2012,3,21,336,28,308,2012-3-21,-280
2012,3,22,182,42,140,2012-3-22,-98
2012,3,23,252,28,224,2012-3-23,-196
2012,3,24,280,84,196,2012-3-24,-112
2012,3,25,546,98,448,2012-3-25,-350
2012,3,26,420,98,322,2012-3-26,-224
2012,3,27,462,70,392,2012-3-27,-322
2012,3,28,434,98,336,2012-3-28,-238
2012,3,29,518,84,434,2012-3-29,-350
2012,3,30,490,112,378,2012-3-30,-266
2012,3,31,406,168,238,2012-3-31,-70
2012,4,1,280,56,224,2012-4-1,-168
2012,4,2,350,98,252,2012-4-2,-154
2012,4,3,308,126,182,2012-4-3,-56
2012,4,4,308,168,140,2012-4-4,28
2012,4,5,224,224,0,2012-4-5,224
2012,4,6,294,294,0,2012-4-6,294
2012,4,7,154,154,0,2012-4-7,154
2012,4,8,182,182,0,2012-4-8,182
2012,4,9,182,182,0,2012-4-9,182
2012,4,10,21,7,14,2012-4-10,-7
2012,4,11,70,42,28,2012-4-11,14
2012,4,12,140,98,42,2012-4-12,56
2012,4,13,210,196,14,2012-4-13,182
2012,4,14,308,266,42,2012-4-14,224
2012,4,15,378,266,112,2012-4-15,154
2012,4,16,700,336,364,2012-4-16,-28
2012,4,17,420,168,252,2012-4-17,-84
2012,4,18,826,364,462,2012-4-18,-98
2012,4,19,728,308,420,2012-4-19,-112
2012,4,20,2226,658,1568,2012-4-20,-910
2012,4,21,2282,700,1582,2012-4-21,-882
2012,4,22,2086,504,1582,2012-4-22,-1078
2012,4,23,2212,616,1596,2012-4-23,-980
2012,4,24,1876,560,1316,2012-4-24,-756
2012,4,25,1288,574,714,2012-4-25,-140
2012,4,26,756,350,406,2012-4-26,-56
2012,4,27,672,308,364,2012-4-27,-56
2012,4,28,798,266,532,2012-4-28,-266
2012,4,29,924,238,686,2012-4-29,-448
2012,4,30,994,280,714,2012-4-30,-434
2012,5,1,854,154,700,2012-5-1,-546
2012,5,2,840,28,812,2012-5-2,-784
2012,5,3,756,84,672,2012-5-3,-588
2012,5,4,714,56,658,2012-5-4,-602
2012,5,5,854,532,322,2012-5-5,210
2012,5,6,1477,1085,392,2012-5-6,693
2012,5,7,1470,1134,336,2012-5-7,798
2012,5,8,1624,1330,294,2012-5-8,1036
2012,5,9,1848,1484,364,2012-5-9,1120
2012,5,10,1848,1456,392,2012-5-10,1064
2012,5,11,1792,1582,210,2012-5-11,1372
2012,5,12,1666,1526,140,2012-5-12,1386
2012,5,13,1554,1330,224,2012-5-13,1106
2012,5,14,1190,994,196,2012-5-14,798
2012,5,15,770,546,224,2012-5-15,322
2012,5,16,882,742,140,2012-5-16,602
2012,5,17,1008,868,140,2012-5-17,728
2012,5,18,1078,966,112,2012-5-18,854
2012,5,19,1176,1064,112,2012-5-19,952
2012,5,20,1232,1036,196,2012-5-20,840
2012,5,21,1176,1050,126,2012-5-21,924
2012,5,22,1092,1078,14,2012-5-22,1064
2012,5,23,910,868,42,2012-5-23,826
2012,5,24,434,378,56,2012-5-24,322
2012,5,25,742,560,182,2012-5-25,378
2012,5,26,574,294,280,2012-5-26,14
2012,5,27,560,182,378,2012-5-27,-196
2012,5,28,672,182,490,2012-5-28,-308
2012,5,29,644,196,448,2012-5-29,-252
2012,5,30,560,140,420,2012-5-30,-280
2012,5,31,462,56,406,2012-5-31,-350
2012,6,1,1176,532,644,2012-6-1,-112
2012,6,2,882,420,462,2012-6-2,-42
2012,6,3,826,406,420,2012-6-3,-14
2012,6,4,826,420,406,2012-6-4,14
2012,6,5,938,462,476,2012-6-5,-14
2012,6,6,812,266,546,2012-6-6,-280
2012,6,7,672,266,406,2012-6-7,-140
2012,6,8,420,154,266,2012-6-8,-112
2012,6,9,532,168,364,2012-6-9,-196
2012,6,10,770,238,532,2012-6-10,-294
2012,6,11,406,84,322,2012-6-11,-238
2012,6,12,938,154,784,2012-6-12,-630
2012,6,13,1162,112,1050,2012-6-13,-938
2012,6,14,1176,98,1078,2012-6-14,-980
2012,6,15,1302,42,1260,2012-6-15,-1218
2012,6,16,1498,42,1456,2012-6-16,-1414
2012,6,17,1369.2,14,1355.2,2012-6-17,-1341.2
2012,6,18,1148,14,1134,2012-6-18,-1120
2012,6,19,952,14,938,2012-6-19,-924
2012,6,20,728,0,728,2012-6-20,-728
2012,6,21,294,0,294,2012-6-21,-294
2012,6,22,42,42,0,2012-6-22,42
2012,6,23,42,42,0,2012-6-23,42
2012,6,24,42,28,14,2012-6-24,14
2012,6,25,84,0,84,2012-6-25,-84
2012,6,26,224,42,182,2012-6-26,-140
2012,6,27,798,112,686,2012-6-27,-574
2012,6,28,742,126,616,2012-6-28,-490
2012,6,29,1106,182,924,2012-6-29,-742
2012,6,30,1134,252,882,2012-6-30,-630
2012,7,1,1848,462,1386,2012-7-1,-924
2012,7,2,1582,532,1050,2012-7-2,-518
2012,7,3,1400,434,966,2012-7-3,-532
2012,7,4,1386,336,1050,2012-7-4,-714
2012,7,5,1470,364,1106,2012-7-5,-742
2012,7,6,1736,364,1372,2012-7-6,-1008
2012,7,7,2226,322,1904,2012-7-7,-1582
2012,7,8,2674,294,2380,2012-7-8,-2086
2012,7,9,2604,14,2590,2012-7-9,-2576
2012,7,10,2296,28,2268,2012-7-10,-2240
2012,7,11,2114,0,2114,2012-7-11,-2114
2012,7,12,2450,28,2422,2012-7-12,-2394
2012,7,13,1778,28,1750,2012-7-13,-1722
2012,7,14,1946,28,1918,2012-7-14,-1890
2012,7,15,2016,56,1960,2012-7-15,-1904
2012,7,16,1176,84,1092,2012-7-16,-1008
2012,7,17,1288,84,1204,2012-7-17,-1120
2012,7,18,672,0,672,2012-7-18,-672
2012,7,19,196,0,196,2012-7-19,-196
2012,7,20,154,0,154,2012-7-20,-154
2012,7,21,84,0,84,2012-7-21,-84
2012,7,22,98,0,98,2012-7-22,-98
2012,7,23,252,98,154,2012-7-23,-56
2012,7,24,378,112,266,2012-7-24,-154
2012,7,25,434,112,322,2012-7-25,-210
2012,7,26,504,84,420,2012-7-26,-336
2012,7,27,518,56,462,2012-7-27,-406
2012,7,28,1092,84,1008,2012-7-28,-924
2012,7,29,1134,56,1078,2012-7-29,-1022
2012,7,30,1134,196,938,2012-7-30,-742
2012,7,31,1106,210,896,2012-7-31,-686
2012,8,1,1260,280,980,2012-8-1,-700
2012,8,2,1246,266,980,2012-8-2,-714
2012,8,3,1148,210,938,2012-8-3,-728
2012,8,4,1232,210,1022,2012-8-4,-812
2012,8,5,1022,182,840,2012-8-5,-658
2012,8,6,742,168,574,2012-8-6,-406
2012,8,7,1050,336,714,2012-8-7,-378
2012,8,8,966,448,518,2012-8-8,-70
2012,8,9,1246,518,728,2012-8-9,-210
2012,8,10,1106,504,602,2012-8-10,-98
2012,8,11,798,364,434,2012-8-11,-70
2012,8,12,546,322,224,2012-8-12,98
2012,8,13,518,350,168,2012-8-13,182
2012,8,14,420,350,70,2012-8-14,280
2012,8,15,434,420,14,2012-8-15,406
2012,8,16,574,574,0,2012-8-16,574
2012,8,17,560,560,0,2012-8-17,560
2012,8,18,672,672,0,2012-8-18,672
2012,8,19,490,462,28,2012-8-19,434
2012,8,20,126,112,14,2012-8-20,98
2012,8,21,196,126,70,2012-8-21,56
2012,8,22,154,98,56,2012-8-22,42
2012,8,23,322,70,252,2012-8-23,-182
2012,8,24,280,126,154,2012-8-24,-28
2012,8,25,728,476,252,2012-8-25,224
2012,8,26,826,644,182,2012-8-26,462
2012,8,27,812,630,182,2012-8-27,448
2012,8,28,476,322,154,2012-8-28,168
2012,8,29,504,322,182,2012-8-29,140
2012,8,30,518,252,266,2012-8-30,-14
2012,8,31,1022,532,490,2012-8-31,42
2012,9,1,1036,532,504,2012-9-1,28
2012,9,2,896,364,532,2012-9-2,-168
2012,9,3,1204,644,560,2012-9-3,84
2012,9,4,826,504,322,2012-9-4,182
2012,9,5,938,462,476,2012-9-5,-14
2012,9,6,770,378,392,2012-9-6,-14
2012,9,7,896,140,756,2012-9-7,-616
2012,9,8,658,154,504,2012-9-8,-350
2012,9,9,588,154,434,2012-9-9,-280
2012,9,10,350,98,252,2012-9-10,-154
2012,9,11,546,98,448,2012-9-11,-350
2012,9,12,532,56,476,2012-9-12,-420
2012,9,13,546,70,476,2012-9-13,-406
2012,9,14,378,42,336,2012-9-14,-294
2012,9,15,420,28,392,2012-9-15,-364
2012,9,16,336,42,294,2012-9-16,-252
2012,9,17,308,0,308,2012-9-17,-308
2012,9,18,462,210,252,2012-9-18,-42
2012,9,19,518,308,210,2012-9-19,98
2012,9,20,854,392,462,2012-9-20,-70
2012,9,21,588,350,238,2012-9-21,112
2012,9,22,546,476,70,2012-9-22,406
2012,9,23,574,504,70,2012-9-23,434
2012,9,24,658,434,224,2012-9-24,210
2012,9,25,784,490,294,2012-9-25,196
2012,9,26,994,476,518,2012-9-26,-42
2012,9,27,840,245,595,2012-9-27,-350
2012,9,28,826,154,672,2012-9-28,-518
2012,9,29,1162,392,770,2012-9-29,-378
2012,9,30,1162,406,756,2012-9-30,-350
2012,10,1,812,84,728,2012-10-1,-644
2012,10,2,826,56,770,2012-10-2,-714
2012,10,3,994,0,994,2012-10-3,-994
2012,10,4,896,0,896,2012-10-4,-896
2012,10,5,784,0,784,2012-10-5,-784
2012,10,6,728,0,728,2012-10-6,-728
2012,10,7,672,0,672,2012-10-7,-672
2012,10,8,644,0,644,2012-10-8,-644
2012,10,9,574,168,406,2012-10-9,-238
2012,10,10,560,294,266,2012-10-10,28
2012,10,11,700,406,294,2012-10-11,112
2012,10,12,938,672,266,2012-10-12,406
2012,10,13,854,644,210,2012-10-13,434
2012,10,14,826,672,154,2012-10-14,518
2012,10,15,770,602,168,2012-10-15,434
2012,10,16,686,476,210,2012-10-16,266
2012,10,17,546,364,182,2012-10-17,182
2012,10,18,896,728,168,2012-10-18,560
2012,10,19,966,770,196,2012-10-19,574
2012,10,20,1218,770,448,2012-10-20,322
2012,10,21,1302,868,434,2012-10-21,434
2012,10,22,1120,602,518,2012-10-22,84
2012,10,23,1274,602,672,2012-10-23,-70
2012,10,24,1232,588,644,2012-10-24,-56
2012,10,25,980,322,658,2012-10-25,-336
2012,10,26,1022,378,644,2012-10-26,-266
2012,10,27,882,266,616,2012-10-27,-350
2012,10,28,644,224,420,2012-10-28,-196
2012,10,29,630,182,448,2012-10-29,-266
2012,10,30,560,84,476,2012-10-30,-392
2012,10,31,518,0,518,2012-10-31,-518
2012,11,1,490,14,476,2012-11-1,-462
2012,11,2,448,0,448,2012-11-2,-448
2012,11,3,154,14,140,2012-11-3,-126
2012,11,4,182,14,168,2012-11-4,-154
2012,11,5,56,28,28,2012-11-5,0
2012,11,6,182,98,84,2012-11-6,14
2012,11,7,392,140,252,2012-11-7,-112
2012,11,8,574,504,70,2012-11-8,434
2012,11,9,574,518,56,2012-11-9,462
2012,11,10,490,336,154,2012-11-10,182
2012,11,11,868,546,322,2012-11-11,224
2012,11,12,2240,1218,1022,2012-11-12,196
2012,11,13,1190,672,518,2012-11-13,154
2012,11,14,1302,840,462,2012-11-14,378
2012,11,15,1274,854,420,2012-11-15,434
2012,11,16,1120,742,378,2012-11-16,364
2012,11,17,1120,742,378,2012-11-17,364
2012,11,18,784,644,140,2012-11-18,504
2012,11,19,938,826,112,2012-11-19,714
2012,11,20,784,658,126,2012-11-20,532
2012,11,21,728,644,84,2012-11-21,560
2012,11,22,910,742,168,2012-11-22,574
2012,11,23,1050,924,126,2012-11-23,798
2012,11,24,756,728,28,2012-11-24,700
2012,11,25,588,518,70,2012-11-25,448
2012,11,26,882,532,350,2012-11-26,182
2012,11,27,1022,658,364,2012-11-27,294
2012,11,28,1246,658,588,2012-11-28,70
2012,11,29,1498,1008,490,2012-11-29,518
2012,11,30,924,672,252,2012-11-30,420
2012,12,1,616,616,0,2012-12-1,616
2012,12,2,378,378,0,2012-12-2,378
2012,12,3,392,392,0,2012-12-3,392
2012,12,4,392,392,0,2012-12-4,392
2012,12,5,308,301,7,2012-12-5,294
2012,12,6,182,182,0,2012-12-6,182
2012,12,7,182,182,0,2012-12-7,182
2012,12,8,112,112,0,2012-12-8,112
2012,12,9,182,182,0,2012-12-9,182
2012,12,10,196,196,0,2012-12-10,196
2012,12,11,294,294,0,2012-12-11,294
2012,12,12,266,266,0,2012-12-12,266
2012,12,13,364,364,0,2012-12-13,364
2012,12,14,406,406,0,2012-12-14,406
2012,12,15,910,406,504,2012-12-15,-98
2012,12,16,798,308,490,2012-12-16,-182
2012,12,17,952,378,574,2012-12-17,-196
2012,12,18,840,280,560,2012-12-18,-280
2012,12,19,602,154,448,2012-12-19,-294
2012,12,20,798,350,448,2012-12-20,-98
2012,12,21,798,350,448,2012-12-21,-98
2012,12,22,602,280,322,2012-12-22,-42
2012,12,23,630,280,350,2012-12-23,-70
2012,12,24,462,294,168,2012-12-24,126
2012,12,25,448,392,56,2012-12-25,336
2012,12,26,294,252,42,2012-12-26,210
2012,12,27,378,308,70,2012-12-27,238
2012,12,28,420,294,126,2012-12-28,168
2012,12,29,336,238,98,2012-12-29,140
2012,12,30,308,266,42,2012-12-30,224
2012,12,31,420,336,84,2012-12-31,252
2013,1,1,672,532,140,2013-1-1,392
2013,1,2,854,644,210,2013-1-2,434
2013,1,3,896,742,154,2013-1-3,588
2013,1,4,1162,798,364,2013-1-4,434
2013,1,5,1442,910,532,2013-1-5,378
2013,1,6,1596,1022,574,2013-1-6,448
2013,1,7,1946,1218,728,2013-1-7,490
2013,1,8,1316,882,434,2013-1-8,448
2013,1,9,1204,840,364,2013-1-9,476
2013,1,10,1820,1442,378,2013-1-10,1064
2013,1,11,2310,1890,420,2013-1-11,1470
2013,1,12,2044,1708,336,2013-1-12,1372
2013,1,13,1974,1666,308,2013-1-13,1358
2013,1,14,1764,1526,238,2013-1-14,1288
2013,1,15,1792,1568,224,2013-1-15,1344
2013,1,16,1092,966,126,2013-1-16,840
2013,1,17,910,812,98,2013-1-17,714
2013,1,18,784,658,126,2013-1-18,532
2013,1,19,672,574,98,2013-1-19,476
2013,1,20,574,490,84,2013-1-20,406
2013,1,21,252,154,98,2013-1-21,56
2013,1,22,378,294,84,2013-1-22,210
2013,1,23,476,392,84,2013-1-23,308
2013,1,24,448,364,84,2013-1-24,280
2013,1,25,420,420,0,2013-1-25,420
2013,1,26,266,252,14,2013-1-26,238
2013,1,27,210,154,56,2013-1-27,98
2013,1,28,210,98,112,2013-1-28,-14
2013,1,29,602,420,182,2013-1-29,238
2013,1,30,448,322,126,2013-1-30,196
2013,1,31,364,280,84,2013-1-31,196
2013,2,1,364,294,70,2013-2-1,224
2013,2,2,490,448,42,2013-2-2,406
2013,2,3,560,560,0,2013-2-3,560
2013,2,4,364,364,0,2013-2-4,364
2013,2,5,294,294,0,2013-2-5,294
2013,2,6,322,322,0,2013-2-6,322
2013,2,7,378,378,0,2013-2-7,378
2013,2,8,392,392,0,2013-2-8,392
2013,2,9,420,420,0,2013-2-9,420
2013,2,10,392,392,0,2013-2-10,392
2013,2,11,518,504,14,2013-2-11,490
2013,2,12,476,462,14,2013-2-12,448
2013,2,13,294,294,0,2013-2-13,294
2013,2,14,280,280,0,2013-2-14,280
2013,2,15,308,238,70,2013-2-15,168
2013,2,16,336,140,196,2013-2-16,-56
2013,2,17,350,196,154,2013-2-17,42
2013,2,18,560,350,210,2013-2-18,140
2013,2,19,644,420,224,2013-2-19,196
2013,2,20,910,700,210,2013-2-20,490
2013,2,21,924,840,84,2013-2-21,756
2013,2,22,742,672,70,2013-2-22,602
2013,2,23,616,546,70,2013-2-23,476
2013,2,24,84,56,28,2013-2-24,28
2013,2,25,154,42,112,2013-2-25,-70
2013,2,26,350,56,294,2013-2-26,-238
2013,2,27,350,56,294,2013-2-27,-238
2013,2,28,518,28,490,2013-2-28,-462
2013,3,1,644,28,616,2013-3-1,-588
2013,3,2,714,28,686,2013-3-2,-658
2013,3,3,728,70,658,2013-3-3,-588
2013,3,4,406,14,392,2013-3-4,-378
2013,3,5,420,14,406,2013-3-5,-392
2013,3,6,546,112,434,2013-3-6,-322
2013,3,7,448,56,392,2013-3-7,-336
2013,3,8,224,70,154,2013-3-8,-84
2013,3,9,602,448,154,2013-3-9,294
2013,3,10,686,490,196,2013-3-10,294
2013,3,11,770,588,182,2013-3-11,406
2013,3,12,854,714,140,2013-3-12,574
2013,3,13,882,840,42,2013-3-13,798
2013,3,14,1036,966,70,2013-3-14,896
2013,3,15,910,798,112,2013-3-15,686
2013,3,16,1246,1036,210,2013-3-16,826
2013,3,17,1372,1036,336,2013-3-17,700
2013,3,18,1302,854,448,2013-3-18,406
2013,3,19,882,798,84,2013-3-19,714
2013,3,20,728,686,42,2013-3-20,644
2013,3,21,644,644,0,2013-3-21,644
2013,3,22,294,238,56,2013-3-22,182
2013,3,23,350,238,112,2013-3-23,126
2013,3,24,252,196,56,2013-3-24,140
2013,3,25,238,154,84,2013-3-25,70
2013,3,26,196,154,42,2013-3-26,112
2013,3,27,140,112,28,2013-3-27,84
2013,3,28,238,196,42,2013-3-28,154
2013,3,29,392,252,140,2013-3-29,112
2013,3,30,672,224,448,2013-3-30,-224
2013,3,31,882,182,700,2013-3-31,-518
2013,4,1,910,182,728,2013-4-1,-546
2013,4,2,980,308,672,2013-4-2,-364
2013,4,3,1204,238,966,2013-4-3,-728
2013,4,4,1148,252,896,2013-4-4,-644
2013,4,5,1204,364,840,2013-4-5,-476
2013,4,6,1232,602,630,2013-4-6,-28
2013,4,7,1274,686,588,2013-4-7,98
2013,4,8,1596,1008,588,2013-4-8,420
2013,4,9,1344,826,518,2013-4-9,308
2013,4,10,1512,938,574,2013-4-10,364
2013,4,11,1344,798,546,2013-4-11,252
2013,4,12,1708,1218,490,2013-4-12,728
2013,4,13,1106,742,364,2013-4-13,378
2013,4,14,994,532,462,2013-4-14,70
2013,4,15,826,252,574,2013-4-15,-322
2013,4,16,644,84,560,2013-4-16,-476
2013,4,17,700,70,630,2013-4-17,-560
2013,4,18,630,70,560,2013-4-18,-490
2013,4,19,420,112,308,2013-4-19,-196
2013,4,20,476,336,140,2013-4-20,196
2013,4,21,504,448,56,2013-4-21,392
2013,4,22,910,868,42,2013-4-22,826
2013,4,23,994,924,70,2013-4-23,854
2013,4,24,1330,1302,28,2013-4-24,1274
2013,4,25,2030,1890,140,2013-4-25,1750
2013,4,26,1526,1358,168,2013-4-26,1190
2013,4,27,910,630,280,2013-4-27,350
2013,4,28,896,616,280,2013-4-28,336
2013,4,29,1204,518,686,2013-4-29,-168
2013,4,30,1932,560,1372,2013-4-30,-812
2013,5,1,1708,504,1204,2013-5-1,-700
2013,5,2,1554,462,1092,2013-5-2,-630
2013,5,3,1624,490,1134,2013-5-3,-644
2013,5,4,1512,322,1190,2013-5-4,-868
2013,5,5,1120,434,686,2013-5-5,-252
2013,5,6,938,238,700,2013-5-6,-462
2013,5,7,938,252,686,2013-5-7,-434
2013,5,8,1036,252,784,2013-5-8,-532
2013,5,9,1323,308,1015,2013-5-9,-707
2013,5,10,1246,448,798,2013-5-10,-350
2013,5,11,1470,658,812,2013-5-11,-154
2013,5,12,1792,1344,448,2013-5-12,896
2013,5,13,1932,1540,392,2013-5-13,1148
2013,5,14,1680,1274,406,2013-5-14,868
2013,5,15,1652,1134,518,2013-5-15,616
2013,5,16,1806,1190,616,2013-5-16,574
2013,5,17,1386,938,448,2013-5-17,490
2013,5,18,980,630,350,2013-5-18,280
2013,5,19,826,476,350,2013-5-19,126
2013,5,20,826,518,308,2013-5-20,210
2013,5,21,938,588,350,2013-5-21,238
2013,5,22,1092,602,490,2013-5-22,112
2013,5,23,994,476,518,2013-5-23,-42
2013,5,24,798,364,434,2013-5-24,-70
2013,5,25,952,336,616,2013-5-25,-280
2013,5,26,770,252,518,2013-5-26,-266
2013,5,27,602,154,448,2013-5-27,-294
2013,5,28,448,98,350,2013-5-28,-252
2013,5,29,322,56,266,2013-5-29,-210
2013,5,30,196,28,168,2013-5-30,-140
2013,5,31,168,28,140,2013-5-31,-112
2013,6,1,182,28,154,2013-6-1,-126
2013,6,2,406,70,336,2013-6-2,-266
2013,6,3,644,182,462,2013-6-3,-280
2013,6,4,546,140,406,2013-6-4,-266
2013,6,5,952,182,770,2013-6-5,-588
2013,6,6,714,266,448,2013-6-6,-182
2013,6,7,644,364,280,2013-6-7,84
2013,6,8,280,280,0,2013-6-8,280
2013,6,9,308,294,14,2013-6-9,280
2013,6,10,168,168,0,2013-6-10,168
2013,6,11,70,70,0,2013-6-11,70
2013,6,12,112,42,70,2013-6-12,-28
2013,6,13,182,0,182,2013-6-13,-182
2013,6,14,574,0,574,2013-6-14,-574
2013,6,15,714,42,672,2013-6-15,-630
2013,6,16,686,56,630,2013-6-16,-574
2013,6,17,1386,126,1260,2013-6-17,-1134
2013,6,18,1078,140,938,2013-6-18,-798
2013,6,19,952,196,756,2013-6-19,-560
2013,6,20,924,210,714,2013-6-20,-504
2013,6,21,1190,280,910,2013-6-21,-630
2013,6,22,1680,378,1302,2013-6-22,-924
2013,6,23,1120,238,882,2013-6-23,-644
2013,6,24,1036,182,854,2013-6-24,-672
2013,6,25,560,56,504,2013-6-25,-448
2013,6,26,448,14,434,2013-6-26,-420
2013,6,27,476,14,462,2013-6-27,-448
2013,6,28,322,28,294,2013-6-28,-266
2013,6,29,322,56,266,2013-6-29,-210
2013,6,30,392,140,252,2013-6-30,-112
2013,7,1,602,210,392,2013-7-1,-182
2013,7,2,868,168,700,2013-7-2,-532
2013,7,3,980,42,938,2013-7-3,-896
2013,7,4,1218,14,1204,2013-7-4,-1190
2013,7,5,1358,0,1358,2013-7-5,-1358
2013,7,6,1218,0,1218,2013-7-6,-1218
2013,7,7,1190,0,1190,2013-7-7,-1190
2013,7,8,1106,0,1106,2013-7-8,-1106
2013,7,9,1008,0,1008,2013-7-9,-1008
2013,7,10,616,0,616,2013-7-10,-616
2013,7,11,490,0,490,2013-7-11,-490
2013,7,12,322,14,308,2013-7-12,-294
2013,7,13,364,14,350,2013-7-13,-336
2013,7,14,434,238,196,2013-7-14,42
2013,7,15,504,350,154,2013-7-15,196
2013,7,16,742,588,154,2013-7-16,434
2013,7,17,602,434,168,2013-7-17,266
2013,7,18,616,434,182,2013-7-18,252
2013,7,19,462,392,70,2013-7-19,322
2013,7,20,364,322,42,2013-7-20,280
2013,7,21,448,336,112,2013-7-21,224
2013,7,22,336,238,98,2013-7-22,140
2013,7,23,350,252,98,2013-7-23,154
2013,7,24,448,266,182,2013-7-24,84
2013,7,25,476,238,238,2013-7-25,0
2013,7,26,462,210,252,2013-7-26,-42
2013,7,27,476,126,350,2013-7-27,-224
2013,7,28,658,126,532,2013-7-28,-406
2013,7,29,700,168,532,2013-7-29,-364
2013,7,30,686,350,336,2013-7-30,14
2013,7,31,630,350,280,2013-7-31,70
2013,8,1,532,434,98,2013-8-1,336
2013,8,2,630,434,196,2013-8-2,238
2013,8,3,546,336,210,2013-8-3,126
2013,8,4,462,280,182,2013-8-4,98
2013,8,5,280,168,112,2013-8-5,56
2013,8,6,252,140,112,2013-8-6,28
2013,8,7,266,140,126,2013-8-7,14
2013,8,8,266,112,154,2013-8-8,-42
2013,8,9,182,42,140,2013-8-9,-98
2013,8,10,154,28,126,2013-8-10,-98
2013,8,11,252,14,238,2013-8-11,-224
2013,8,12,462,14,448,2013-8-12,-434
2013,8,13,938,0,938,2013-8-13,-938
2013,8,14,770,14,756,2013-8-14,-742
2013,8,15,1078,14,1064,2013-8-15,-1050
2013,8,16,910,0,910,2013-8-16,-910
2013,8,17,882,0,882,2013-8-17,-882
2013,8,18,1176,28,1148,2013-8-18,-1120
2013,8,19,1442,154,1288,2013-8-19,-1134
2013,8,20,1036,196,840,2013-8-20,-644
2013,8,21,1022,252,770,2013-8-21,-518
2013,8,22,672,224,448,2013-8-22,-224
2013,8,23,588,210,378,2013-8-23,-168
2013,8,24,490,154,336,2013-8-24,-182
2013,8,25,364,28,336,2013-8-25,-308
2013,8,26,294,14,280,2013-8-26,-266
2013,8,27,546,126,420,2013-8-27,-294
2013,8,28,616,224,392,2013-8-28,-168
2013,8,29,630,280,350,2013-8-29,-70
2013,8,30,546,294,252,2013-8-30,42
2013,8,31,476,280,196,2013-8-31,84
2013,9,1,448,294,154,2013-9-1,140
2013,9,2,574,350,224,2013-9-2,126
2013,9,3,504,252,252,2013-9-3,0
2013,9,4,518,266,252,2013-9-4,14
2013,9,5,448,182,266,2013-9-5,-84
2013,9,6,364,182,182,2013-9-6,0
2013,9,7,238,126,112,2013-9-7,14
2013,9,8,126,84,42,2013-9-8,42
2013,9,9,14,0,14,2013-9-9,-14
2013,9,10,14,0,14,2013-9-10,-14
2013,9,11,112,0,112,2013-9-11,-112
2013,9,12,113.4,28,85.4,2013-9-12,-57.4
2013,9,13,126,14,112,2013-9-13,-98
2013,9,14,84,0,84,2013-9-14,-84
2013,9,15,42,0,42,2013-9-15,-42
2013,9,16,56,0,56,2013-9-16,-56
2013,9,17,196,56,140,2013-9-17,-84
2013,9,18,336,70,266,2013-9-18,-196
2013,9,19,406,112,294,2013-9-19,-182
2013,9,20,448,210,238,2013-9-20,-28
2013,9,21,546,238,308,2013-9-21,-70
2013,9,22,490,224,266,2013-9-22,-42
2013,9,23,406,168,238,2013-9-23,-70
2013,9,24,336,112,224,2013-9-24,-112
2013,9,25,378,140,238,2013-9-25,-98
2013,9,26,476,280,196,2013-9-26,84
2013,9,27,392,210,182,2013-9-27,28
2013,9,28,462,252,210,2013-9-28,42
2013,9,29,266,126,140,2013-9-29,-14
2013,9,30,98,84,14,2013-9-30,70
2013,10,1,168,56,112,2013-10-1,-56
2013,10,2,378,98,280,2013-10-2,-182
2013,10,3,434,168,266,2013-10-3,-98
2013,10,4,518,224,294,2013-10-4,-70
2013,10,5,448,182,266,2013-10-5,-84
2013,10,6,280,56,224,2013-10-6,-168
2013,10,7,238,42,196,2013-10-7,-154
2013,10,8,392,42,350,2013-10-8,-308
2013,10,9,686,14,672,2013-10-9,-658
2013,10,10,938,28,910,2013-10-10,-882
2013,10,11,1092,14,1078,2013-10-11,-1064
2013,10,12,1064,42,1022,2013-10-12,-980
2013,10,13,1288,140,1148,2013-10-13,-1008
2013,10,14,1106,168,938,2013-10-14,-770
2013,10,15,1120,112,1008,2013-10-15,-896
2013,10,16,868,98,770,2013-10-16,-672
2013,10,17,1064,308,756,2013-10-17,-448
2013,10,18,1302,308,994,2013-10-18,-686
2013,10,19,1246,322,924,2013-10-19,-602
2013,10,20,1008,280,728,2013-10-20,-448
2013,10,21,1218,420,798,2013-10-21,-378
2013,10,22,1386,602,784,2013-10-22,-182
2013,10,23,1512,868,644,2013-10-23,224
2013,10,24,2016,1008,1008,2013-10-24,0
2013,10,25,2100,924,1176,2013-10-25,-252
2013,10,26,2184,980,1204,2013-10-26,-224
2013,10,27,2702,1204,1498,2013-10-27,-294
2013,10,28,2450,1134,1316,2013-10-28,-182
2013,10,29,2408,616,1792,2013-10-29,-1176
2013,10,30,1722,112,1610,2013-10-30,-1498
2013,10,31,1260,84,1176,2013-10-31,-1092
2013,11,1,1022,28,994,2013-11-1,-966
2013,11,2,994,28,966,2013-11-2,-938
2013,11,3,1792,28,1764,2013-11-3,-1736
2013,11,4,1890,154,1736,2013-11-4,-1582
2013,11,5,1960,168,1792,2013-11-5,-1624
2013,11,6,1750,126,1624,2013-11-6,-1498
2013,11,7,1638,112,1526,2013-11-7,-1414
2013,11,8,1778,112,1666,2013-11-8,-1554
2013,11,9,1372,42,1330,2013-11-9,-1288
2013,11,10,1246,168,1078,2013-11-10,-910
2013,11,11,1484,196,1288,2013-11-11,-1092
2013,11,12,2534,616,1918,2013-11-12,-1302
2013,11,13,2338,700,1638,2013-11-13,-938
2013,11,14,2212,1106,1106,2013-11-14,0
2013,11,15,2296,1050,1246,2013-11-15,-196
2013,11,16,2030,994,1036,2013-11-16,-42
2013,11,17,2296,952,1344,2013-11-17,-392
2013,11,18,2170,1008,1162,2013-11-18,-154
2013,11,19,2156,1078,1078,2013-11-19,0
2013,11,20,1652,910,742,2013-11-20,168
2013,11,21,1246,938,308,2013-11-21,630
2013,11,22,1036,854,182,2013-11-22,672
2013,11,23,1050,868,182,2013-11-23,686
2013,11,24,1232,1078,154,2013-11-24,924
2013,11,25,280,154,126,2013-11-25,28
2013,11,26,196,14,182,2013-11-26,-168
2013,11,27,518,14,504,2013-11-27,-490
2013,11,28,1120,42,1078,2013-11-28,-1036
2013,11,29,1078,14,1064,2013-11-29,-1050
2013,11,30,882,14,868,2013-11-30,-854
2013,12,1,910,56,854,2013-12-1,-798
2013,12,2,896,14,882,2013-12-2,-868
2013,12,3,798,0,798,2013-12-3,-798
2013,12,4,868,0,868,2013-12-4,-868
2013,12,5,714,0,714,2013-12-5,-714
2013,12,6,770,0,770,2013-12-6,-770
2013,12,7,714,0,714,2013-12-7,-714
2013,12,8,952,0,952,2013-12-8,-952
2013,12,9,1288,266,1022,2013-12-9,-756
2013,12,10,1974,756,1218,2013-12-10,-462
2013,12,11,1890,756,1134,2013-12-11,-378
2013,12,12,1596,756,840,2013-12-12,-84
2013,12,13,1470,770,700,2013-12-13,70
2013,12,14,1540,798,742,2013-12-14,56
2013,12,15,1484,742,742,2013-12-15,0
2013,12,16,1092,490,602,2013-12-16,-112
2013,12,17,1064,420,644,2013-12-17,-224
2013,12,18,1582,378,1204,2013-12-18,-826
2013,12,19,1610,406,1204,2013-12-19,-798
2013,12,20,1498,364,1134,2013-12-20,-770
2013,12,21,1666,294,1372,2013-12-21,-1078
2013,12,22,1232,84,1148,2013-12-22,-1064
2013,12,23,1204,0,1204,2013-12-23,-1204
2013,12,24,938,0,938,2013-12-24,-938
2013,12,25,686,0,686,2013-12-25,-686
2013,12,26,630,0,630,2013-12-26,-630
2013,12,27,798,0,798,2013-12-27,-798
2013,12,28,798,0,798,2013-12-28,-798
2013,12,29,728,0,728,2013-12-29,-728
2013,12,30,714,0,714,2013-12-30,-714
2013,12,31,686,28,658,2013-12-31,-630
2014,1,1,854,28,826,2014-1-1,-798
2014,1,2,1974,56,1918,2014-1-2,-1862
2014,1,3,2198,56,2142,2014-1-3,-2086
2014,1,4,2394,70,2324,2014-1-4,-2254
2014,1,5,2506,154,2352,2014-1-5,-2198
2014,1,6,2597,364,2233,2014-1-6,-1869
2014,1,7,2590,420,2170,2014-1-7,-1750
2014,1,8,2786,490,2296,2014-1-8,-1806
2014,1,9,2744,546,2198,2014-1-9,-1652
2014,1,10,2758,658,2100,2014-1-10,-1442
2014,1,11,2520,420,2100,2014-1-11,-1680
2014,1,12,2268,280,1988,2014-1-12,-1708
2014,1,13,1890,252,1638,2014-1-13,-1386
2014,1,14,672,126,546,2014-1-14,-420
2014,1,15,630,168,462,2014-1-15,-294
2014,1,16,462,84,378,2014-1-16,-294
2014,1,17,504,98,406,2014-1-17,-308
2014,1,18,700,56,644,2014-1-18,-588
2014,1,19,742,42,700,2014-1-19,-658
2014,1,20,868,42,826,2014-1-20,-784
2014,1,21,1148,84,1064,2014-1-21,-980
2014,1,22,938,126,812,2014-1-22,-686
2014,1,23,784,112,672,2014-1-23,-560
2014,1,24,952,238,714,2014-1-24,-476
2014,1,25,728,98,630,2014-1-25,-532
2014,1,26,644,42,602,2014-1-26,-560
2014,1,27,686,84,602,2014-1-27,-518
2014,1,28,1274,140,1134,2014-1-28,-994
2014,1,29,1918,294,1624,2014-1-29,-1330
2014,1,30,2058,224,1834,2014-1-30,-1610
2014,1,31,1694,294,1400,2014-1-31,-1106
2014,2,1,2296,308,1988,2014-2-1,-1680
2014,2,2,2646,420,2226,2014-2-2,-1806
2014,2,3,2618,448,2170,2014-2-3,-1722
2014,2,4,2758,462,2296,2014-2-4,-1834
2014,2,5,2912,644,2268,2014-2-5,-1624
2014,2,6,3682,1078,2604,2014-2-6,-1526
2014,2,7,3178,952,2226,2014-2-7,-1274
2014,2,8,2478,770,1708,2014-2-8,-938
2014,2,9,2464,728,1736,2014-2-9,-1008
2014,2,10,1316,140,1176,2014-2-10,-1036
2014,2,11,1540,140,1400,2014-2-11,-1260
2014,2,12,1764,126,1638,2014-2-12,-1512
2014,2,13,2394,84,2310,2014-2-13,-2226
2014,2,14,2499,42,2457,2014-2-14,-2415
2014,2,15,1974,14,1960,2014-2-15,-1946
2014,2,16,1974,14,1960,2014-2-16,-1946
2014,2,17,1526,0,1526,2014-2-17,-1526
2014,2,18,1820,0,1820,2014-2-18,-1820
2014,2,19,1316,14,1302,2014-2-19,-1288
2014,2,20,1232,28,1204,2014-2-20,-1176
2014,2,21,1218,56,1162,2014-2-21,-1106
2014,2,22,1428,56,1372,2014-2-22,-1316
2014,2,23,1554,98,1456,2014-2-23,-1358
2014,2,24,1750,168,1582,2014-2-24,-1414
2014,2,25,1274,140,1134,2014-2-25,-994
2014,2,26,1484,70,1414,2014-2-26,-1344
2014,2,27,1638,112,1526,2014-2-27,-1414
2014,2,28,1708,70,1638,2014-2-28,-1568
2014,3,1,1484,168,1316,2014-3-1,-1148
2014,3,2,1344,182,1162,2014-3-2,-980
2014,3,3,1302,210,1092,2014-3-3,-882
2014,3,4,1064,252,812,2014-3-4,-560
2014,3,5,1288,280,1008,2014-3-5,-728
2014,3,6,742,98,644,2014-3-6,-546
2014,3,7,1036,252,784,2014-3-7,-532
2014,3,8,686,182,504,2014-3-8,-322
2014,3,9,476,168,308,2014-3-9,-140
2014,3,10,686,350,336,2014-3-10,14
2014,3,11,756,364,392,2014-3-11,-28
2014,3,12,1246,630,616,2014-3-12,14
2014,3,13,1190,574,616,2014-3-13,-42
2014,3,14,1050,546,504,2014-3-14,42
2014,3,15,1204,728,476,2014-3-15,252
2014,3,16,1302,840,462,2014-3-16,378
2014,3,17,742,378,364,2014-3-17,14
2014,3,18,728,406,322,2014-3-18,84
2014,3,19,882,392,490,2014-3-19,-98
2014,3,20,1232,392,840,2014-3-20,-448
2014,3,21,1134,322,812,2014-3-21,-490
2014,3,22,1372,350,1022,2014-3-22,-672
2014,3,23,1246,392,854,2014-3-23,-462
2014,3,24,1036,322,714,2014-3-24,-392
2014,3,25,910,238,672,2014-3-25,-434
2014,3,26,728,210,518,2014-3-26,-308
2014,3,27,868,322,546,2014-3-27,-224
2014,3,28,952,336,616,2014-3-28,-280
2014,3,29,658,238,420,2014-3-29,-182
2014,3,30,770,238,532,2014-3-30,-294
2014,3,31,882,238,644,2014-3-31,-406
2014,4,1,756,224,532,2014-4-1,-308
2014,4,2,1036,238,798,2014-4-2,-560
2014,4,3,1120,322,798,2014-4-3,-476
2014,4,4,1470,462,1008,2014-4-4,-546
2014,4,5,1302,490,812,2014-4-5,-322
2014,4,6,784,504,280,2014-4-6,224
2014,4,7,588,378,210,2014-4-7,168
2014,4,8,616,504,112,2014-4-8,392
2014,4,9,602,560,42,2014-4-9,518
2014,4,10,588,574,14,2014-4-10,560
2014,4,11,924,700,224,2014-4-11,476
2014,4,12,994,728,266,2014-4-12,462
2014,4,13,1036,686,350,2014-4-13,336
2014,4,14,1106,602,504,2014-4-14,98
2014,4,15,1344,602,742,2014-4-15,-140
2014,4,16,2072,742,1330,2014-4-16,-588
2014,4,17,2324,1022,1302,2014-4-17,-280
2014,4,18,2576,1288,1288,2014-4-18,0
2014,4,19,2450,1274,1176,2014-4-19,98
2014,4,20,1512,700,812,2014-4-20,-112
2014,4,21,1484,588,896,2014-4-21,-308
2014,4,22,1064,350,714,2014-4-22,-364
2014,4,23,1134,252,882,2014-4-23,-630
2014,4,24,630,224,406,2014-4-24,-182
2014,4,25,546,196,350,2014-4-25,-154
2014,4,26,294,168,126,2014-4-26,42
2014,4,27,728,266,462,2014-4-27,-196
2014,4,28,868,154,714,2014-4-28,-560
2014,4,29,798,126,672,2014-4-29,-546
2014,4,30,756,112,644,2014-4-30,-532
2014,5,1,910,42,868,2014-5-1,-826
2014,5,2,1400,56,1344,2014-5-2,-1288
2014,5,3,1484,42,1442,2014-5-3,-1400
2014,5,4,1092,56,1036,2014-5-4,-980
2014,5,5,1246,378,868,2014-5-5,-490
2014,5,6,1582,798,784,2014-5-6,14
2014,5,7,1414,1134,280,2014-5-7,854
2014,5,8,1652,1260,392,2014-5-8,868
2014,5,9,1848,1554,294,2014-5-9,1260
2014,5,10,1512,1288,224,2014-5-10,1064
2014,5,11,1470,1148,322,2014-5-11,826
2014,5,12,1596,1050,546,2014-5-12,504
2014,5,13,1232,770,462,2014-5-13,308
2014,5,14,1400,952,448,2014-5-14,504
2014,5,15,1260,868,392,2014-5-15,476
2014,5,16,1078,672,406,2014-5-16,266
2014,5,17,812,378,434,2014-5-17,-56
2014,5,18,658,196,462,2014-5-18,-266
2014,5,19,476,56,420,2014-5-19,-364
2014,5,20,322,14,308,2014-5-20,-294
2014,5,21,518,0,518,2014-5-21,-518
2014,5,22,392,0,392,2014-5-22,-392
2014,5,23,448,0,448,2014-5-23,-448
2014,5,24,616,0,616,2014-5-24,-616
2014,5,25,784,0,784,2014-5-25,-784
2014,5,26,714,0,714,2014-5-26,-714
2014,5,27,294,0,294,2014-5-27,-294
2014,5,28,210,0,210,2014-5-28,-210
2014,5,29,140,0,140,2014-5-29,-140
2014,5,30,154,0,154,2014-5-30,-154
2014,5,31,182,0,182,2014-5-31,-182
2014,6,1,364,168,196,2014-6-1,-28
2014,6,2,294,140,154,2014-6-2,-14
2014,6,3,280,126,154,2014-6-3,-28
2014,6,4,308,140,168,2014-6-4,-28
2014,6,5,462,182,280,2014-6-5,-98
2014,6,6,770,364,406,2014-6-6,-42
2014,6,7,1330,588,742,2014-6-7,-154
2014,6,8,1582,560,1022,2014-6-8,-462
2014,6,9,2114,462,1652,2014-6-9,-1190
2014,6,10,1736,462,1274,2014-6-10,-812
2014,6,11,2086,616,1470,2014-6-11,-854
2014,6,12,2226,630,1596,2014-6-12,-966
2014,6,13,2520,798,1722,2014-6-13,-924
2014,6,14,1568,504,1064,2014-6-14,-560
2014,6,15,700,476,224,2014-6-15,252
2014,6,16,882,546,336,2014-6-16,210
2014,6,17,952,518,434,2014-6-17,84
2014,6,18,966,532,434,2014-6-18,98
2014,6,19,742,322,420,2014-6-19,-98
2014,6,20,476,126,350,2014-6-20,-224
2014,6,21,392,84,308,2014-6-21,-224
2014,6,22,448,238,210,2014-6-22,28
2014,6,23,238,196,42,2014-6-23,154
2014,6,24,182,154,28,2014-6-24,126
2014,6,25,336,238,98,2014-6-25,140
2014,6,26,336,168,168,2014-6-26,0
2014,6,27,210,140,70,2014-6-27,70
2014,6,28,322,182,140,2014-6-28,42
2014,6,29,924,196,728,2014-6-29,-532
2014,6,30,1050,196,854,2014-6-30,-658
2014,7,1,1190,196,994,2014-7-1,-798
2014,7,2,1764,280,1484,2014-7-2,-1204
2014,7,3,2002,294,1708,2014-7-3,-1414
2014,7,4,2562,434,2128,2014-7-4,-1694
2014,7,5,2926,336,2590,2014-7-5,-2254
2014,7,6,3122,364,2758,2014-7-6,-2394
2014,7,7,2772,308,2464,2014-7-7,-2156
2014,7,8,3192,322,2870,2014-7-8,-2548
2014,7,9,3122,406,2716,2014-7-9,-2310
2014,7,10,2506,266,2240,2014-7-10,-1974
2014,7,11,2086,182,1904,2014-7-11,-1722
2014,7,12,1988,168,1820,2014-7-12,-1652
2014,7,13,924,140,784,2014-7-13,-644
2014,7,14,518,84,434,2014-7-14,-350
2014,7,15,28,14,14,2014-7-15,0
2014,7,16,14,14,0,2014-7-16,14
2014,7,17,0,0,0,2014-7-17,0
2014,7,18,42,28,14,2014-7-18,14
2014,7,19,42,14,28,2014-7-19,-14
2014,7,20,84,28,56,2014-7-20,-28
2014,7,21,98,0,98,2014-7-21,-98
2014,7,22,252,126,126,2014-7-22,0
2014,7,23,252,168,84,2014-7-23,84
2014,7,24,392,294,98,2014-7-24,196
2014,7,25,308,224,84,2014-7-25,140
2014,7,26,336,210,126,2014-7-26,84
2014,7,27,532,182,350,2014-7-27,-168
2014,7,28,756,154,602,2014-7-28,-448
2014,7,29,1246,210,1036,2014-7-29,-826
2014,7,30,1260,140,1120,2014-7-30,-980
2014,7,31,1204,126,1078,2014-7-31,-952
2014,8,1,1246,56,1190,2014-8-1,-1134
2014,8,2,1190,168,1022,2014-8-2,-854
2014,8,3,952,238,714,2014-8-3,-476
2014,8,4,756,238,518,2014-8-4,-280
2014,8,5,630,238,392,2014-8-5,-154
2014,8,6,672,238,434,2014-8-6,-196
2014,8,7,798,420,378,2014-8-7,42
2014,8,8,798,462,336,2014-8-8,126
2014,8,9,644,364,280,2014-8-9,84
2014,8,10,448,322,126,2014-8-10,196
2014,8,11,560,518,42,2014-8-11,476
2014,8,12,476,462,14,2014-8-12,448
2014,8,13,406,392,14,2014-8-13,378
2014,8,14,476,420,56,2014-8-14,364
2014,8,15,588,462,126,2014-8-15,336
2014,8,16,700,504,196,2014-8-16,308
2014,8,17,896,490,406,2014-8-17,84
2014,8,18,714,350,364,2014-8-18,-14
2014,8,19,644,392,252,2014-8-19,140
2014,8,20,448,322,126,2014-8-20,196
2014,8,21,630,518,112,2014-8-21,406
2014,8,22,924,714,210,2014-8-22,504
2014,8,23,1120,630,490,2014-8-23,140
2014,8,24,1246,826,420,2014-8-24,406
2014,8,25,1134,770,364,2014-8-25,406
2014,8,26,994,700,294,2014-8-26,406
2014,8,27,938,574,364,2014-8-27,210
2014,8,28,854,532,322,2014-8-28,210
2014,8,29,658,336,322,2014-8-29,14
2014,8,30,784,392,392,2014-8-30,0
2014,8,31,952,392,560,2014-8-31,-168
2014,9,1,896,322,574,2014-9-1,-252
2014,9,2,910,238,672,2014-9-2,-434
2014,9,3,784,0,784,2014-9-3,-784
2014,9,4,1484,154,1330,2014-9-4,-1176
2014,9,5,1890,420,1470,2014-9-5,-1050
2014,9,6,1932,448,1484,2014-9-6,-1036
2014,9,7,1694,546,1148,2014-9-7,-602
2014,9,8,1554,546,1008,2014-9-8,-462
2014,9,9,1568,630,938,2014-9-9,-308
2014,9,10,1498,616,882,2014-9-10,-266
2014,9,11,1218,630,588,2014-9-11,42
2014,9,12,1106,602,504,2014-9-12,98
2014,9,13,770,294,476,2014-9-13,-182
2014,9,14,770,378,392,2014-9-14,-14
2014,9,15,490,294,196,2014-9-15,98
2014,9,16,406,196,210,2014-9-16,-14
2014,9,17,462,336,126,2014-9-17,210
2014,9,18,322,168,154,2014-9-18,14
2014,9,19,350,126,224,2014-9-19,-98
2014,9,20,420,112,308,2014-9-20,-196
2014,9,21,826,126,700,2014-9-21,-574
2014,9,22,938,112,826,2014-9-22,-714
2014,9,23,1162,140,1022,2014-9-23,-882
2014,9,24,826,98,728,2014-9-24,-630
2014,9,25,966,196,770,2014-9-25,-574
2014,9,26,1428,476,952,2014-9-26,-476
2014,9,27,1652,658,994,2014-9-27,-336
2014,9,28,1918,714,1204,2014-9-28,-490
2014,9,29,2184,994,1190,2014-9-29,-196
2014,9,30,1750,882,868,2014-9-30,14
2014,10,1,1078,336,742,2014-10-1,-406
2014,10,2,602,84,518,2014-10-2,-434
2014,10,3,434,84,350,2014-10-3,-266
2014,10,4,518,84,434,2014-10-4,-350
2014,10,5,462,56,406,2014-10-5,-350
2014,10,6,420,14,406,2014-10-6,-392
2014,10,7,406,0,406,2014-10-7,-406
2014,10,8,448,0,448,2014-10-8,-448
2014,10,9,616,0,616,2014-10-9,-616
2014,10,10,490,0,490,2014-10-10,-490
2014,10,11,546,0,546,2014-10-11,-546
2014,10,12,448,0,448,2014-10-12,-448
2014,10,13,560,14,546,2014-10-13,-532
2014,10,14,588,28,560,2014-10-14,-532
2014,10,15,560,56,504,2014-10-15,-448
2014,10,16,588,28,560,2014-10-16,-532
2014,10,17,868,0,868,2014-10-17,-868
2014,10,18,2184,0,2184,2014-10-18,-2184
2014,10,19,2590,42,2548,2014-10-19,-2506
2014,10,20,3402,112,3290,2014-10-20,-3178
2014,10,21,3906,112,3794,2014-10-21,-3682
2014,10,22,4368,252,4116,2014-10-22,-3864
2014,10,23,4326,238,4088,2014-10-23,-3850
2014,10,24,3948,196,3752,2014-10-24,-3556
2014,10,25,3934,224,3710,2014-10-25,-3486
2014,10,26,4228,224,4004,2014-10-26,-3780
2014,10,27,3542,112,3430,2014-10-27,-3318
2014,10,28,3906,70,3836,2014-10-28,-3766
2014,10,29,2282,70,2212,2014-10-29,-2142
2014,10,30,784,84,700,2014-10-30,-616
2014,10,31,238,98,140,2014-10-31,-42
2014,11,1,252,168,84,2014-11-1,84
2014,11,2,434,350,84,2014-11-2,266
2014,11,3,462,392,70,2014-11-3,322
2014,11,4,420,336,84,2014-11-4,252
2014,11,5,658,490,168,2014-11-5,322
2014,11,6,812,700,112,2014-11-6,588
2014,11,7,714,616,98,2014-11-7,518
2014,11,8,560,476,84,2014-11-8,392
2014,11,9,588,490,98,2014-11-9,392
2014,11,10,574,392,182,2014-11-10,210
2014,11,11,462,322,140,2014-11-11,182
2014,11,12,518,210,308,2014-11-12,-98
2014,11,13,420,224,196,2014-11-13,28
2014,11,14,1344,210,1134,2014-11-14,-924
2014,11,15,1344,126,1218,2014-11-15,-1092
2014,11,16,1456,42,1414,2014-11-16,-1372
2014,11,17,1470,14,1456,2014-11-17,-1442
2014,11,18,1596,14,1582,2014-11-18,-1568
2014,11,19,1358,0,1358,2014-11-19,-1358
2014,11,20,1904,14,1890,2014-11-20,-1876
2014,11,21,2170,0,2170,2014-11-21,-2170
2014,11,22,2226,0,2226,2014-11-22,-2226
2014,11,23,2534,0,2534,2014-11-23,-2534
2014,11,24,2898,182,2716,2014-11-24,-2534
2014,11,25,2884,224,2660,2014-11-25,-2436
2014,11,26,1316,280,1036,2014-11-26,-756
2014,11,27,1358,714,644,2014-11-27,70
2014,11,28,1708,840,868,2014-11-28,-28
2014,11,29,1890,840,1050,2014-11-29,-210
2014,11,30,2156,854,1302,2014-11-30,-448
2014,12,1,1932,532,1400,2014-12-1,-868
2014,12,2,1806,490,1316,2014-12-2,-826
2014,12,3,1526,224,1302,2014-12-3,-1078
2014,12,4,1526,238,1288,2014-12-4,-1050
2014,12,5,1148,168,980,2014-12-5,-812
2014,12,6,1232,126,1106,2014-12-6,-980
2014,12,7,1204,112,1092,2014-12-7,-980
2014,12,8,1204,252,952,2014-12-8,-700
2014,12,9,714,350,364,2014-12-9,-14
2014,12,10,938,392,546,2014-12-10,-154
2014,12,11,1092,378,714,2014-12-11,-336
2014,12,12,1190,490,700,2014-12-12,-210
2014,12,13,1246,462,784,2014-12-13,-322
2014,12,14,1428,546,882,2014-12-14,-336
2014,12,15,1722,518,1204,2014-12-15,-686
2014,12,16,2142,504,1638,2014-12-16,-1134
2014,12,17,2184,392,1792,2014-12-17,-1400
2014,12,18,2618,266,2352,2014-12-18,-2086
2014,12,19,2912,280,2632,2014-12-19,-2352
2014,12,20,2450,252,2198,2014-12-20,-1946
2014,12,21,2226,266,1960,2014-12-21,-1694
2014,12,22,1862,280,1582,2014-12-22,-1302
2014,12,23,1442,238,1204,2014-12-23,-966
2014,12,24,672,126,546,2014-12-24,-420
2014,12,25,644,98,546,2014-12-25,-448
2014,12,26,392,98,294,2014-12-26,-196
2014,12,27,812,140,672,2014-12-27,-532
2014,12,28,728,140,588,2014-12-28,-448
2014,12,29,784,126,658,2014-12-29,-532
2014,12,30,714,126,588,2014-12-30,-462
2014,12,31,994,98,896,2014-12-31,-798
2015,1,1,1218,70,1148,2015-1-1,-1078
2015,1,2,1750,126,1624,2015-1-2,-1498
2015,1,3,1820,0,1820,2015-1-3,-1820
2015,1,4,1708,0,1708,2015-1-4,-1708
2015,1,5,1288,0,1288,2015-1-5,-1288
2015,1,6,952,70,882,2015-1-6,-812
2015,1,7,686,182,504,2015-1-7,-322
2015,1,8,770,280,490,2015-1-8,-210
2015,1,9,1372,770,602,2015-1-9,168
2015,1,10,1316,756,560,2015-1-10,196
2015,1,11,1372,686,686,2015-1-11,0
2015,1,12,1330,644,686,2015-1-12,-42
2015,1,13,1176,476,700,2015-1-13,-224
2015,1,14,798,266,532,2015-1-14,-266
2015,1,15,378,126,252,2015-1-15,-126
2015,1,16,308,98,210,2015-1-16,-112
2015,1,17,168,14,154,2015-1-17,-140
2015,1,18,210,14,196,2015-1-18,-182
2015,1,19,350,42,308,2015-1-19,-266
2015,1,20,294,42,252,2015-1-20,-210
2015,1,21,224,28,196,2015-1-21,-168
2015,1,22,518,28,490,2015-1-22,-462
2015,1,23,742,28,714,2015-1-23,-686
2015,1,24,756,28,728,2015-1-24,-700
2015,1,25,644,70,574,2015-1-25,-504
2015,1,26,812,168,644,2015-1-26,-476
2015,1,27,1176,252,924,2015-1-27,-672
2015,1,28,1190,322,868,2015-1-28,-546
2015,1,29,1624,630,994,2015-1-29,-364
2015,1,30,2030,1064,966,2015-1-30,98
2015,1,31,1848,1008,840,2015-1-31,168
2015,2,1,1442,896,546,2015-2-1,350
2015,2,2,952,574,378,2015-2-2,196
2015,2,3,1162,700,462,2015-2-3,238
2015,2,4,980,756,224,2015-2-4,532
2015,2,5,784,112,672,2015-2-5,-560
2015,2,6,616,392,224,2015-2-6,168
2015,2,7,672,420,252,2015-2-7,168
2015,2,8,714,420,294,2015-2-8,126
2015,2,9,658,294,364,2015-2-9,-70
2015,2,10,854,434,420,2015-2-10,14
2015,2,11,714,378,336,2015-2-11,42
2015,2,12,560,364,196,2015-2-12,168
2015,2,13,406,364,42,2015-2-13,322
2015,2,14,350,350,0,2015-2-14,350
2015,2,15,336,308,28,2015-2-15,280
2015,2,16,308,294,14,2015-2-16,280
2015,2,17,252,238,14,2015-2-17,224
2015,2,18,350,252,98,2015-2-18,154
2015,2,19,336,238,98,2015-2-19,140
2015,2,20,140,70,70,2015-2-20,0
2015,2,21,154,84,70,2015-2-21,14
2015,2,22,98,84,14,2015-2-22,70
2015,2,23,112,98,14,2015-2-23,84
2015,2,24,168,140,28,2015-2-24,112
2015,2,25,140,112,28,2015-2-25,84
2015,2,26,98,84,14,2015-2-26,70
2015,2,27,280,168,112,2015-2-27,56
2015,2,28,308,168,140,2015-2-28,28
2015,3,1,294,168,126,2015-3-1,42
2015,3,2,238,126,112,2015-3-2,14
2015,3,3,196,70,126,2015-3-3,-56
2015,3,4,350,98,252,2015-3-4,-154
2015,3,5,105,91,14,2015-3-5,77
2015,3,6,70,14,56,2015-3-6,-42
2015,3,7,252,0,252,2015-3-7,-252
2015,3,8,364,0,364,2015-3-8,-364
2015,3,9,364,0,364,2015-3-9,-364
2015,3,10,392,0,392,2015-3-10,-392
2015,3,11,504,0,504,2015-3-11,-504
2015,3,12,504,0,504,2015-3-12,-504
2015,3,13,658,14,644,2015-3-13,-630
2015,3,14,490,0,490,2015-3-14,-490
2015,3,15,546,0,546,2015-3-15,-546
2015,3,16,546,0,546,2015-3-16,-546
2015,3,17,1134,574,560,2015-3-17,14
2015,3,18,658,252,406,2015-3-18,-154
2015,3,19,588,224,364,2015-3-19,-140
2015,3,20,168,168,0,2015-3-20,168
2015,3,21,364,168,196,2015-3-21,-28
2015,3,22,532,182,350,2015-3-22,-168
2015,3,23,756,294,462,2015-3-23,-168
2015,3,24,812,322,490,2015-3-24,-168
2015,3,25,910,322,588,2015-3-25,-266
2015,3,26,826,210,616,2015-3-26,-406
2015,3,27,840,224,616,2015-3-27,-392
2015,3,28,812,224,588,2015-3-28,-364
2015,3,29,630,84,546,2015-3-29,-462
2015,3,30,686,14,672,2015-3-30,-658
2015,3,31,490,14,476,2015-3-31,-462
2015,4,1,728,56,672,2015-4-1,-616
2015,4,2,392,84,308,2015-4-2,-224
2015,4,3,98,98,0,2015-4-3,98
2015,4,4,182,112,70,2015-4-4,42
2015,4,5,322,112,210,2015-4-5,-98
2015,4,6,308,98,210,2015-4-6,-112
2015,4,7,392,140,252,2015-4-7,-112
2015,4,8,238,42,196,2015-4-8,-154
2015,4,9,210,14,196,2015-4-9,-182
2015,4,10,196,14,182,2015-4-10,-168
2015,4,11,462,322,140,2015-4-11,182
2015,4,12,1008,896,112,2015-4-12,784
2015,4,13,1036,910,126,2015-4-13,784
2015,4,14,1806,1624,182,2015-4-14,1442
2015,4,15,1610,1568,42,2015-4-15,1526
2015,4,16,1288,1288,0,2015-4-16,1288
2015,4,17,1232,1036,196,2015-4-17,840
2015,4,18,1218,1008,210,2015-4-18,798
2015,4,19,1232,966,266,2015-4-19,700
2015,4,20,1050,840,210,2015-4-20,630
2015,4,21,938,686,252,2015-4-21,434
2015,4,22,882,602,280,2015-4-22,322
2015,4,23,882,616,266,2015-4-23,350
2015,4,24,672,336,336,2015-4-24,0
2015,4,25,770,350,420,2015-4-25,-70
2015,4,26,742,322,420,2015-4-26,-98
2015,4,27,336,14,322,2015-4-27,-308
2015,4,28,336,14,322,2015-4-28,-308
2015,4,29,42,14,28,2015-4-29,-14
2015,4,30,70,0,70,2015-4-30,-70
2015,5,1,98,0,98,2015-5-1,-98
2015,5,2,308,0,308,2015-5-2,-308
2015,5,3,280,28,252,2015-5-3,-224
2015,5,4,518,70,448,2015-5-4,-378
2015,5,5,910,504,406,2015-5-5,98
2015,5,6,1316,994,322,2015-5-6,672
2015,5,7,1512,1092,420,2015-5-7,672
2015,5,8,1722,1344,378,2015-5-8,966
2015,5,9,1484,1246,238,2015-5-9,1008
2015,5,10,1484,1218,266,2015-5-10,952
2015,5,11,1582,1204,378,2015-5-11,826
2015,5,12,1274,1022,252,2015-5-12,770
2015,5,13,826,560,266,2015-5-13,294
2015,5,14,1050,672,378,2015-5-14,294
2015,5,15,896,532,364,2015-5-15,168
2015,5,16,826,518,308,2015-5-16,210
2015,5,17,714,448,266,2015-5-17,182
2015,5,18,476,196,280,2015-5-18,-84
2015,5,19,308,140,168,2015-5-19,-28
2015,5,20,182,42,140,2015-5-20,-98
2015,5,21,98,0,98,2015-5-21,-98
2015,5,22,224,112,112,2015-5-22,0
2015,5,23,210,84,126,2015-5-23,-42
2015,5,24,252,84,168,2015-5-24,-84
2015,5,25,252,98,154,2015-5-25,-56
2015,5,26,140,42,98,2015-5-26,-56
2015,5,27,56,42,14,2015-5-27,28
2015,5,28,84,0,84,2015-5-28,-84
2015,5,29,98,14,84,2015-5-29,-70
2015,5,30,126,28,98,2015-5-30,-70
2015,5,31,196,14,182,2015-5-31,-168
2015,6,1,140,0,140,2015-6-1,-140
2015,6,2,154,0,154,2015-6-2,-154
2015,6,3,196,70,126,2015-6-3,-56
2015,6,4,476,378,98,2015-6-4,280
2015,6,5,588,462,126,2015-6-5,336
2015,6,6,812,588,224,2015-6-6,364
2015,6,7,784,546,238,2015-6-7,308
2015,6,8,588,434,154,2015-6-8,280
2015,6,9,490,392,98,2015-6-9,294
2015,6,10,350,252,98,2015-6-10,154
2015,6,11,448,266,182,2015-6-11,84
2015,6,12,882,406,476,2015-6-12,-70
2015,6,13,854,308,546,2015-6-13,-238
2015,6,14,770,140,630,2015-6-14,-490
2015,6,15,728,42,686,2015-6-15,-644
2015,6,16,952,364,588,2015-6-16,-224
2015,6,17,1316,756,560,2015-6-17,196
2015,6,18,1568,1148,420,2015-6-18,728
2015,6,19,1848,1428,420,2015-6-19,1008
2015,6,20,1974,1568,406,2015-6-20,1162
2015,6,21,1974,1652,322,2015-6-21,1330
2015,6,22,1848,1512,336,2015-6-22,1176
2015,6,23,1498,1330,168,2015-6-23,1162
2015,6,24,1036,1036,0,2015-6-24,1036
2015,6,25,812,812,0,2015-6-25,812
2015,6,26,770,770,0,2015-6-26,770
2015,6,27,602,602,0,2015-6-27,602
2015,6,28,308,308,0,2015-6-28,308
2015,6,29,252,182,70,2015-6-29,112
2015,6,30,378,280,98,2015-6-30,182
2015,7,1,532,420,112,2015-7-1,308
2015,7,2,476,350,126,2015-7-2,224
2015,7,3,476,294,182,2015-7-3,112
2015,7,4,546,322,224,2015-7-4,98
2015,7,5,588,336,252,2015-7-5,84
2015,7,6,882,672,210,2015-7-6,462
2015,7,7,980,784,196,2015-7-7,588
2015,7,8,1176,840,336,2015-7-8,504
2015,7,9,1148,770,378,2015-7-9,392
2015,7,10,994,644,350,2015-7-10,294
2015,7,11,1022,686,336,2015-7-11,350
2015,7,12,1050,812,238,2015-7-12,574
2015,7,13,826,588,238,2015-7-13,350
2015,7,14,742,532,210,2015-7-14,322
2015,7,15,392,224,168,2015-7-15,56
2015,7,16,294,168,126,2015-7-16,42
2015,7,17,266,154,112,2015-7-17,42
2015,7,18,434,308,126,2015-7-18,182
2015,7,19,308,224,84,2015-7-19,140
2015,7,20,224,224,0,2015-7-20,224
2015,7,21,210,210,0,2015-7-21,210
2015,7,22,126,126,0,2015-7-22,126
2015,7,23,56,56,0,2015-7-23,56
2015,7,24,98,42,56,2015-7-24,-14
2015,7,25,182,0,182,2015-7-25,-182
2015,7,26,266,0,266,2015-7-26,-266
2015,7,27,336,56,280,2015-7-27,-224
2015,7,28,294,70,224,2015-7-28,-154
2015,7,29,280,84,196,2015-7-29,-112
2015,7,30,378,266,112,2015-7-30,154
2015,7,31,504,364,140,2015-7-31,224
2015,8,1,406,294,112,2015-8-1,182
2015,8,2,322,252,70,2015-8-2,182
2015,8,3,253.4,239.4,14,2015-8-3,225.4
2015,8,4,378,266,112,2015-8-4,154
2015,8,5,630,238,392,2015-8-5,-154
2015,8,6,980,196,784,2015-8-6,-588
2015,8,7,1190,182,1008,2015-8-7,-826
2015,8,8,1288,154,1134,2015-8-8,-980
2015,8,9,1260,84,1176,2015-8-9,-1092
2015,8,10,1106,70,1036,2015-8-10,-966
2015,8,11,1078,70,1008,2015-8-11,-938
2015,8,12,826,28,798,2015-8-12,-770
2015,8,13,406,70,336,2015-8-13,-266
2015,8,14,224,70,154,2015-8-14,-84
2015,8,15,84,42,42,2015-8-15,0
2015,8,16,112,14,98,2015-8-16,-84
2015,8,17,42,0,42,2015-8-17,-42
2015,8,18,154,14,140,2015-8-18,-126
2015,8,19,210,0,210,2015-8-19,-210
2015,8,20,574,28,546,2015-8-20,-518
2015,8,21,532,28,504,2015-8-21,-476
2015,8,22,588,28,560,2015-8-22,-532
2015,8,23,1106,42,1064,2015-8-23,-1022
2015,8,24,1330,28,1302,2015-8-24,-1274
2015,8,25,1666,0,1666,2015-8-25,-1666
2015,8,26,1540,0,1540,2015-8-26,-1540
2015,8,27,1260,0,1260,2015-8-27,-1260
2015,8,28,1190,0,1190,2015-8-28,-1190
2015,8,29,770,14,756,2015-8-29,-742
2015,8,30,182,56,126,2015-8-30,-70
2015,8,31,56,56,0,2015-8-31,56
2015,9,1,126,126,0,2015-9-1,126
2015,9,2,98,98,0,2015-9-2,98
2015,9,3,56,42,14,2015-9-3,28
2015,9,4,84,56,28,2015-9-4,28
2015,9,5,70,70,0,2015-9-5,70
2015,9,6,98,70,28,2015-9-6,42
2015,9,7,112,56,56,2015-9-7,0
2015,9,8,84,42,42,2015-9-8,0
2015,9,9,98,42,56,2015-9-9,-14
2015,9,10,84,28,56,2015-9-10,-28
2015,9,11,322,28,294,2015-9-11,-266
2015,9,12,490,28,462,2015-9-12,-434
2015,9,13,700,14,686,2015-9-13,-672
2015,9,14,728,0,728,2015-9-14,-728
2015,9,15,742,14,728,2015-9-15,-714
2015,9,16,952,168,784,2015-9-16,-616
2015,9,17,756,140,616,2015-9-17,-476
2015,9,18,686,98,588,2015-9-18,-490
2015,9,19,728,70,658,2015-9-19,-588
2015,9,20,1050,420,630,2015-9-20,-210
2015,9,21,910,434,476,2015-9-21,-42
2015,9,22,882,406,476,2015-9-22,-70
2015,9,23,700,350,350,2015-9-23,0
2015,9,24,770,350,420,2015-9-24,-70
2015,9,25,896,350,546,2015-9-25,-196
2015,9,26,1008,392,616,2015-9-26,-224
2015,9,27,1414,364,1050,2015-9-27,-686
2015,9,28,1470,238,1232,2015-9-28,-994
2015,9,29,1638,266,1372,2015-9-29,-1106
2015,9,30,1526,308,1218,2015-9-30,-910
2015,10,1,1330,280,1050,2015-10-1,-770
2015,10,2,938,266,672,2015-10-2,-406
2015,10,3,672,294,378,2015-10-3,-84
2015,10,4,210,210,0,2015-10-4,210
2015,10,5,154,154,0,2015-10-5,154
2015,10,6,154,140,14,2015-10-6,126
2015,10,7,154,140,14,2015-10-7,126
2015,10,8,56,0,56,2015-10-8,-56
2015,10,9,42,0,42,2015-10-9,-42
2015,10,10,70,0,70,2015-10-10,-70
2015,10,11,112,0,112,2015-10-11,-112
2015,10,12,140,42,98,2015-10-12,-56
2015,10,13,168,42,126,2015-10-13,-84
2015,10,14,154,14,140,2015-10-14,-126
2015,10,15,140,0,140,2015-10-15,-140
2015,10,16,280,0,280,2015-10-16,-280
2015,10,17,560,112,448,2015-10-17,-336
2015,10,18,742,294,448,2015-10-18,-154
2015,10,19,812,364,448,2015-10-19,-84
2015,10,20,728,336,392,2015-10-20,-56
2015,10,21,714,406,308,2015-10-21,98
2015,10,22,658,476,182,2015-10-22,294
2015,10,23,574,392,182,2015-10-23,210
2015,10,24,448,378,70,2015-10-24,308
2015,10,25,392,364,28,2015-10-25,336
2015,10,26,350,322,28,2015-10-26,294
2015,10,27,266,252,14,2015-10-27,238
2015,10,28,266,238,28,2015-10-28,210
2015,10,29,728,672,56,2015-10-29,616
2015,10,30,868,854,14,2015-10-30,840
2015,10,31,938,938,0,2015-10-31,938
2015,11,1,1022,1022,0,2015-11-1,1022
2015,11,2,1190,1190,0,2015-11-2,1190
2015,11,3,1092,1092,0,2015-11-3,1092
2015,11,4,812,812,0,2015-11-4,812
2015,11,5,588,588,0,2015-11-5,588
2015,11,6,574,532,42,2015-11-6,490
2015,11,7,644,420,224,2015-11-7,196
2015,11,8,504,280,224,2015-11-8,56
2015,11,9,504,308,196,2015-11-9,112
2015,11,10,350,182,168,2015-11-10,14
2015,11,11,196,42,154,2015-11-11,-112
2015,11,12,14,14,0,2015-11-12,14
2015,11,13,70,42,28,2015-11-13,14
2015,11,14,84,70,14,2015-11-14,56
2015,11,15,112,98,14,2015-11-15,84
2015,11,16,56,56,0,2015-11-16,56
2015,11,17,56,56,0,2015-11-17,56
2015,11,18,84,84,0,2015-11-18,84
2015,11,19,112,112,0,2015-11-19,112
2015,11,20,210,210,0,2015-11-20,210
2015,11,21,350,350,0,2015-11-21,350
2015,11,22,462,462,0,2015-11-22,462
2015,11,23,560,560,0,2015-11-23,560
2015,11,24,406,406,0,2015-11-24,406
2015,11,25,280,280,0,2015-11-25,280
2015,11,26,238,238,0,2015-11-26,238
2015,11,27,154,154,0,2015-11-27,154
2015,11,28,154,154,0,2015-11-28,154
2015,11,29,98,84,14,2015-11-29,70
2015,11,30,168,154,14,2015-11-30,140
2015,12,1,98,98,0,2015-12-1,98
2015,12,2,84,84,0,2015-12-2,84
2015,12,3,70,42,28,2015-12-3,14
2015,12,4,168,56,112,2015-12-4,-56
2015,12,5,238,42,196,2015-12-5,-154
2015,12,6,182,14,168,2015-12-6,-154
2015,12,7,182,14,168,2015-12-7,-154
2015,12,8,224,14,210,2015-12-8,-196
2015,12,9,266,0,266,2015-12-9,-266
2015,12,10,392,0,392,2015-12-10,-392
2015,12,11,238,0,238,2015-12-11,-238
2015,12,12,406,252,154,2015-12-12,98
2015,12,13,602,504,98,2015-12-13,406
2015,12,14,672,574,98,2015-12-14,476
2015,12,15,924,896,28,2015-12-15,868
2015,12,16,812,770,42,2015-12-16,728
2015,12,17,910,882,28,2015-12-17,854
2015,12,18,798,784,14,2015-12-18,770
2015,12,19,644,630,14,2015-12-19,616
2015,12,20,602,602,0,2015-12-20,602
2015,12,21,700,658,42,2015-12-21,616
2015,12,22,1106,784,322,2015-12-22,462
2015,12,23,1274,686,588,2015-12-23,98
2015,12,24,1232,532,700,2015-12-24,-168
2015,12,25,1232,434,798,2015-12-25,-364
2015,12,26,868,42,826,2015-12-26,-784
2015,12,27,784,42,742,2015-12-27,-700
2015,12,28,742,28,714,2015-12-28,-686
2015,12,29,672,14,658,2015-12-29,-644
2015,12,30,350,14,336,2015-12-30,-322
2015,12,31,182,0,182,2015-12-31,-182
2016,1,1,196,28,168,2016-1-1,-140
2016,1,2,196,112,84,2016-1-2,28
2016,1,3,238,126,112,2016-1-3,14
2016,1,4,224,126,98,2016-1-4,28
2016,1,5,140,98,42,2016-1-5,56
2016,1,6,224,210,14,2016-1-6,196
2016,1,7,420,336,84,2016-1-7,252
2016,1,8,476,364,112,2016-1-8,252
2016,1,9,546,378,168,2016-1-9,210
2016,1,10,378,378,0,2016-1-10,378
2016,1,11,490,490,0,2016-1-11,490
2016,1,12,392,392,0,2016-1-12,392
2016,1,13,392,392,0,2016-1-13,392
2016,1,14,364,364,0,2016-1-14,364
2016,1,15,350,350,0,2016-1-15,350
2016,1,16,294,294,0,2016-1-16,294
2016,1,17,364,308,56,2016-1-17,252
2016,1,18,392,308,84,2016-1-18,224
2016,1,19,154,42,112,2016-1-19,-70
2016,1,20,252,98,154,2016-1-20,-56
2016,1,21,280,98,182,2016-1-21,-84
2016,1,22,252,126,126,2016-1-22,0
2016,1,23,238,168,70,2016-1-23,98
2016,1,24,322,280,42,2016-1-24,238
2016,1,25,462,420,42,2016-1-25,378
2016,1,26,504,462,42,2016-1-26,420
2016,1,27,700,658,42,2016-1-27,616
2016,1,28,756,728,28,2016-1-28,700
2016,1,29,644,630,14,2016-1-29,616
2016,1,30,546,546,0,2016-1-30,546
2016,1,31,364,350,14,2016-1-31,336
2016,2,1,448,434,14,2016-2-1,420
2016,2,2,420,392,28,2016-2-2,364
2016,2,3,532,406,126,2016-2-3,280
2016,2,4,700,238,462,2016-2-4,-224
2016,2,5,560,98,462,2016-2-5,-364
2016,2,6,546,126,420,2016-2-6,-294
2016,2,7,644,168,476,2016-2-7,-308
2016,2,8,910,322,588,2016-2-8,-266
2016,2,9,490,322,168,2016-2-9,154
2016,2,10,490,392,98,2016-2-10,294
2016,2,11,350,294,56,2016-2-11,238
2016,2,12,406,392,14,2016-2-12,378
2016,2,13,322,308,14,2016-2-13,294
2016,2,14,392,364,28,2016-2-14,336
2016,2,15,434,420,14,2016-2-15,406
2016,2,16,364,364,0,2016-2-16,364
2016,2,17,420,420,0,2016-2-17,420
2016,2,18,98,98,0,2016-2-18,98
2016,2,19,154,154,0,2016-2-19,154
2016,2,20,294,294,0,2016-2-20,294
2016,2,21,364,364,0,2016-2-21,364
2016,2,22,308,308,0,2016-2-22,308
2016,2,23,322,322,0,2016-2-23,322
2016,2,24,322,308,14,2016-2-24,294
2016,2,25,70,28,42,2016-2-25,-14
2016,2,26,84,42,42,2016-2-26,0
2016,2,27,98,14,84,2016-2-27,-70
2016,2,28,168,14,154,2016-2-28,-140
2016,2,29,224,42,182,2016-2-29,-140
2016,3,1,196,42,154,2016-3-1,-112
2016,3,2,308,154,154,2016-3-2,0
2016,3,3,210,112,98,2016-3-3,14
2016,3,4,266,154,112,2016-3-4,42
2016,3,5,252,196,56,2016-3-5,140
2016,3,6,196,196,0,2016-3-6,196
2016,3,7,168,168,0,2016-3-7,168
2016,3,8,126,126,0,2016-3-8,126
2016,3,9,266,266,0,2016-3-9,266
2016,3,10,224,224,0,2016-3-10,224
2016,3,11,154,154,0,2016-3-11,154
2016,3,12,294,294,0,2016-3-12,294
2016,3,13,280,280,0,2016-3-13,280
2016,3,14,308,308,0,2016-3-14,308
2016,3,15,238,238,0,2016-3-15,238
2016,3,16,266,252,14,2016-3-16,238
2016,3,17,448,434,14,2016-3-17,420
2016,3,18,420,420,0,2016-3-18,420
2016,3,19,490,490,0,2016-3-19,490
2016,3,20,434,434,0,2016-3-20,434
2016,3,21,308,308,0,2016-3-21,308
2016,3,22,336,336,0,2016-3-22,336
2016,3,23,294,294,0,2016-3-23,294
2016,3,24,434,266,168,2016-3-24,98
2016,3,25,392,140,252,2016-3-25,-112
2016,3,26,378,112,266,2016-3-26,-154
2016,3,27,378,112,266,2016-3-27,-154
2016,3,28,350,84,266,2016-3-28,-182
2016,3,29,280,0,280,2016-3-29,-280
2016,3,30,266,0,266,2016-3-30,-266
2016,3,31,280,0,280,2016-3-31,-280
2016,4,1,252,0,252,2016-4-1,-252
2016,4,2,266,0,266,2016-4-2,-266
2016,4,3,238,14,224,2016-4-3,-210
2016,4,4,224,14,210,2016-4-4,-196
2016,4,5,210,42,168,2016-4-5,-126
2016,4,6,28,28,0,2016-4-6,28
2016,4,7,518,518,0,2016-4-7,518
2016,4,8,504,504,0,2016-4-8,504
2016,4,9,1162,1162,0,2016-4-9,1162
2016,4,10,1148,1148,0,2016-4-10,1148
2016,4,11,1232,1232,0,2016-4-11,1232
2016,4,12,1148,1148,0,2016-4-12,1148
2016,4,13,1134,1134,0,2016-4-13,1134
2016,4,14,1134,1134,0,2016-4-14,1134
2016,4,15,1064,1064,0,2016-4-15,1064
2016,4,16,1050,1050,0,2016-4-16,1050
2016,4,17,1162,1162,0,2016-4-17,1162
2016,4,18,896,896,0,2016-4-18,896
2016,4,19,896,896,0,2016-4-19,896
2016,4,20,126,42,84,2016-4-20,-42
2016,4,21,112,28,84,2016-4-21,-56
2016,4,22,98,14,84,2016-4-22,-70
2016,4,23,112,0,112,2016-4-23,-112
2016,4,24,294,154,140,2016-4-24,14
2016,4,25,196,56,140,2016-4-25,-84
2016,4,26,280,112,168,2016-4-26,-56
2016,4,27,392,168,224,2016-4-27,-56
2016,4,28,420,182,238,2016-4-28,-56
2016,4,29,420,210,210,2016-4-29,0
2016,4,30,420,280,140,2016-4-30,140
2016,5,1,532,434,98,2016-5-1,336
2016,5,2,294,294,0,2016-5-2,294
2016,5,3,224,224,0,2016-5-3,224
2016,5,4,518,518,0,2016-5-4,518
2016,5,5,266,266,0,2016-5-5,266
2016,5,6,252,252,0,2016-5-6,252
2016,5,7,280,280,0,2016-5-7,280
2016,5,8,154,140,14,2016-5-8,126
2016,5,9,294,252,42,2016-5-9,210
2016,5,10,378,238,140,2016-5-10,98
2016,5,11,420,224,196,2016-5-11,28
2016,5,12,490,252,238,2016-5-12,14
2016,5,13,406,252,154,2016-5-13,98
2016,5,14,714,252,462,2016-5-14,-210
2016,5,15,1078,364,714,2016-5-15,-350
2016,5,16,1064,266,798,2016-5-16,-532
2016,5,17,924,168,756,2016-5-17,-588
2016,5,18,826,154,672,2016-5-18,-518
2016,5,19,742,112,630,2016-5-19,-518
2016,5,20,854,112,742,2016-5-20,-630
2016,5,21,770,0,770,2016-5-21,-770
2016,5,22,672,0,672,2016-5-22,-672
2016,5,23,644,0,644,2016-5-23,-644
2016,5,24,644,14,630,2016-5-24,-616
2016,5,25,532,70,462,2016-5-25,-392
2016,5,26,588,168,420,2016-5-26,-252
2016,5,27,182,182,0,2016-5-27,182
2016,5,28,196,168,28,2016-5-28,140
2016,5,29,112,84,28,2016-5-29,56
2016,5,30,112,98,14,2016-5-30,84
2016,5,31,84,84,0,2016-5-31,84
2016,6,1,98,98,0,2016-6-1,98
2016,6,2,140,140,0,2016-6-2,140
2016,6,3,0,0,0,2016-6-3,0
2016,6,4,0,0,0,2016-6-4,0
2016,6,5,0,0,0,2016-6-5,0
2016,6,6,0,0,0,2016-6-6,0
2016,6,7,14,14,0,2016-6-7,14
2016,6,8,28,28,0,2016-6-8,28
2016,6,9,196,196,0,2016-6-9,196
2016,6,10,252,84,168,2016-6-10,-84
2016,6,11,616,238,378,2016-6-11,-140
2016,6,12,700,238,462,2016-6-12,-224
2016,6,13,574,168,406,2016-6-13,-238
2016,6,14,546,140,406,2016-6-14,-266
2016,6,15,490,70,420,2016-6-15,-350
2016,6,16,476,0,476,2016-6-16,-476
2016,6,17,574,42,532,2016-6-17,-490
2016,6,18,434,56,378,2016-6-18,-322
2016,6,19,462,98,364,2016-6-19,-266
2016,6,20,434,84,350,2016-6-20,-266
2016,6,21,280,14,266,2016-6-21,-252
2016,6,22,224,14,210,2016-6-22,-196
2016,6,23,0,0,0,2016-6-23,0
2016,6,24,0,0,0,2016-6-24,0
2016,6,25,0,0,0,2016-6-25,0
2016,6,26,0,0,0,2016-6-26,0
2016,6,27,0,0,0,2016-6-27,0
2016,6,28,0,0,0,2016-6-28,0
2016,6,29,0,0,0,2016-6-29,0
2016,6,30,0,0,0,2016-6-30,0
2016,7,1,0,0,0,2016-7-1,0
2016,7,2,0,0,0,2016-7-2,0
2016,7,3,0,0,0,2016-7-3,0
2016,7,4,0,0,0,2016-7-4,0
2016,7,5,28,14,14,2016-7-5,0
2016,7,6,14,0,14,2016-7-6,-14
2016,7,7,84,0,84,2016-7-7,-84
2016,7,8,168,70,98,2016-7-8,-28
2016,7,9,238,140,98,2016-7-9,42
2016,7,10,266,196,70,2016-7-10,126
2016,7,11,336,294,42,2016-7-11,252
2016,7,12,420,350,70,2016-7-12,280
2016,7,13,336,294,42,2016-7-13,252
2016,7,14,350,336,14,2016-7-14,322
2016,7,15,714,672,42,2016-7-15,630
2016,7,16,742,728,14,2016-7-16,714
2016,7,17,952,952,0,2016-7-17,952
2016,7,18,924,924,0,2016-7-18,924
2016,7,19,1008,1008,0,2016-7-19,1008
2016,7,20,1190,1190,0,2016-7-20,1190
2016,7,21,896,896,0,2016-7-21,896
2016,7,22,812,812,0,2016-7-22,812
2016,7,23,644,644,0,2016-7-23,644
2016,7,24,210,210,0,2016-7-24,210
2016,7,25,0,0,0,2016-7-25,0
2016,7,26,0,0,0,2016-7-26,0
2016,7,27,0,0,0,2016-7-27,0
2016,7,28,14,14,0,2016-7-28,14
2016,7,29,14,14,0,2016-7-29,14
2016,7,30,14,14,0,2016-7-30,14
2016,7,31,14,14,0,2016-7-31,14
2016,8,1,14,14,0,2016-8-1,14
2016,8,2,14,14,0,2016-8-2,14
2016,8,3,0,0,0,2016-8-3,0
2016,8,4,28,28,0,2016-8-4,28
2016,8,5,112,112,0,2016-8-5,112
2016,8,6,168,168,0,2016-8-6,168
2016,8,7,532,532,0,2016-8-7,532
2016,8,8,686,630,56,2016-8-8,574
2016,8,9,686,630,56,2016-8-9,574
2016,8,10,644,448,196,2016-8-10,252
2016,8,11,602,406,196,2016-8-11,210
2016,8,12,700,504,196,2016-8-12,308
2016,8,13,546,364,182,2016-8-13,182
2016,8,14,490,350,140,2016-8-14,210
2016,8,15,406,266,140,2016-8-15,126
2016,8,16,308,210,98,2016-8-16,112
2016,8,17,252,168,84,2016-8-17,84
2016,8,18,224,154,70,2016-8-18,84
2016,8,19,182,126,56,2016-8-19,70
2016,8,20,14,14,0,2016-8-20,14
2016,8,21,14,14,0,2016-8-21,14
2016,8,22,112,84,28,2016-8-22,56
2016,8,23,168,140,28,2016-8-23,112
2016,8,24,168,140,28,2016-8-24,112
2016,8,25,168,112,56,2016-8-25,56
2016,8,26,154,126,28,2016-8-26,98
2016,8,27,182,154,28,2016-8-27,126
2016,8,28,280,252,28,2016-8-28,224
2016,8,29,490,448,42,2016-8-29,406
2016,8,30,406,364,42,2016-8-30,322
2016,8,31,805,616,189,2016-8-31,427
2016,9,1,1022,924,98,2016-9-1,826
2016,9,2,868,868,0,2016-9-2,868
2016,9,3,966,966,0,2016-9-3,966
2016,9,4,784,784,0,2016-9-4,784
2016,9,5,588,588,0,2016-9-5,588
2016,9,6,574,574,0,2016-9-6,574
2016,9,7,658,658,0,2016-9-7,658
2016,9,8,560,560,0,2016-9-8,560
2016,9,9,602,602,0,2016-9-9,602
2016,9,10,630,630,0,2016-9-10,630
2016,9,11,476,476,0,2016-9-11,476
2016,9,12,406,406,0,2016-9-12,406
2016,9,13,84,84,0,2016-9-13,84
2016,9,14,42,42,0,2016-9-14,42
2016,9,15,14,14,0,2016-9-15,14
2016,9,16,14,14,0,2016-9-16,14
2016,9,17,14,14,0,2016-9-17,14
2016,9,18,56,56,0,2016-9-18,56
2016,9,19,140,140,0,2016-9-19,140
2016,9,20,238,238,0,2016-9-20,238
2016,9,21,238,238,0,2016-9-21,238
2016,9,22,140,140,0,2016-9-22,140
2016,9,23,182,140,42,2016-9-23,98
2016,9,24,252,84,168,2016-9-24,-84
2016,9,25,84,0,84,2016-9-25,-84
2016,9,26,98,0,98,2016-9-26,-98
2016,9,27,154,0,154,2016-9-27,-154
2016,9,28,140,0,140,2016-9-28,-140
2016,9,29,140,0,140,2016-9-29,-140
2016,9,30,84,0,84,2016-9-30,-84
2016,10,1,0,0,0,2016-10-1,0
2016,10,2,14,14,0,2016-10-2,14
2016,10,3,0,0,0,2016-10-3,0
2016,10,4,0,0,0,2016-10-4,0
2016,10,5,0,0,0,2016-10-5,0
2016,10,6,0,0,0,2016-10-6,0
2016,10,7,0,0,0,2016-10-7,0
2016,10,8,0,0,0,2016-10-8,0
2016,10,9,0,0,0,2016-10-9,0
2016,10,10,0,0,0,2016-10-10,0
2016,10,11,0,0,0,2016-10-11,0
2016,10,12,0,0,0,2016-10-12,0
2016,10,13,0,0,0,2016-10-13,0
2016,10,14,0,0,0,2016-10-14,0
2016,10,15,0,0,0,2016-10-15,0
2016,10,16,0,0,0,2016-10-16,0
2016,10,17,0,0,0,2016-10-17,0
2016,10,18,0,0,0,2016-10-18,0
2016,10,19,0,0,0,2016-10-19,0
2016,10,20,0,0,0,2016-10-20,0
2016,10,21,0,0,0,2016-10-21,0
2016,10,22,0,0,0,2016-10-22,0
2016,10,23,0,0,0,2016-10-23,0
2016,10,24,0,0,0,2016-10-24,0
2016,10,25,0,0,0,2016-10-25,0
2016,10,26,0,0,0,2016-10-26,0
2016,10,27,0,0,0,2016-10-27,0
2016,10,28,0,0,0,2016-10-28,0
2016,10,29,0,0,0,2016-10-29,0
2016,10,30,0,0,0,2016-10-30,0
2016,10,31,0,0,0,2016-10-31,0
